transaction_id,timestamp,account_id,transaction_type,amount,balance,currency,merchant
TXN0000000001,2024-02-21T20:14:18,ACC00007037,Debit,1755.92,8244.08,GBP,Grocery
TXN0000000002,2024-11-17T17:40:07,ACC00009181,Payment,1305.92,6938.16,USD,Target
TXN0000000003,2024-01-26T17:27:29,ACC00009600,Debit,705.25,6232.91,GBP,Amazon
TXN0000000004,2024-04-15T21:44:55,ACC00003457,Debit,741.58,5491.33,GBP,Restaurant
TXN0000000005,2024-04-22T04:07:48,ACC00001366,Payment,1074.3,4417.03,GBP,Amazon
TXN0000000006,2024-02-09T02:17:07,ACC00003382,ATM,1416.54,3000.49,EUR,Amazon
TXN0000000007,2024-03-31T20:27:24,ACC00009738,ATM,1043.82,1956.67,GBP,Grocery
TXN0000000008,2024-05-23T09:41:19,ACC00004080,Credit,651.07,2607.74,JPY,Online Store
TXN0000000009,2024-04-04T11:26:35,ACC00001666,Transfer,945.95,3553.69,JPY,Restaurant
TXN0000000010,2024-02-07T20:12:24,ACC00001916,Debit,50.18,3503.51,EUR,Target
TXN0000000011,2024-07-08T00:23:56,ACC00009497,Transfer,1743.8,5247.31,GBP,Grocery
TXN0000000012,2024-02-29T16:47:12,ACC00007705,Debit,1720.98,3526.33,EUR,Amazon
TXN0000000013,2024-02-10T06:55:57,ACC00001943,Credit,965.08,4491.41,JPY,Amazon
TXN0000000014,2024-02-25T03:03:50,ACC00002970,Payment,1561.51,2929.9,EUR,Shell
TXN0000000015,2024-02-17T23:50:20,ACC00003712,Payment,923.78,2006.12,USD,Target
TXN0000000016,2024-01-04T19:35:42,ACC00009490,ATM,906.62,1099.5,EUR,Online Store
TXN0000000017,2024-10-25T07:23:01,ACC00000352,Debit,57.31,1042.19,EUR,Online Store
TXN0000000018,2024-06-21T21:29:51,ACC00009990,ATM,1884.91,-842.72,JPY,Starbucks
TXN0000000019,2024-12-21T17:05:59,ACC00009500,Transfer,677.81,-164.91,EUR,Restaurant
TXN0000000020,2024-12-25T03:13:13,ACC00001791,Credit,738.42,573.51,GBP,Amazon
TXN0000000021,2024-07-10T01:51:56,ACC00004303,Payment,1337.99,-764.48,GBP,Amazon
TXN0000000022,2024-07-10T18:35:48,ACC00008856,Transfer,1252.86,488.38,EUR,Online Store
TXN0000000023,2024-08-28T11:54:45,ACC00009677,ATM,365.29,123.09,EUR,Shell
TXN0000000024,2024-04-23T16:40:02,ACC00001653,Transfer,1842.84,1965.93,EUR,Online Store
TXN0000000025,2024-12-02T03:22:34,ACC00002771,ATM,1599.13,366.8,USD,Starbucks
TXN0000000026,2024-08-01T13:42:34,ACC00004966,ATM,1921.69,-1554.89,JPY,Walmart
TXN0000000027,2024-08-02T06:00:51,ACC00007524,ATM,1778.13,-3333.02,GBP,Walmart
TXN0000000028,2024-04-06T20:02:56,ACC00003609,ATM,1878.92,-5211.94,GBP,Restaurant
TXN0000000029,2024-03-30T15:06:47,ACC00002925,Credit,770.92,-4441.02,EUR,Grocery
TXN0000000030,2024-08-10T03:19:46,ACC00007754,Debit,996.94,-5437.96,USD,Amazon
TXN0000000031,2024-03-08T21:16:39,ACC00001960,Transfer,107.85,-5330.11,USD,Target
TXN0000000032,2024-09-03T03:08:57,ACC00005573,Debit,119.8,-5449.91,USD,Online Store
TXN0000000033,2024-07-23T11:18:15,ACC00006213,Credit,456.9,-4993.01,GBP,Target
TXN0000000034,2024-04-01T22:06:58,ACC00000473,Debit,1667.16,-6660.17,GBP,Grocery
TXN0000000035,2024-01-22T00:30:05,ACC00000873,ATM,530.84,-7191.01,EUR,Starbucks
TXN0000000036,2024-04-04T16:33:53,ACC00004619,Debit,1667.6,-8858.61,JPY,Target
TXN0000000037,2024-02-19T16:24:20,ACC00007037,Debit,1374.41,-10233.02,USD,Grocery
TXN0000000038,2024-05-05T15:21:43,ACC00000787,Credit,133.26,-10099.76,USD,Shell
TXN0000000039,2024-05-13T20:58:16,ACC00006194,Credit,352.89,-9746.87,GBP,Grocery
TXN0000000040,2024-07-14T03:55:29,ACC00001231,Credit,1816.1,-7930.77,USD,Walmart
TXN0000000041,2024-03-20T09:19:30,ACC00003636,Payment,1053.54,-8984.31,USD,Walmart
TXN0000000042,2024-08-06T07:53:00,ACC00006447,Debit,42.1,-9026.41,USD,Restaurant
TXN0000000043,2024-08-17T21:57:28,ACC00002071,Transfer,1024.42,-8001.99,JPY,Target
TXN0000000044,2024-09-12T09:21:30,ACC00006257,Debit,152.61,-8154.6,JPY,Shell
TXN0000000045,2024-08-21T18:36:25,ACC00007481,Debit,1057.32,-9211.92,USD,Online Store
TXN0000000046,2024-02-14T12:06:11,ACC00004140,Transfer,507.79,-8704.13,EUR,Online Store
TXN0000000047,2024-12-08T17:00:33,ACC00002601,Credit,1284.45,-7419.68,USD,Grocery
TXN0000000048,2024-03-16T10:41:16,ACC00003388,Payment,1382.6,-8802.28,USD,Target
TXN0000000049,2024-10-09T06:38:18,ACC00008209,Debit,998.65,-9800.93,EUR,Target
TXN0000000050,2024-06-18T15:28:01,ACC00008441,ATM,1103.3,-10904.23,JPY,Restaurant
TXN0000000051,2024-09-20T06:56:57,ACC00002849,ATM,306.82,-11211.05,USD,Starbucks
TXN0000000052,2024-01-22T03:13:15,ACC00007306,ATM,1810.21,-13021.26,JPY,Walmart
TXN0000000053,2024-05-13T11:34:46,ACC00002292,Debit,591.88,-13613.14,GBP,Amazon
TXN0000000054,2024-03-27T18:19:11,ACC00003807,Payment,1583.21,-15196.35,EUR,Online Store
TXN0000000055,2024-04-08T09:47:43,ACC00004220,Credit,888.1,-14308.25,JPY,Starbucks
TXN0000000056,2024-10-13T02:39:44,ACC00009338,Transfer,151.15,-14157.1,EUR,Walmart
TXN0000000057,2024-08-29T21:22:29,ACC00001382,Debit,1179.8,-15336.9,USD,Amazon
TXN0000000058,2024-05-18T02:16:47,ACC00006299,Debit,1630.61,-16967.51,JPY,Target
TXN0000000059,2024-01-28T19:36:52,ACC00008772,Credit,1626.01,-15341.5,JPY,Online Store
TXN0000000060,2024-04-12T06:01:47,ACC00008165,ATM,1901.02,-17242.52,USD,Shell
TXN0000000061,2024-08-19T17:36:59,ACC00006065,Credit,1014.18,-16228.34,JPY,Restaurant
TXN0000000062,2024-08-03T04:37:19,ACC00002521,ATM,1590.69,-17819.03,EUR,Starbucks
TXN0000000063,2024-10-27T02:08:21,ACC00001685,Payment,1228.69,-19047.72,USD,Starbucks
TXN0000000064,2024-06-15T06:29:36,ACC00002182,Debit,1861.04,-20908.76,USD,Online Store
TXN0000000065,2024-05-12T11:31:14,ACC00007510,Payment,70.27,-20979.03,JPY,Starbucks
TXN0000000066,2024-09-24T04:26:54,ACC00003992,Payment,1890.14,-22869.17,USD,Shell
TXN0000000067,2024-05-01T18:42:07,ACC00009653,Payment,1481.46,-24350.63,EUR,Grocery
TXN0000000068,2024-08-28T22:26:59,ACC00009253,ATM,1735.09,-26085.72,USD,Online Store
TXN0000000069,2024-10-31T18:29:37,ACC00005906,Debit,153.02,-26238.74,GBP,Online Store
TXN0000000070,2024-07-12T14:23:45,ACC00000275,Debit,1573.18,-27811.92,EUR,Grocery
TXN0000000071,2024-05-02T10:35:08,ACC00001352,ATM,1154.88,-28966.8,USD,Grocery
TXN0000000072,2024-12-18T00:07:34,ACC00009053,Credit,1864.7,-27102.1,USD,Restaurant
TXN0000000073,2024-02-23T03:05:38,ACC00007446,Credit,1599.88,-25502.22,GBP,Restaurant
TXN0000000074,2024-02-13T04:42:20,ACC00003011,Debit,486.87,-25989.09,GBP,Restaurant
TXN0000000075,2024-02-29T20:56:01,ACC00003745,Payment,812.63,-26801.72,JPY,Grocery
TXN0000000076,2024-07-31T04:45:04,ACC00000692,Payment,45.61,-26847.33,EUR,Amazon
TXN0000000077,2024-06-05T13:40:29,ACC00005868,Debit,1085.65,-27932.98,JPY,Walmart
TXN0000000078,2024-03-22T21:13:21,ACC00009961,Transfer,415.49,-27517.49,JPY,Target
TXN0000000079,2024-05-13T09:14:13,ACC00006036,Debit,1144.25,-28661.74,EUR,Shell
TXN0000000080,2024-03-11T17:56:53,ACC00000364,Transfer,1101.21,-27560.53,JPY,Walmart
TXN0000000081,2024-12-19T23:01:03,ACC00003725,Credit,853.04,-26707.49,GBP,Restaurant
TXN0000000082,2024-08-14T17:00:32,ACC00007737,Payment,1227.04,-27934.53,JPY,Starbucks
TXN0000000083,2024-11-07T03:39:16,ACC00002925,ATM,571.89,-28506.42,EUR,Restaurant
TXN0000000084,2024-09-09T13:06:48,ACC00008735,Payment,1229.16,-29735.58,USD,Target
TXN0000000085,2024-03-02T19:52:59,ACC00005223,Debit,1100.24,-30835.82,JPY,Target
TXN0000000086,2024-04-26T17:24:55,ACC00004954,Debit,1119.89,-31955.71,GBP,Starbucks
TXN0000000087,2024-01-05T06:21:05,ACC00005613,Payment,906.69,-32862.4,USD,Restaurant
TXN0000000088,2024-06-08T19:27:58,ACC00007301,Payment,1112.27,-33974.67,GBP,Walmart
TXN0000000089,2024-09-10T11:48:18,ACC00004404,Credit,48.45,-33926.22,USD,Walmart
TXN0000000090,2024-10-11T17:07:49,ACC00006272,Payment,1077.48,-35003.7,USD,Walmart
TXN0000000091,2024-11-04T15:52:48,ACC00007222,Transfer,1442.76,-33560.94,USD,Restaurant
TXN0000000092,2024-12-04T18:25:14,ACC00005296,ATM,1944.25,-35505.19,EUR,Online Store
TXN0000000093,2024-03-26T10:13:19,ACC00004941,Credit,205.63,-35299.56,JPY,Online Store
TXN0000000094,2024-11-03T23:39:41,ACC00009986,ATM,676.57,-35976.13,JPY,Walmart
TXN0000000095,2024-02-19T13:04:37,ACC00006475,Payment,98.05,-36074.18,EUR,Grocery
TXN0000000096,2024-01-01T12:49:50,ACC00001964,Credit,1318.02,-34756.16,EUR,Restaurant
TXN0000000097,2024-08-14T02:15:57,ACC00007718,Payment,504.4,-35260.56,JPY,Shell
TXN0000000098,2024-08-02T08:48:24,ACC00006301,Transfer,651.98,-34608.58,GBP,Shell
TXN0000000099,2024-10-17T16:11:06,ACC00005435,Credit,534.47,-34074.11,GBP,Shell
TXN0000000100,2024-01-05T06:54:24,ACC00003485,Transfer,686.15,-33387.96,JPY,Shell
TXN0000000101,2024-03-13T00:03:43,ACC00005340,Transfer,502.5,-32885.46,JPY,Walmart
TXN0000000102,2024-08-31T07:14:51,ACC00003937,Credit,1581.41,-31304.05,USD,Amazon
TXN0000000103,2024-10-06T02:50:33,ACC00008779,Transfer,1752.16,-29551.89,USD,Online Store
TXN0000000104,2024-06-10T17:36:47,ACC00005897,Payment,809.29,-30361.18,USD,Target
TXN0000000105,2024-07-20T04:49:29,ACC00000122,Payment,1828.07,-32189.25,JPY,Target
TXN0000000106,2024-07-29T07:34:06,ACC00000617,Payment,328.94,-32518.19,USD,Amazon
TXN0000000107,2024-03-01T17:57:44,ACC00003989,Debit,1451.0,-33969.19,EUR,Amazon
TXN0000000108,2024-01-22T21:13:53,ACC00002244,Payment,1114.24,-35083.43,EUR,Target
TXN0000000109,2024-06-28T12:43:50,ACC00003721,Debit,337.55,-35420.98,USD,Target
TXN0000000110,2024-02-06T11:59:24,ACC00006943,Transfer,1010.99,-34409.99,GBP,Shell
TXN0000000111,2024-01-12T22:44:19,ACC00003310,Credit,455.27,-33954.72,GBP,Starbucks
TXN0000000112,2024-04-03T17:11:45,ACC00002208,Credit,35.7,-33919.02,USD,Online Store
TXN0000000113,2024-10-08T19:56:01,ACC00001652,Payment,724.06,-34643.08,JPY,Shell
TXN0000000114,2024-11-17T20:55:05,ACC00007603,Transfer,745.49,-33897.59,EUR,Grocery
TXN0000000115,2024-01-27T13:57:45,ACC00009424,ATM,697.19,-34594.78,GBP,Amazon
TXN0000000116,2024-05-23T09:17:02,ACC00001232,Debit,1972.0,-36566.78,JPY,Grocery
TXN0000000117,2024-08-18T13:22:03,ACC00003413,Transfer,1017.5,-35549.28,GBP,Restaurant
TXN0000000118,2024-04-18T13:07:37,ACC00006561,Payment,385.45,-35934.73,JPY,Starbucks
TXN0000000119,2024-04-23T19:54:44,ACC00006281,ATM,714.2,-36648.93,EUR,Target
TXN0000000120,2024-05-22T11:07:46,ACC00001467,Transfer,1208.31,-35440.62,EUR,Amazon
TXN0000000121,2024-09-14T18:12:13,ACC00009712,Payment,887.76,-36328.38,USD,Online Store
TXN0000000122,2024-07-17T08:57:25,ACC00002439,Debit,1792.96,-38121.34,GBP,Starbucks
TXN0000000123,2024-10-04T10:50:32,ACC00003130,Transfer,286.22,-37835.12,JPY,Grocery
TXN0000000124,2024-04-16T10:22:41,ACC00008705,Credit,1251.42,-36583.7,EUR,Amazon
TXN0000000125,2024-11-18T02:56:49,ACC00005628,ATM,463.43,-37047.13,GBP,Target
TXN0000000126,2024-07-14T02:44:59,ACC00009773,Payment,1971.92,-39019.05,EUR,Walmart
TXN0000000127,2024-09-13T18:50:18,ACC00001316,Transfer,583.31,-38435.74,JPY,Amazon
TXN0000000128,2024-04-12T01:57:51,ACC00003660,Payment,1600.05,-40035.79,USD,Amazon
TXN0000000129,2024-07-26T18:30:43,ACC00007963,Credit,1754.37,-38281.42,JPY,Walmart
TXN0000000130,2024-07-24T16:04:32,ACC00005424,Payment,1486.8,-39768.22,EUR,Restaurant
TXN0000000131,2024-05-22T17:09:41,ACC00007020,Debit,1822.47,-41590.69,GBP,Target
TXN0000000132,2024-10-12T19:36:56,ACC00004128,Credit,1860.73,-39729.96,GBP,Walmart
TXN0000000133,2024-12-28T09:52:10,ACC00000097,Debit,1182.52,-40912.48,USD,Grocery
TXN0000000134,2024-11-30T05:42:19,ACC00001619,Transfer,1490.81,-39421.67,USD,Target
TXN0000000135,2024-08-23T13:07:27,ACC00000338,Payment,1501.23,-40922.9,USD,Shell
TXN0000000136,2024-06-07T10:27:49,ACC00007951,ATM,1545.88,-42468.78,USD,Grocery
TXN0000000137,2024-05-03T09:33:27,ACC00000453,Credit,116.29,-42352.49,GBP,Target
TXN0000000138,2024-06-26T00:26:52,ACC00009547,Debit,1125.32,-43477.81,EUR,Restaurant
TXN0000000139,2024-01-15T10:28:05,ACC00004792,Debit,967.72,-44445.53,USD,Online Store
TXN0000000140,2024-03-17T07:27:50,ACC00001942,ATM,440.06,-44885.59,EUR,Walmart
TXN0000000141,2024-03-14T05:07:50,ACC00005800,ATM,1876.18,-46761.77,EUR,Amazon
TXN0000000142,2024-09-04T18:20:27,ACC00001957,Credit,886.03,-45875.74,JPY,Shell
TXN0000000143,2024-10-30T11:31:04,ACC00009786,Debit,1320.48,-47196.22,GBP,Online Store
TXN0000000144,2024-08-19T10:42:47,ACC00006142,ATM,1680.32,-48876.54,EUR,Walmart
TXN0000000145,2024-02-13T12:56:27,ACC00004500,Payment,1718.69,-50595.23,USD,Restaurant
TXN0000000146,2024-09-19T10:07:05,ACC00001669,Credit,405.47,-50189.76,USD,Starbucks
TXN0000000147,2024-05-23T03:11:29,ACC00008353,Credit,1633.99,-48555.77,USD,Starbucks
TXN0000000148,2024-07-04T01:35:22,ACC00003379,Credit,1163.07,-47392.7,USD,Target
TXN0000000149,2024-10-24T17:11:30,ACC00009522,Debit,1177.8,-48570.5,EUR,Online Store
TXN0000000150,2024-08-10T00:11:14,ACC00008962,Debit,178.93,-48749.43,JPY,Online Store
TXN0000000151,2024-12-30T04:52:36,ACC00001209,Debit,1850.13,-50599.56,JPY,Amazon
TXN0000000152,2024-09-14T06:00:29,ACC00002654,Credit,1683.82,-48915.74,USD,Starbucks
TXN0000000153,2024-11-21T16:49:57,ACC00000461,ATM,1694.31,-50610.05,USD,Restaurant
TXN0000000154,2024-05-20T17:50:40,ACC00008589,Payment,1571.91,-52181.96,GBP,Shell
TXN0000000155,2024-06-23T08:15:00,ACC00006091,Debit,1986.39,-54168.35,JPY,Online Store
TXN0000000156,2024-12-28T23:15:54,ACC00000985,ATM,1493.62,-55661.97,GBP,Walmart
TXN0000000157,2024-05-07T22:49:43,ACC00000507,Credit,1415.46,-54246.51,EUR,Online Store
TXN0000000158,2024-01-31T00:24:31,ACC00000510,ATM,1512.91,-55759.42,USD,Target
TXN0000000159,2024-12-28T20:35:55,ACC00008380,Payment,1166.15,-56925.57,EUR,Walmart
TXN0000000160,2024-09-20T09:18:46,ACC00001065,Credit,1248.94,-55676.63,EUR,Shell
TXN0000000161,2024-10-08T19:41:50,ACC00005342,ATM,884.08,-56560.71,JPY,Starbucks
TXN0000000162,2024-04-04T06:48:46,ACC00004666,Debit,562.74,-57123.45,EUR,Online Store
TXN0000000163,2024-05-10T01:24:31,ACC00008160,ATM,1391.19,-58514.64,JPY,Walmart
TXN0000000164,2024-11-01T15:51:39,ACC00006313,ATM,1850.76,-60365.4,GBP,Online Store
TXN0000000165,2024-06-08T20:51:48,ACC00004895,Transfer,659.06,-59706.34,EUR,Walmart
TXN0000000166,2024-02-28T17:25:32,ACC00000379,Transfer,1166.62,-58539.72,EUR,Restaurant
TXN0000000167,2024-02-22T00:18:40,ACC00002434,Payment,1599.37,-60139.09,EUR,Shell
TXN0000000168,2024-03-09T06:30:56,ACC00007475,Payment,1658.66,-61797.75,JPY,Grocery
TXN0000000169,2024-10-11T14:09:31,ACC00002649,Credit,424.79,-61372.96,GBP,Starbucks
TXN0000000170,2024-03-10T17:08:21,ACC00003905,Payment,1681.23,-63054.19,GBP,Amazon
TXN0000000171,2024-01-15T15:21:29,ACC00004792,Debit,1387.67,-64441.86,USD,Amazon
TXN0000000172,2024-07-22T06:08:04,ACC00003060,Transfer,858.26,-63583.6,USD,Amazon
TXN0000000173,2024-09-06T09:15:03,ACC00004029,Payment,1825.05,-65408.65,GBP,Grocery
TXN0000000174,2024-10-06T08:35:55,ACC00001542,Debit,1877.14,-67285.79,EUR,Shell
TXN0000000175,2024-02-21T02:04:20,ACC00003579,Debit,860.77,-68146.56,EUR,Target
TXN0000000176,2024-06-29T06:08:46,ACC00001536,Credit,703.3,-67443.26,EUR,Online Store
TXN0000000177,2024-07-06T17:51:11,ACC00009507,ATM,1634.56,-69077.82,USD,Amazon
TXN0000000178,2024-04-16T14:35:39,ACC00001856,Payment,1681.73,-70759.55,GBP,Restaurant
TXN0000000179,2024-11-24T06:01:44,ACC00009050,Transfer,1471.59,-69287.96,EUR,Amazon
TXN0000000180,2024-11-20T11:25:51,ACC00006120,Debit,930.41,-70218.37,USD,Grocery
TXN0000000181,2024-03-02T03:52:33,ACC00009678,ATM,1824.4,-72042.77,EUR,Grocery
TXN0000000182,2024-05-11T10:16:14,ACC00001045,Payment,1268.18,-73310.95,JPY,Grocery
TXN0000000183,2024-05-07T23:38:50,ACC00007709,Payment,700.31,-74011.26,JPY,Walmart
TXN0000000184,2024-03-17T03:53:54,ACC00002243,Debit,1242.25,-75253.51,GBP,Grocery
TXN0000000185,2024-11-25T18:25:45,ACC00001852,ATM,736.77,-75990.28,GBP,Online Store
TXN0000000186,2024-05-15T17:51:38,ACC00005664,Credit,1323.26,-74667.02,JPY,Walmart
TXN0000000187,2024-07-21T20:34:25,ACC00008045,ATM,1598.56,-76265.58,GBP,Grocery
TXN0000000188,2024-12-06T14:14:45,ACC00001699,Transfer,1693.83,-74571.75,JPY,Walmart
TXN0000000189,2024-06-08T11:08:04,ACC00006349,ATM,1318.68,-75890.43,JPY,Walmart
TXN0000000190,2024-11-19T15:22:58,ACC00007842,Debit,759.29,-76649.72,JPY,Starbucks
TXN0000000191,2024-11-17T12:35:49,ACC00000438,Debit,886.82,-77536.54,JPY,Target
TXN0000000192,2024-07-05T13:03:45,ACC00002228,Debit,1289.21,-78825.75,EUR,Online Store
TXN0000000193,2024-12-19T15:58:30,ACC00002872,Payment,730.59,-79556.34,USD,Walmart
TXN0000000194,2024-04-26T08:45:29,ACC00006593,Credit,1761.55,-77794.79,JPY,Walmart
TXN0000000195,2024-12-03T13:32:47,ACC00007516,Transfer,856.89,-76937.9,GBP,Amazon
TXN0000000196,2024-02-06T22:02:39,ACC00006994,Credit,93.45,-76844.45,JPY,Amazon
TXN0000000197,2024-10-24T18:20:43,ACC00001772,Transfer,548.98,-76295.47,EUR,Restaurant
TXN0000000198,2024-04-07T20:57:24,ACC00001598,Transfer,1745.4,-74550.07,USD,Online Store
TXN0000000199,2024-06-20T23:15:06,ACC00009241,Credit,1250.06,-73300.01,EUR,Shell
TXN0000000200,2024-01-25T14:11:03,ACC00007363,Payment,1576.88,-74876.89,JPY,Online Store
TXN0000000201,2024-11-14T10:47:26,ACC00007400,Credit,1799.69,-73077.2,EUR,Target
TXN0000000202,2024-04-21T01:52:29,ACC00005481,ATM,401.1,-73478.3,USD,Grocery
TXN0000000203,2024-03-03T09:29:13,ACC00007863,Payment,376.57,-73854.87,USD,Restaurant
TXN0000000204,2024-08-22T07:02:23,ACC00000228,Debit,1549.71,-75404.58,GBP,Restaurant
TXN0000000205,2024-09-20T14:07:12,ACC00001797,Payment,409.67,-75814.25,JPY,Target
TXN0000000206,2024-11-24T00:35:49,ACC00008849,Debit,1726.66,-77540.91,USD,Online Store
TXN0000000207,2024-05-05T08:59:54,ACC00005089,Transfer,717.11,-76823.8,GBP,Shell
TXN0000000208,2024-05-23T16:07:19,ACC00000036,Payment,750.94,-77574.74,USD,Shell
TXN0000000209,2024-03-21T14:22:44,ACC00005991,Transfer,1328.55,-76246.19,USD,Amazon
TXN0000000210,2024-07-22T14:21:33,ACC00000008,Transfer,678.83,-75567.36,USD,Shell
TXN0000000211,2024-10-17T16:33:38,ACC00002503,Credit,231.23,-75336.13,USD,Shell
TXN0000000212,2024-03-13T23:54:14,ACC00007585,ATM,1756.65,-77092.78,JPY,Online Store
TXN0000000213,2024-11-21T14:48:47,ACC00002517,Debit,1710.71,-78803.49,JPY,Restaurant
TXN0000000214,2024-03-06T11:52:43,ACC00007727,Transfer,382.58,-78420.91,USD,Target
TXN0000000215,2024-12-01T06:30:51,ACC00009970,Credit,482.35,-77938.56,USD,Restaurant
TXN0000000216,2024-02-14T13:07:54,ACC00003040,ATM,1479.62,-79418.18,EUR,Amazon
TXN0000000217,2024-10-06T20:09:53,ACC00006871,Credit,1050.91,-78367.27,EUR,Online Store
TXN0000000218,2024-02-29T05:25:53,ACC00004439,ATM,1660.38,-80027.65,EUR,Shell
TXN0000000219,2024-09-07T06:43:43,ACC00009467,Debit,383.88,-80411.53,JPY,Starbucks
TXN0000000220,2024-04-18T07:19:39,ACC00002456,Debit,1893.21,-82304.74,USD,Starbucks
TXN0000000221,2024-09-04T11:01:48,ACC00006883,Transfer,1860.2,-80444.54,JPY,Walmart
TXN0000000222,2024-04-17T19:31:08,ACC00000162,Transfer,509.11,-79935.43,JPY,Online Store
TXN0000000223,2024-09-14T13:37:28,ACC00006044,Credit,928.75,-79006.68,GBP,Amazon
TXN0000000224,2024-01-02T06:36:20,ACC00009073,Transfer,1764.54,-77242.14,GBP,Shell
TXN0000000225,2024-01-23T12:34:42,ACC00001221,Credit,94.46,-77147.68,EUR,Online Store
TXN0000000226,2024-11-16T23:21:19,ACC00009276,Transfer,1225.26,-75922.42,JPY,Target
TXN0000000227,2024-08-20T18:22:43,ACC00000112,Transfer,1310.79,-74611.63,EUR,Online Store
TXN0000000228,2024-09-29T09:03:19,ACC00004997,ATM,171.98,-74783.61,JPY,Restaurant
TXN0000000229,2024-03-06T04:06:43,ACC00005438,ATM,652.02,-75435.63,EUR,Walmart
TXN0000000230,2024-05-15T23:21:42,ACC00008859,ATM,382.91,-75818.54,JPY,Grocery
TXN0000000231,2024-10-31T00:51:37,ACC00006225,Credit,152.2,-75666.34,GBP,Target
TXN0000000232,2024-05-01T20:17:23,ACC00009009,Payment,1753.89,-77420.23,EUR,Online Store
TXN0000000233,2024-08-11T20:23:13,ACC00006019,Debit,414.27,-77834.5,EUR,Amazon
TXN0000000234,2024-11-18T06:21:33,ACC00004312,Debit,758.52,-78593.02,JPY,Walmart
TXN0000000235,2024-08-18T18:24:35,ACC00000349,Credit,542.7,-78050.32,EUR,Amazon
TXN0000000236,2024-10-30T18:27:17,ACC00004811,ATM,628.47,-78678.79,GBP,Target
TXN0000000237,2024-09-18T03:08:54,ACC00005144,Payment,1202.52,-79881.31,GBP,Grocery
TXN0000000238,2024-09-06T23:48:12,ACC00007601,Credit,1010.88,-78870.43,USD,Amazon
TXN0000000239,2024-08-06T23:11:45,ACC00002214,ATM,1497.67,-80368.1,USD,Starbucks
TXN0000000240,2024-06-03T12:17:23,ACC00007613,ATM,1140.16,-81508.26,EUR,Online Store
TXN0000000241,2024-06-20T04:37:28,ACC00007178,Payment,845.61,-82353.87,GBP,Grocery
TXN0000000242,2024-12-18T01:13:25,ACC00005683,Payment,1177.08,-83530.95,USD,Shell
TXN0000000243,2024-09-06T01:44:42,ACC00004879,ATM,60.88,-83591.83,GBP,Starbucks
TXN0000000244,2024-11-29T20:10:39,ACC00007188,Credit,1921.77,-81670.06,EUR,Walmart
TXN0000000245,2024-06-17T15:09:26,ACC00006059,Payment,781.5,-82451.56,JPY,Restaurant
TXN0000000246,2024-09-08T08:21:18,ACC00001671,Payment,1439.45,-83891.01,EUR,Amazon
TXN0000000247,2024-06-29T23:34:58,ACC00005493,Debit,1098.04,-84989.05,JPY,Shell
TXN0000000248,2024-08-30T20:56:02,ACC00000120,Transfer,1813.83,-83175.22,USD,Amazon
TXN0000000249,2024-01-23T10:15:15,ACC00002728,Credit,1631.93,-81543.29,USD,Online Store
TXN0000000250,2024-11-02T21:53:46,ACC00009147,Payment,100.92,-81644.21,JPY,Target
TXN0000000251,2024-01-17T06:02:31,ACC00009688,Transfer,918.08,-80726.13,GBP,Online Store
TXN0000000252,2024-12-26T07:57:33,ACC00004436,Transfer,1995.1,-78731.03,USD,Starbucks
TXN0000000253,2024-07-13T14:12:54,ACC00002007,Credit,1965.81,-76765.22,JPY,Starbucks
TXN0000000254,2024-01-03T16:07:18,ACC00009576,Credit,329.86,-76435.36,GBP,Restaurant
TXN0000000255,2024-03-04T00:56:06,ACC00008683,Debit,1799.61,-78234.97,GBP,Target
TXN0000000256,2024-02-11T02:28:17,ACC00009108,ATM,1588.57,-79823.54,GBP,Amazon
TXN0000000257,2024-12-12T21:48:20,ACC00006409,Payment,193.61,-80017.15,GBP,Target
TXN0000000258,2024-06-27T20:42:46,ACC00008119,Debit,1725.64,-81742.79,JPY,Restaurant
TXN0000000259,2024-12-09T19:56:54,ACC00003851,Payment,350.83,-82093.62,USD,Grocery
TXN0000000260,2024-07-24T03:26:24,ACC00003351,Transfer,867.29,-81226.33,EUR,Amazon
TXN0000000261,2024-10-15T17:51:24,ACC00008236,Transfer,1871.57,-79354.76,EUR,Target
TXN0000000262,2024-11-19T12:12:09,ACC00003960,Debit,1667.96,-81022.72,JPY,Starbucks
TXN0000000263,2024-12-10T07:24:09,ACC00002492,Debit,365.25,-81387.97,USD,Online Store
TXN0000000264,2024-11-03T19:04:47,ACC00007549,Credit,589.61,-80798.36,JPY,Online Store
TXN0000000265,2024-01-22T16:03:09,ACC00001945,Debit,463.33,-81261.69,EUR,Restaurant
TXN0000000266,2024-05-09T16:08:24,ACC00006004,Payment,113.18,-81374.87,EUR,Target
TXN0000000267,2024-03-10T05:33:36,ACC00005567,ATM,103.05,-81477.92,GBP,Restaurant
TXN0000000268,2024-03-14T02:17:45,ACC00009486,Payment,914.1,-82392.02,EUR,Starbucks
TXN0000000269,2024-11-17T04:38:15,ACC00002842,ATM,651.25,-83043.27,JPY,Walmart
TXN0000000270,2024-07-14T10:14:57,ACC00001730,Payment,382.07,-83425.34,JPY,Walmart
TXN0000000271,2024-07-23T16:54:39,ACC00007101,Payment,572.97,-83998.31,USD,Restaurant
TXN0000000272,2024-07-27T11:36:04,ACC00008179,Credit,812.48,-83185.83,EUR,Shell
TXN0000000273,2024-06-09T14:45:05,ACC00007692,Payment,1042.53,-84228.36,USD,Restaurant
TXN0000000274,2024-09-22T17:15:53,ACC00002091,Debit,1083.88,-85312.24,USD,Restaurant
TXN0000000275,2024-07-15T15:13:08,ACC00000099,ATM,314.7,-85626.94,USD,Grocery
TXN0000000276,2024-10-07T19:12:50,ACC00008156,Debit,761.63,-86388.57,JPY,Walmart
TXN0000000277,2024-05-14T19:06:51,ACC00009865,Credit,1215.59,-85172.98,EUR,Walmart
TXN0000000278,2024-07-28T21:43:56,ACC00001681,Credit,1950.04,-83222.94,JPY,Starbucks
TXN0000000279,2024-11-12T10:35:23,ACC00009576,Credit,1415.47,-81807.47,USD,Starbucks
TXN0000000280,2024-07-11T02:43:12,ACC00005627,Payment,1581.55,-83389.02,GBP,Shell
TXN0000000281,2024-03-13T05:12:13,ACC00001490,Payment,1930.54,-85319.56,GBP,Restaurant
TXN0000000282,2024-02-14T16:27:44,ACC00005640,ATM,75.8,-85395.36,JPY,Amazon
TXN0000000283,2024-03-25T19:41:24,ACC00007918,Debit,979.54,-86374.9,JPY,Restaurant
TXN0000000284,2024-12-07T07:47:23,ACC00008531,Debit,317.3,-86692.2,JPY,Target
TXN0000000285,2024-04-16T00:59:15,ACC00004191,Payment,1075.11,-87767.31,GBP,Starbucks
TXN0000000286,2024-05-19T09:24:51,ACC00008864,ATM,1717.34,-89484.65,EUR,Online Store
TXN0000000287,2024-12-11T04:27:31,ACC00002944,ATM,1146.49,-90631.14,GBP,Restaurant
TXN0000000288,2024-11-17T14:20:06,ACC00001638,Debit,1531.41,-92162.55,USD,Target
TXN0000000289,2024-10-23T14:04:55,ACC00003539,Debit,975.97,-93138.52,USD,Grocery
TXN0000000290,2024-07-22T01:26:06,ACC00000851,Credit,995.6,-92142.92,GBP,Target
TXN0000000291,2024-12-08T02:00:16,ACC00008676,Payment,868.31,-93011.23,USD,Amazon
TXN0000000292,2024-07-02T08:37:56,ACC00005852,Debit,1133.72,-94144.95,USD,Online Store
TXN0000000293,2024-02-28T07:05:53,ACC00007876,Payment,1728.76,-95873.71,GBP,Shell
TXN0000000294,2024-12-03T10:55:27,ACC00001537,Credit,182.16,-95691.55,USD,Target
TXN0000000295,2024-11-08T10:29:48,ACC00003679,Payment,240.58,-95932.13,EUR,Shell
TXN0000000296,2024-12-24T06:05:26,ACC00003100,Transfer,72.11,-95860.02,GBP,Walmart
TXN0000000297,2024-03-21T21:34:07,ACC00005647,Payment,1062.48,-96922.5,USD,Amazon
TXN0000000298,2024-10-07T06:30:11,ACC00008869,Payment,1045.29,-97967.79,EUR,Grocery
TXN0000000299,2024-09-13T22:16:29,ACC00007436,Transfer,680.87,-97286.92,EUR,Shell
TXN0000000300,2024-08-08T13:33:10,ACC00004045,Credit,607.6,-96679.32,GBP,Walmart
TXN0000000301,2024-12-21T09:30:09,ACC00009325,Credit,1633.75,-95045.57,USD,Online Store
TXN0000000302,2024-01-01T12:41:29,ACC00005464,Credit,1891.96,-93153.61,EUR,Walmart
TXN0000000303,2024-08-05T07:24:22,ACC00005229,ATM,725.72,-93879.33,JPY,Online Store
TXN0000000304,2024-12-24T15:07:04,ACC00007096,Payment,1253.18,-95132.51,JPY,Grocery
TXN0000000305,2024-03-31T06:02:29,ACC00004302,Payment,75.79,-95208.3,GBP,Grocery
TXN0000000306,2024-01-24T04:08:17,ACC00003874,Payment,820.3,-96028.6,GBP,Walmart
TXN0000000307,2024-02-20T13:45:18,ACC00005843,Transfer,1929.41,-94099.19,EUR,Grocery
TXN0000000308,2024-01-07T09:03:11,ACC00005361,Debit,160.63,-94259.82,USD,Walmart
TXN0000000309,2024-03-04T02:12:01,ACC00005408,Debit,1262.36,-95522.18,JPY,Shell
TXN0000000310,2024-04-02T21:38:02,ACC00008262,Payment,1877.55,-97399.73,JPY,Shell
TXN0000000311,2024-08-18T01:56:45,ACC00003323,ATM,1524.25,-98923.98,JPY,Walmart
TXN0000000312,2024-10-27T07:50:01,ACC00002221,ATM,1384.49,-100308.47,EUR,Shell
TXN0000000313,2024-08-02T21:02:49,ACC00000750,Transfer,1059.93,-99248.54,JPY,Online Store
TXN0000000314,2024-03-16T15:37:41,ACC00001651,Credit,1119.8,-98128.74,GBP,Target
TXN0000000315,2024-08-09T22:59:48,ACC00007729,Credit,1676.24,-96452.5,EUR,Grocery
TXN0000000316,2024-03-11T04:52:05,ACC00002781,Credit,1112.51,-95339.99,EUR,Online Store
TXN0000000317,2024-01-19T19:54:19,ACC00008063,Debit,1853.5,-97193.49,EUR,Target
TXN0000000318,2024-05-30T20:11:37,ACC00006833,Debit,19.07,-97212.56,JPY,Starbucks
TXN0000000319,2024-03-21T10:58:57,ACC00007230,Debit,939.44,-98152.0,JPY,Starbucks
TXN0000000320,2024-01-28T20:32:40,ACC00005048,ATM,1753.13,-99905.13,EUR,Starbucks
TXN0000000321,2024-07-10T16:00:33,ACC00005709,ATM,170.7,-100075.83,JPY,Amazon
TXN0000000322,2024-03-17T11:02:45,ACC00004749,Payment,1167.1,-101242.93,JPY,Starbucks
TXN0000000323,2024-07-11T18:37:27,ACC00007965,Transfer,858.75,-100384.18,EUR,Starbucks
TXN0000000324,2024-07-27T10:43:01,ACC00007847,Credit,490.44,-99893.74,JPY,Starbucks
TXN0000000325,2024-01-30T22:53:05,ACC00004678,Payment,19.61,-99913.35,JPY,Starbucks
TXN0000000326,2024-03-19T09:06:46,ACC00004582,ATM,1521.72,-101435.07,JPY,Shell
TXN0000000327,2024-06-01T23:33:46,ACC00006618,Transfer,1786.45,-99648.62,GBP,Grocery
TXN0000000328,2024-12-17T13:20:53,ACC00001083,Transfer,1574.2,-98074.42,JPY,Target
TXN0000000329,2024-06-28T11:37:54,ACC00007049,Debit,1695.66,-99770.08,EUR,Online Store
TXN0000000330,2024-09-24T03:35:12,ACC00004650,Credit,1677.45,-98092.63,GBP,Restaurant
TXN0000000331,2024-07-11T03:44:16,ACC00001223,Credit,189.02,-97903.61,JPY,Grocery
TXN0000000332,2024-06-11T08:36:14,ACC00003416,ATM,1789.13,-99692.74,EUR,Online Store
TXN0000000333,2024-07-25T15:54:48,ACC00005974,ATM,44.9,-99737.64,USD,Starbucks
TXN0000000334,2024-08-08T00:23:10,ACC00005281,Debit,1566.91,-101304.55,JPY,Amazon
TXN0000000335,2024-08-03T02:29:48,ACC00007246,ATM,1188.19,-102492.74,JPY,Shell
TXN0000000336,2024-09-12T00:44:30,ACC00004244,Transfer,160.63,-102332.11,USD,Online Store
TXN0000000337,2024-12-20T11:11:56,ACC00000428,ATM,662.02,-102994.13,JPY,Grocery
TXN0000000338,2024-06-17T13:54:29,ACC00003462,ATM,690.16,-103684.29,EUR,Online Store
TXN0000000339,2024-09-16T00:00:44,ACC00001448,Credit,1480.61,-102203.68,EUR,Amazon
TXN0000000340,2024-08-20T00:22:07,ACC00005444,Credit,1718.58,-100485.1,GBP,Target
TXN0000000341,2024-07-18T06:02:51,ACC00007422,ATM,296.77,-100781.87,USD,Amazon
TXN0000000342,2024-02-03T06:49:53,ACC00003680,Transfer,1591.35,-99190.52,USD,Shell
TXN0000000343,2024-06-17T18:43:28,ACC00008779,ATM,354.85,-99545.37,JPY,Target
TXN0000000344,2024-12-06T09:22:13,ACC00008697,Transfer,1489.33,-98056.04,GBP,Online Store
TXN0000000345,2024-01-28T04:25:58,ACC00004552,Payment,232.92,-98288.96,EUR,Shell
TXN0000000346,2024-04-21T22:50:50,ACC00008788,Debit,324.82,-98613.78,JPY,Restaurant
TXN0000000347,2024-01-09T05:27:13,ACC00009321,Payment,339.38,-98953.16,USD,Walmart
TXN0000000348,2024-05-12T04:57:40,ACC00002152,ATM,824.12,-99777.28,GBP,Online Store
TXN0000000349,2024-09-16T13:13:45,ACC00005442,Debit,1408.25,-101185.53,EUR,Starbucks
TXN0000000350,2024-04-28T13:50:20,ACC00007803,Debit,584.58,-101770.11,USD,Restaurant
TXN0000000351,2024-10-06T02:02:13,ACC00007537,Transfer,750.51,-101019.6,EUR,Target
TXN0000000352,2024-06-18T21:52:26,ACC00007720,Payment,101.03,-101120.63,GBP,Online Store
TXN0000000353,2024-01-24T14:47:17,ACC00007683,Payment,190.86,-101311.49,JPY,Amazon
TXN0000000354,2024-12-19T00:36:04,ACC00002123,Payment,817.14,-102128.63,GBP,Target
TXN0000000355,2024-04-16T16:42:11,ACC00007487,Credit,1418.39,-100710.24,EUR,Shell
TXN0000000356,2024-04-26T18:10:54,ACC00004062,ATM,1591.32,-102301.56,JPY,Amazon
TXN0000000357,2024-03-25T04:58:32,ACC00007406,Payment,1655.99,-103957.55,GBP,Grocery
TXN0000000358,2024-12-14T08:35:07,ACC00005005,Credit,130.14,-103827.41,USD,Walmart
TXN0000000359,2024-01-05T02:15:47,ACC00009462,Payment,1823.42,-105650.83,USD,Grocery
TXN0000000360,2024-10-12T08:16:04,ACC00002957,Debit,166.56,-105817.39,EUR,Target
TXN0000000361,2024-06-28T14:12:11,ACC00004873,Transfer,999.11,-104818.28,GBP,Amazon
TXN0000000362,2024-12-08T07:06:19,ACC00000124,Credit,1299.34,-103518.94,EUR,Online Store
TXN0000000363,2024-03-01T12:29:36,ACC00005633,Debit,1258.62,-104777.56,USD,Restaurant
TXN0000000364,2024-10-10T15:54:34,ACC00001664,ATM,86.46,-104864.02,USD,Restaurant
TXN0000000365,2024-05-16T03:57:35,ACC00003962,Payment,150.38,-105014.4,JPY,Shell
TXN0000000366,2024-09-03T04:25:43,ACC00001641,Debit,1258.18,-106272.58,JPY,Restaurant
TXN0000000367,2024-11-07T14:56:01,ACC00008879,Payment,1127.17,-107399.75,JPY,Target
TXN0000000368,2024-06-21T09:15:51,ACC00002617,Credit,690.34,-106709.41,EUR,Walmart
TXN0000000369,2024-10-18T11:55:49,ACC00002461,Payment,81.79,-106791.2,GBP,Starbucks
TXN0000000370,2024-12-10T07:46:17,ACC00007203,ATM,378.37,-107169.57,EUR,Starbucks
TXN0000000371,2024-05-18T21:07:54,ACC00002663,Transfer,506.89,-106662.68,GBP,Target
TXN0000000372,2024-07-11T00:41:12,ACC00009994,Transfer,1058.89,-105603.79,USD,Walmart
TXN0000000373,2024-02-14T04:33:16,ACC00005212,Credit,21.21,-105582.58,USD,Starbucks
TXN0000000374,2024-09-04T12:15:47,ACC00006187,ATM,906.34,-106488.92,JPY,Walmart
TXN0000000375,2024-01-28T21:11:54,ACC00003096,Credit,472.47,-106016.45,GBP,Amazon
TXN0000000376,2024-12-21T19:49:11,ACC00003386,Payment,954.66,-106971.11,USD,Walmart
TXN0000000377,2024-07-20T22:44:23,ACC00002922,Credit,798.49,-106172.62,USD,Grocery
TXN0000000378,2024-02-01T01:35:08,ACC00007639,Payment,292.17,-106464.79,GBP,Walmart
TXN0000000379,2024-09-15T13:42:47,ACC00005635,Payment,1898.39,-108363.18,JPY,Restaurant
TXN0000000380,2024-04-22T07:37:17,ACC00003944,ATM,1158.06,-109521.24,JPY,Restaurant
TXN0000000381,2024-05-22T18:29:06,ACC00006653,Credit,529.68,-108991.56,EUR,Target
TXN0000000382,2024-02-09T12:32:45,ACC00000262,Payment,362.74,-109354.3,GBP,Restaurant
TXN0000000383,2024-03-26T12:52:50,ACC00003550,Payment,1072.87,-110427.17,EUR,Target
TXN0000000384,2024-05-10T10:52:12,ACC00001589,Payment,476.46,-110903.63,USD,Target
TXN0000000385,2024-06-16T02:13:26,ACC00002241,Payment,1696.93,-112600.56,USD,Amazon
TXN0000000386,2024-06-03T09:46:26,ACC00005781,Credit,1506.39,-111094.17,JPY,Online Store
TXN0000000387,2024-08-16T20:38:12,ACC00006599,Credit,1593.71,-109500.46,EUR,Online Store
TXN0000000388,2024-01-31T05:46:47,ACC00004566,Debit,308.74,-109809.2,JPY,Shell
TXN0000000389,2024-05-22T13:41:00,ACC00004426,ATM,1897.53,-111706.73,JPY,Walmart
TXN0000000390,2024-02-16T14:07:44,ACC00002421,Transfer,1957.49,-109749.24,JPY,Target
TXN0000000391,2024-03-29T18:43:40,ACC00003282,ATM,900.7,-110649.94,GBP,Target
TXN0000000392,2024-08-12T00:36:37,ACC00002316,ATM,968.4,-111618.34,USD,Restaurant
TXN0000000393,2024-01-04T05:18:15,ACC00006610,Transfer,1122.95,-110495.39,USD,Online Store
TXN0000000394,2024-02-08T04:02:35,ACC00005152,Payment,317.48,-110812.87,JPY,Online Store
TXN0000000395,2024-09-26T02:30:05,ACC00004681,Debit,593.46,-111406.33,GBP,Walmart
TXN0000000396,2024-06-16T22:58:23,ACC00006434,Transfer,1998.63,-109407.7,GBP,Starbucks
TXN0000000397,2024-03-29T01:20:58,ACC00001424,Payment,1076.99,-110484.69,GBP,Starbucks
TXN0000000398,2024-08-20T23:35:31,ACC00008278,ATM,127.89,-110612.58,JPY,Amazon
TXN0000000399,2024-06-25T22:02:27,ACC00003903,Payment,746.85,-111359.43,USD,Grocery
TXN0000000400,2024-08-21T12:06:30,ACC00005720,Payment,674.25,-112033.68,USD,Shell
TXN0000000401,2024-03-16T19:33:39,ACC00008402,Transfer,642.5,-111391.18,USD,Walmart
TXN0000000402,2024-01-30T21:38:34,ACC00006590,Credit,1806.23,-109584.95,JPY,Shell
TXN0000000403,2024-08-09T23:27:44,ACC00006565,Debit,583.41,-110168.36,JPY,Restaurant
TXN0000000404,2024-04-12T19:57:52,ACC00003174,Credit,1505.71,-108662.65,JPY,Shell
TXN0000000405,2024-04-08T12:33:15,ACC00003002,Credit,654.26,-108008.39,GBP,Amazon
TXN0000000406,2024-06-29T03:13:10,ACC00006598,Transfer,1912.06,-106096.33,EUR,Starbucks
TXN0000000407,2024-07-16T02:34:34,ACC00009299,Credit,644.57,-105451.76,GBP,Amazon
TXN0000000408,2024-11-13T23:35:01,ACC00006665,Credit,614.6,-104837.16,EUR,Online Store
TXN0000000409,2024-08-04T14:06:27,ACC00001874,Credit,1660.77,-103176.39,GBP,Shell
TXN0000000410,2024-12-29T06:20:01,ACC00006182,Transfer,1981.89,-101194.5,USD,Starbucks
TXN0000000411,2024-11-15T07:20:04,ACC00003743,ATM,194.4,-101388.9,EUR,Shell
TXN0000000412,2024-12-30T12:08:14,ACC00006599,Transfer,872.7,-100516.2,EUR,Starbucks
TXN0000000413,2024-11-11T20:25:21,ACC00009479,Transfer,1403.71,-99112.49,GBP,Online Store
TXN0000000414,2024-07-10T02:43:10,ACC00001867,Transfer,1577.65,-97534.84,EUR,Starbucks
TXN0000000415,2024-04-07T13:08:46,ACC00007764,Debit,919.55,-98454.39,USD,Online Store
TXN0000000416,2024-10-31T16:46:33,ACC00003965,Payment,1586.35,-100040.74,USD,Shell
TXN0000000417,2024-07-08T02:33:11,ACC00003664,Transfer,1295.4,-98745.34,USD,Target
TXN0000000418,2024-12-01T00:57:07,ACC00004602,ATM,1646.84,-100392.18,GBP,Grocery
TXN0000000419,2024-01-19T09:33:46,ACC00002979,Credit,1688.88,-98703.3,JPY,Grocery
TXN0000000420,2024-01-29T02:43:17,ACC00000014,Credit,1449.15,-97254.15,JPY,Shell
TXN0000000421,2024-05-23T13:20:23,ACC00005841,Debit,595.95,-97850.1,USD,Online Store
TXN0000000422,2024-02-24T14:41:05,ACC00006770,Payment,1065.75,-98915.85,JPY,Walmart
TXN0000000423,2024-04-15T02:12:39,ACC00008181,ATM,352.26,-99268.11,GBP,Walmart
TXN0000000424,2024-08-16T11:28:45,ACC00006401,ATM,696.09,-99964.2,GBP,Amazon
TXN0000000425,2024-10-26T12:53:39,ACC00007828,ATM,222.0,-100186.2,USD,Restaurant
TXN0000000426,2024-06-23T03:36:43,ACC00002045,ATM,1027.74,-101213.94,GBP,Amazon
TXN0000000427,2024-12-11T06:57:37,ACC00008356,Payment,647.4,-101861.34,USD,Online Store
TXN0000000428,2024-04-18T09:28:48,ACC00006655,Payment,1484.79,-103346.13,GBP,Grocery
TXN0000000429,2024-09-01T14:29:30,ACC00001086,Credit,968.96,-102377.17,GBP,Shell
TXN0000000430,2024-03-17T08:45:24,ACC00009842,Transfer,1903.78,-100473.39,EUR,Target
TXN0000000431,2024-09-14T10:51:50,ACC00007926,ATM,1378.72,-101852.11,JPY,Walmart
TXN0000000432,2024-08-24T13:55:59,ACC00003827,Payment,1498.39,-103350.5,USD,Grocery
TXN0000000433,2024-03-08T14:56:45,ACC00008333,Credit,1385.12,-101965.38,EUR,Amazon
TXN0000000434,2024-04-24T08:43:25,ACC00001167,Transfer,1583.1,-100382.28,GBP,Shell
TXN0000000435,2024-11-23T17:12:00,ACC00006067,Transfer,944.29,-99437.99,JPY,Online Store
TXN0000000436,2024-11-19T19:35:47,ACC00006531,Debit,1399.07,-100837.06,JPY,Starbucks
TXN0000000437,2024-02-28T08:52:21,ACC00006862,Debit,760.01,-101597.07,USD,Amazon
TXN0000000438,2024-01-22T05:03:14,ACC00006900,ATM,258.67,-101855.74,EUR,Grocery
TXN0000000439,2024-10-09T00:00:42,ACC00006579,ATM,774.22,-102629.96,GBP,Online Store
TXN0000000440,2024-06-20T10:58:48,ACC00000216,Debit,835.43,-103465.39,USD,Restaurant
TXN0000000441,2024-06-28T02:18:36,ACC00009253,Transfer,997.08,-102468.31,JPY,Grocery
TXN0000000442,2024-01-07T14:33:27,ACC00002514,ATM,1094.78,-103563.09,JPY,Starbucks
TXN0000000443,2024-12-29T13:27:25,ACC00000293,Transfer,1801.91,-101761.18,USD,Shell
TXN0000000444,2024-12-03T08:31:43,ACC00008256,Debit,628.74,-102389.92,JPY,Grocery
TXN0000000445,2024-07-04T17:36:49,ACC00009514,Transfer,615.69,-101774.23,GBP,Restaurant
TXN0000000446,2024-12-02T20:21:58,ACC00000958,Transfer,1326.04,-100448.19,EUR,Grocery
TXN0000000447,2024-12-09T22:00:17,ACC00001909,Payment,616.68,-101064.87,JPY,Starbucks
TXN0000000448,2024-04-02T03:12:41,ACC00007265,Transfer,1935.51,-99129.36,EUR,Online Store
TXN0000000449,2024-01-13T05:12:31,ACC00003883,Payment,223.78,-99353.14,JPY,Online Store
TXN0000000450,2024-03-07T01:19:46,ACC00004994,ATM,1446.93,-100800.07,JPY,Restaurant
TXN0000000451,2024-12-27T07:15:24,ACC00002770,Payment,1789.47,-102589.54,USD,Walmart
TXN0000000452,2024-01-29T18:24:07,ACC00001355,Credit,1968.39,-100621.15,JPY,Walmart
TXN0000000453,2024-11-10T13:36:30,ACC00004184,Transfer,702.54,-99918.61,EUR,Target
TXN0000000454,2024-12-15T16:17:15,ACC00000489,Payment,1746.0,-101664.61,GBP,Online Store
TXN0000000455,2024-04-30T09:05:01,ACC00002978,Payment,911.49,-102576.1,USD,Restaurant
TXN0000000456,2024-05-09T22:24:01,ACC00008967,Credit,1393.71,-101182.39,GBP,Grocery
TXN0000000457,2024-09-21T01:26:58,ACC00009956,Transfer,493.24,-100689.15,EUR,Shell
TXN0000000458,2024-11-05T19:57:40,ACC00001242,Payment,574.99,-101264.14,USD,Restaurant
TXN0000000459,2024-06-04T16:44:03,ACC00004579,ATM,678.24,-101942.38,GBP,Amazon
TXN0000000460,2024-02-19T18:31:53,ACC00001375,Debit,342.53,-102284.91,JPY,Restaurant
TXN0000000461,2024-10-14T12:31:16,ACC00003743,Transfer,333.24,-101951.67,USD,Restaurant
TXN0000000462,2024-12-18T21:20:56,ACC00008155,ATM,1579.14,-103530.81,EUR,Walmart
TXN0000000463,2024-09-19T08:09:40,ACC00004375,Credit,1104.19,-102426.62,USD,Walmart
TXN0000000464,2024-12-12T12:38:09,ACC00008665,Payment,1905.57,-104332.19,EUR,Shell
TXN0000000465,2024-11-27T04:19:09,ACC00006528,Transfer,1421.73,-102910.46,EUR,Target
TXN0000000466,2024-11-22T11:02:19,ACC00001056,Debit,712.0,-103622.46,JPY,Starbucks
TXN0000000467,2024-08-03T06:42:18,ACC00004167,Debit,1420.12,-105042.58,JPY,Restaurant
TXN0000000468,2024-05-28T18:32:59,ACC00006564,ATM,1692.65,-106735.23,GBP,Restaurant
TXN0000000469,2024-05-04T15:51:50,ACC00004233,Debit,355.31,-107090.54,GBP,Restaurant
TXN0000000470,2024-09-27T05:31:19,ACC00009856,ATM,336.7,-107427.24,GBP,Shell
TXN0000000471,2024-06-19T23:28:58,ACC00000999,Transfer,1181.52,-106245.72,EUR,Starbucks
TXN0000000472,2024-01-12T05:56:26,ACC00004060,Debit,918.32,-107164.04,JPY,Target
TXN0000000473,2024-04-08T03:03:36,ACC00000011,Transfer,1830.87,-105333.17,USD,Target
TXN0000000474,2024-02-19T11:16:47,ACC00009039,Credit,546.9,-104786.27,GBP,Amazon
TXN0000000475,2024-01-11T12:38:43,ACC00001438,Debit,435.93,-105222.2,EUR,Amazon
TXN0000000476,2024-11-30T14:55:54,ACC00002764,Transfer,1990.42,-103231.78,EUR,Online Store
TXN0000000477,2024-05-01T17:05:37,ACC00006710,ATM,1536.87,-104768.65,GBP,Target
TXN0000000478,2024-04-27T03:24:16,ACC00001706,Debit,1548.33,-106316.98,EUR,Walmart
TXN0000000479,2024-02-12T03:31:02,ACC00004672,Debit,807.76,-107124.74,GBP,Walmart
TXN0000000480,2024-06-01T06:10:54,ACC00008037,Credit,1172.18,-105952.56,JPY,Online Store
TXN0000000481,2024-11-19T16:06:00,ACC00004464,Credit,1646.15,-104306.41,EUR,Online Store
TXN0000000482,2024-07-19T12:26:30,ACC00003665,Payment,924.96,-105231.37,JPY,Restaurant
TXN0000000483,2024-06-24T02:59:55,ACC00006191,Payment,229.27,-105460.64,GBP,Grocery
TXN0000000484,2024-06-29T01:26:43,ACC00006407,Credit,1094.07,-104366.57,EUR,Starbucks
TXN0000000485,2024-10-11T16:53:22,ACC00005106,Transfer,1089.12,-103277.45,USD,Online Store
TXN0000000486,2024-08-27T07:45:29,ACC00003524,ATM,1432.68,-104710.13,EUR,Walmart
TXN0000000487,2024-01-11T07:18:27,ACC00003038,ATM,748.87,-105459.0,GBP,Target
TXN0000000488,2024-08-02T11:28:39,ACC00006732,Payment,75.11,-105534.11,EUR,Amazon
TXN0000000489,2024-10-14T05:43:46,ACC00003382,Debit,1057.59,-106591.7,USD,Shell
TXN0000000490,2024-07-20T00:28:13,ACC00005190,Credit,1143.52,-105448.18,EUR,Walmart
TXN0000000491,2024-09-10T03:16:04,ACC00006819,Transfer,733.85,-104714.33,EUR,Restaurant
TXN0000000492,2024-04-27T14:27:12,ACC00001662,ATM,1695.0,-106409.33,GBP,Grocery
TXN0000000493,2024-09-28T21:03:46,ACC00005107,Credit,519.56,-105889.77,EUR,Starbucks
TXN0000000494,2024-10-14T07:12:20,ACC00007058,Transfer,1229.89,-104659.88,JPY,Grocery
TXN0000000495,2024-04-19T17:43:24,ACC00004331,Credit,1314.01,-103345.87,JPY,Online Store
TXN0000000496,2024-04-24T05:21:12,ACC00009173,ATM,1302.74,-104648.61,GBP,Target
TXN0000000497,2024-12-26T05:10:43,ACC00008784,Payment,1052.92,-105701.53,JPY,Grocery
TXN0000000498,2024-02-12T19:28:42,ACC00001088,Transfer,1017.42,-104684.11,JPY,Starbucks
TXN0000000499,2024-05-25T21:28:20,ACC00006907,ATM,1153.51,-105837.62,GBP,Restaurant
TXN0000000500,2024-01-04T01:32:55,ACC00004662,Credit,1884.92,-103952.7,JPY,Shell
TXN0000000501,2024-06-09T13:40:07,ACC00001472,Transfer,1092.2,-102860.5,GBP,Grocery
TXN0000000502,2024-02-29T13:31:17,ACC00004491,Credit,1211.44,-101649.06,EUR,Restaurant
TXN0000000503,2024-03-22T08:46:36,ACC00001988,Payment,1017.1,-102666.16,JPY,Amazon
TXN0000000504,2024-11-17T15:05:25,ACC00001089,Credit,199.23,-102466.93,USD,Restaurant
TXN0000000505,2024-11-08T07:08:59,ACC00002833,Debit,1840.55,-104307.48,GBP,Amazon
TXN0000000506,2024-12-02T12:08:54,ACC00007522,Credit,1321.51,-102985.97,USD,Restaurant
TXN0000000507,2024-07-21T19:10:31,ACC00000439,ATM,639.71,-103625.68,JPY,Online Store
TXN0000000508,2024-08-17T06:14:50,ACC00002150,Credit,380.87,-103244.81,USD,Walmart
TXN0000000509,2024-09-06T16:03:11,ACC00008762,Transfer,1756.81,-101488.0,JPY,Starbucks
TXN0000000510,2024-12-28T19:44:34,ACC00006384,Credit,1058.59,-100429.41,JPY,Online Store
TXN0000000511,2024-05-07T17:25:31,ACC00002006,Credit,634.39,-99795.02,GBP,Amazon
TXN0000000512,2024-09-22T19:05:20,ACC00004085,Transfer,452.88,-99342.14,GBP,Starbucks
TXN0000000513,2024-06-22T00:16:19,ACC00008034,Debit,1620.4,-100962.54,EUR,Amazon
TXN0000000514,2024-10-21T16:21:24,ACC00009929,Transfer,175.71,-100786.83,GBP,Amazon
TXN0000000515,2024-08-02T05:45:07,ACC00002465,Transfer,1501.47,-99285.36,EUR,Grocery
TXN0000000516,2024-11-14T16:04:03,ACC00000281,Transfer,1741.24,-97544.12,USD,Restaurant
TXN0000000517,2024-04-02T15:40:41,ACC00001545,ATM,1391.59,-98935.71,JPY,Shell
TXN0000000518,2024-11-25T17:26:58,ACC00006879,Debit,1261.88,-100197.59,USD,Walmart
TXN0000000519,2024-05-02T19:00:40,ACC00004225,Transfer,367.06,-99830.53,JPY,Restaurant
TXN0000000520,2024-02-27T22:18:02,ACC00000976,Debit,1206.01,-101036.54,EUR,Target
TXN0000000521,2024-01-12T12:50:51,ACC00003448,Debit,529.71,-101566.25,USD,Shell
TXN0000000522,2024-01-26T02:53:32,ACC00001245,Credit,1270.6,-100295.65,EUR,Target
TXN0000000523,2024-04-18T06:00:08,ACC00002250,Transfer,1229.16,-99066.49,USD,Online Store
TXN0000000524,2024-08-18T19:11:55,ACC00002647,Transfer,1406.46,-97660.03,EUR,Starbucks
TXN0000000525,2024-11-11T11:48:39,ACC00004832,Credit,768.0,-96892.03,EUR,Walmart
TXN0000000526,2024-03-20T04:20:24,ACC00003657,Credit,1593.42,-95298.61,EUR,Online Store
TXN0000000527,2024-07-10T08:39:40,ACC00007185,Payment,696.6,-95995.21,JPY,Restaurant
TXN0000000528,2024-05-10T09:27:29,ACC00008533,Debit,1910.66,-97905.87,GBP,Walmart
TXN0000000529,2024-10-22T10:12:46,ACC00005937,Transfer,854.32,-97051.55,GBP,Walmart
TXN0000000530,2024-04-30T04:50:50,ACC00004358,Transfer,1041.55,-96010.0,JPY,Online Store
TXN0000000531,2024-12-07T00:24:52,ACC00001348,Debit,1084.49,-97094.49,USD,Amazon
TXN0000000532,2024-06-25T07:55:42,ACC00004013,Payment,660.88,-97755.37,USD,Amazon
TXN0000000533,2024-03-20T14:41:33,ACC00006818,ATM,537.93,-98293.3,EUR,Starbucks
TXN0000000534,2024-11-29T12:24:59,ACC00004762,Payment,1982.81,-100276.11,EUR,Grocery
TXN0000000535,2024-06-12T09:49:13,ACC00008285,ATM,1956.6,-102232.71,EUR,Restaurant
TXN0000000536,2024-08-25T01:55:53,ACC00003716,Transfer,1621.41,-100611.3,GBP,Restaurant
TXN0000000537,2024-04-20T19:05:35,ACC00000911,Credit,1322.04,-99289.26,JPY,Restaurant
TXN0000000538,2024-01-13T23:15:45,ACC00000959,Credit,1472.9,-97816.36,EUR,Grocery
TXN0000000539,2024-05-21T16:21:30,ACC00006372,Payment,1642.71,-99459.07,EUR,Grocery
TXN0000000540,2024-04-20T15:07:36,ACC00005042,Payment,925.92,-100384.99,EUR,Target
TXN0000000541,2024-05-18T06:35:12,ACC00006287,Debit,1307.98,-101692.97,GBP,Amazon
TXN0000000542,2024-12-28T09:56:23,ACC00003618,Credit,1311.86,-100381.11,USD,Online Store
TXN0000000543,2024-06-26T11:59:38,ACC00003686,Payment,1821.77,-102202.88,GBP,Grocery
TXN0000000544,2024-01-21T18:50:15,ACC00004553,Debit,1168.33,-103371.21,GBP,Starbucks
TXN0000000545,2024-03-14T04:05:25,ACC00009677,Transfer,160.65,-103210.56,JPY,Shell
TXN0000000546,2024-08-05T16:18:37,ACC00001707,Transfer,1938.19,-101272.37,USD,Restaurant
TXN0000000547,2024-09-12T13:21:57,ACC00004297,ATM,1007.46,-102279.83,JPY,Grocery
TXN0000000548,2024-06-06T01:01:11,ACC00004301,Credit,1550.77,-100729.06,GBP,Walmart
TXN0000000549,2024-07-15T19:52:04,ACC00000015,Credit,1753.85,-98975.21,EUR,Target
TXN0000000550,2024-04-20T03:41:10,ACC00007730,Transfer,206.07,-98769.14,EUR,Grocery
TXN0000000551,2024-04-23T06:16:05,ACC00005808,Payment,262.96,-99032.1,JPY,Online Store
TXN0000000552,2024-02-28T10:46:56,ACC00005800,Payment,233.97,-99266.07,USD,Amazon
TXN0000000553,2024-08-12T14:46:23,ACC00005392,ATM,1993.11,-101259.18,JPY,Amazon
TXN0000000554,2024-08-03T22:21:58,ACC00002357,Payment,1374.82,-102634.0,JPY,Starbucks
TXN0000000555,2024-11-13T02:13:04,ACC00000427,Debit,319.38,-102953.38,GBP,Grocery
TXN0000000556,2024-03-06T04:46:09,ACC00001428,Payment,1294.29,-104247.67,USD,Restaurant
TXN0000000557,2024-05-23T22:30:08,ACC00000586,Payment,895.25,-105142.92,GBP,Online Store
TXN0000000558,2024-12-04T12:49:45,ACC00000027,Transfer,1754.99,-103387.93,USD,Grocery
TXN0000000559,2024-05-09T01:17:43,ACC00002620,ATM,1396.09,-104784.02,EUR,Grocery
TXN0000000560,2024-07-11T20:38:06,ACC00001420,Debit,230.09,-105014.11,USD,Starbucks
TXN0000000561,2024-07-03T18:48:52,ACC00007461,Credit,937.49,-104076.62,JPY,Amazon
TXN0000000562,2024-02-26T06:44:38,ACC00003232,ATM,605.2,-104681.82,GBP,Starbucks
TXN0000000563,2024-10-14T03:38:31,ACC00002837,Debit,919.89,-105601.71,USD,Restaurant
TXN0000000564,2024-07-14T06:28:00,ACC00008174,Credit,1946.87,-103654.84,JPY,Shell
TXN0000000565,2024-12-19T15:17:00,ACC00008008,ATM,898.66,-104553.5,GBP,Amazon
TXN0000000566,2024-07-19T23:53:05,ACC00007229,Payment,1795.16,-106348.66,EUR,Amazon
TXN0000000567,2024-01-29T10:04:39,ACC00003217,ATM,795.03,-107143.69,JPY,Shell
TXN0000000568,2024-04-02T17:19:40,ACC00008827,Credit,468.47,-106675.22,GBP,Amazon
TXN0000000569,2024-06-26T02:52:24,ACC00002245,Debit,1104.69,-107779.91,JPY,Target
TXN0000000570,2024-01-11T14:36:33,ACC00007189,Credit,947.45,-106832.46,EUR,Walmart
TXN0000000571,2024-01-31T22:36:01,ACC00001288,Payment,865.36,-107697.82,GBP,Target
TXN0000000572,2024-02-03T10:48:02,ACC00000300,Payment,539.04,-108236.86,GBP,Amazon
TXN0000000573,2024-09-07T06:18:15,ACC00009947,Payment,86.48,-108323.34,USD,Target
TXN0000000574,2024-06-04T09:04:22,ACC00005891,Transfer,1947.07,-106376.27,GBP,Restaurant
TXN0000000575,2024-07-29T08:22:00,ACC00007164,ATM,767.03,-107143.3,JPY,Starbucks
TXN0000000576,2024-01-31T04:40:48,ACC00007070,Payment,371.08,-107514.38,USD,Online Store
TXN0000000577,2024-10-07T18:43:35,ACC00003215,Debit,363.72,-107878.1,JPY,Target
TXN0000000578,2024-02-08T05:14:04,ACC00007813,Debit,1620.36,-109498.46,GBP,Shell
TXN0000000579,2024-06-16T08:59:23,ACC00004192,Debit,1947.85,-111446.31,EUR,Online Store
TXN0000000580,2024-01-01T05:23:44,ACC00008374,Transfer,1309.61,-110136.7,EUR,Walmart
TXN0000000581,2024-07-09T11:08:30,ACC00004969,Debit,1757.53,-111894.23,EUR,Target
TXN0000000582,2024-09-11T23:11:09,ACC00006097,Credit,753.54,-111140.69,GBP,Target
TXN0000000583,2024-07-31T03:13:59,ACC00006958,Payment,892.12,-112032.81,GBP,Target
TXN0000000584,2024-05-13T12:22:05,ACC00006463,ATM,1107.24,-113140.05,EUR,Starbucks
TXN0000000585,2024-10-17T13:11:09,ACC00008770,Payment,27.22,-113167.27,GBP,Starbucks
TXN0000000586,2024-09-07T15:46:32,ACC00009633,Debit,1377.72,-114544.99,USD,Amazon
TXN0000000587,2024-02-13T09:40:34,ACC00001726,Payment,404.16,-114949.15,USD,Target
TXN0000000588,2024-09-07T14:42:50,ACC00001440,Debit,93.15,-115042.3,GBP,Online Store
TXN0000000589,2024-05-24T05:34:02,ACC00007912,Debit,1649.68,-116691.98,JPY,Target
TXN0000000590,2024-07-11T17:53:49,ACC00008645,ATM,1464.46,-118156.44,JPY,Grocery
TXN0000000591,2024-07-09T18:26:02,ACC00008949,Payment,1960.19,-120116.63,JPY,Grocery
TXN0000000592,2024-03-17T12:39:40,ACC00004113,Transfer,200.09,-119916.54,GBP,Amazon
TXN0000000593,2024-02-13T19:15:27,ACC00000120,Transfer,1644.6,-118271.94,EUR,Restaurant
TXN0000000594,2024-05-25T12:50:01,ACC00009801,Debit,994.95,-119266.89,GBP,Target
TXN0000000595,2024-07-03T06:50:11,ACC00003727,ATM,1848.54,-121115.43,JPY,Restaurant
TXN0000000596,2024-02-28T23:39:27,ACC00005959,Debit,1603.41,-122718.84,USD,Shell
TXN0000000597,2024-05-27T04:12:50,ACC00009463,Credit,281.39,-122437.45,EUR,Amazon
TXN0000000598,2024-02-17T23:04:53,ACC00003729,ATM,484.05,-122921.5,USD,Shell
TXN0000000599,2024-03-21T13:39:37,ACC00001773,Credit,624.28,-122297.22,GBP,Restaurant
TXN0000000600,2024-05-28T11:51:03,ACC00000618,ATM,1238.58,-123535.8,EUR,Restaurant
TXN0000000601,2024-07-12T01:06:27,ACC00007721,ATM,125.14,-123660.94,GBP,Grocery
TXN0000000602,2024-04-27T00:41:33,ACC00004591,Debit,1227.3,-124888.24,JPY,Amazon
TXN0000000603,2024-11-16T07:39:09,ACC00006517,ATM,1864.42,-126752.66,EUR,Grocery
TXN0000000604,2024-10-18T03:48:36,ACC00002638,ATM,463.19,-127215.85,JPY,Online Store
TXN0000000605,2024-05-16T12:27:50,ACC00007800,Debit,1861.5,-129077.35,JPY,Shell
TXN0000000606,2024-07-27T19:25:05,ACC00005447,Payment,785.52,-129862.87,GBP,Walmart
TXN0000000607,2024-03-19T20:21:03,ACC00004070,Debit,1264.91,-131127.78,GBP,Restaurant
TXN0000000608,2024-06-10T10:17:45,ACC00006465,ATM,1404.51,-132532.29,USD,Grocery
TXN0000000609,2024-04-12T12:22:59,ACC00003709,Payment,1982.25,-134514.54,JPY,Starbucks
TXN0000000610,2024-03-02T18:01:29,ACC00007861,Credit,1741.54,-132773.0,GBP,Target
TXN0000000611,2024-08-15T08:34:19,ACC00004723,Transfer,820.9,-131952.1,JPY,Restaurant
TXN0000000612,2024-05-02T10:11:43,ACC00006971,Debit,1027.73,-132979.83,JPY,Shell
TXN0000000613,2024-01-10T22:44:17,ACC00003124,Credit,686.51,-132293.32,JPY,Starbucks
TXN0000000614,2024-04-19T03:40:05,ACC00000125,Transfer,1601.46,-130691.86,USD,Amazon
TXN0000000615,2024-10-09T03:14:15,ACC00005349,Credit,402.65,-130289.21,JPY,Restaurant
TXN0000000616,2024-01-18T14:25:34,ACC00000664,Transfer,371.76,-129917.45,EUR,Target
TXN0000000617,2024-10-29T10:21:32,ACC00004494,Payment,1479.98,-131397.43,GBP,Starbucks
TXN0000000618,2024-11-24T12:06:49,ACC00000491,Payment,431.59,-131829.02,JPY,Online Store
TXN0000000619,2024-07-03T07:15:44,ACC00002675,ATM,1822.74,-133651.76,GBP,Starbucks
TXN0000000620,2024-09-24T18:41:53,ACC00005931,Debit,455.67,-134107.43,JPY,Restaurant
TXN0000000621,2024-08-26T22:48:52,ACC00001117,Payment,139.33,-134246.76,USD,Shell
TXN0000000622,2024-02-19T10:09:24,ACC00009955,Payment,809.41,-135056.17,EUR,Shell
TXN0000000623,2024-04-28T22:28:33,ACC00003378,ATM,559.25,-135615.42,USD,Target
TXN0000000624,2024-02-08T11:52:31,ACC00009382,Debit,300.0,-135915.42,USD,Grocery
TXN0000000625,2024-07-12T22:16:02,ACC00006328,Debit,1799.84,-137715.26,USD,Amazon
TXN0000000626,2024-06-06T17:43:14,ACC00000609,ATM,1539.03,-139254.29,JPY,Shell
TXN0000000627,2024-01-09T15:11:20,ACC00003570,Debit,1562.95,-140817.24,USD,Starbucks
TXN0000000628,2024-10-30T22:53:44,ACC00004772,Credit,1459.21,-139358.03,USD,Grocery
TXN0000000629,2024-06-07T11:56:33,ACC00001609,ATM,1415.98,-140774.01,USD,Starbucks
TXN0000000630,2024-01-14T16:03:56,ACC00008321,Credit,380.15,-140393.86,JPY,Target
TXN0000000631,2024-11-09T10:42:56,ACC00005695,Payment,1392.97,-141786.83,EUR,Walmart
TXN0000000632,2024-08-15T18:18:09,ACC00000574,Payment,1533.54,-143320.37,USD,Restaurant
TXN0000000633,2024-04-18T15:15:24,ACC00005749,Payment,141.86,-143462.23,EUR,Shell
TXN0000000634,2024-11-19T01:08:06,ACC00003121,Credit,1182.46,-142279.77,GBP,Walmart
TXN0000000635,2024-06-13T14:47:28,ACC00005575,Credit,1044.78,-141234.99,JPY,Walmart
TXN0000000636,2024-09-20T23:27:17,ACC00007817,Transfer,342.16,-140892.83,USD,Restaurant
TXN0000000637,2024-11-16T16:04:25,ACC00006075,Transfer,660.6,-140232.23,EUR,Starbucks
TXN0000000638,2024-11-26T10:17:01,ACC00003139,ATM,1925.75,-142157.98,GBP,Target
TXN0000000639,2024-12-04T09:37:36,ACC00004619,ATM,1240.21,-143398.19,EUR,Amazon
TXN0000000640,2024-12-25T23:00:30,ACC00002340,Transfer,339.03,-143059.16,GBP,Shell
TXN0000000641,2024-12-21T16:53:46,ACC00003557,Debit,1906.33,-144965.49,EUR,Grocery
TXN0000000642,2024-02-28T15:31:57,ACC00003987,Payment,1386.35,-146351.84,EUR,Target
TXN0000000643,2024-03-10T16:59:41,ACC00001208,Payment,1418.52,-147770.36,USD,Grocery
TXN0000000644,2024-01-16T08:57:17,ACC00003910,Payment,1164.79,-148935.15,USD,Grocery
TXN0000000645,2024-11-29T10:57:00,ACC00000009,Debit,1325.99,-150261.14,USD,Amazon
TXN0000000646,2024-01-25T23:18:53,ACC00008896,Debit,281.36,-150542.5,GBP,Shell
TXN0000000647,2024-08-14T09:56:53,ACC00007263,Debit,707.83,-151250.33,EUR,Restaurant
TXN0000000648,2024-01-13T00:56:03,ACC00003297,ATM,1230.93,-152481.26,JPY,Target
TXN0000000649,2024-11-10T16:27:26,ACC00002335,Credit,637.47,-151843.79,EUR,Online Store
TXN0000000650,2024-07-10T23:51:59,ACC00003671,Credit,500.23,-151343.56,USD,Grocery
TXN0000000651,2024-04-22T20:17:52,ACC00009398,Transfer,334.1,-151009.46,GBP,Starbucks
TXN0000000652,2024-08-06T10:30:15,ACC00000269,ATM,1319.03,-152328.49,USD,Starbucks
TXN0000000653,2024-07-30T17:34:34,ACC00007290,ATM,792.7,-153121.19,GBP,Online Store
TXN0000000654,2024-01-27T22:08:22,ACC00007070,Payment,207.21,-153328.4,EUR,Grocery
TXN0000000655,2024-05-27T14:20:50,ACC00008597,Payment,650.98,-153979.38,JPY,Shell
TXN0000000656,2024-12-20T18:11:12,ACC00001358,ATM,320.0,-154299.38,EUR,Walmart
TXN0000000657,2024-01-22T17:38:50,ACC00007855,Debit,810.28,-155109.66,EUR,Shell
TXN0000000658,2024-01-11T05:31:07,ACC00000284,Transfer,1171.19,-153938.47,GBP,Starbucks
TXN0000000659,2024-03-17T16:21:24,ACC00007958,ATM,1155.08,-155093.55,GBP,Amazon
TXN0000000660,2024-09-20T19:38:21,ACC00003289,Credit,452.05,-154641.5,USD,Online Store
TXN0000000661,2024-08-11T20:02:11,ACC00001245,Debit,1575.85,-156217.35,USD,Target
TXN0000000662,2024-11-08T06:13:35,ACC00004231,Credit,1455.51,-154761.84,USD,Amazon
TXN0000000663,2024-06-11T22:13:36,ACC00003231,Credit,1756.6,-153005.24,JPY,Online Store
TXN0000000664,2024-12-05T18:30:32,ACC00001516,Debit,524.89,-153530.13,USD,Target
TXN0000000665,2024-09-02T16:00:07,ACC00006962,Payment,472.56,-154002.69,EUR,Online Store
TXN0000000666,2024-11-28T03:47:47,ACC00001399,ATM,444.62,-154447.31,JPY,Shell
TXN0000000667,2024-01-24T13:09:32,ACC00003937,Transfer,1941.15,-152506.16,EUR,Restaurant
TXN0000000668,2024-02-27T17:26:49,ACC00007377,Debit,544.77,-153050.93,JPY,Amazon
TXN0000000669,2024-05-15T06:44:19,ACC00004648,ATM,408.97,-153459.9,EUR,Restaurant
TXN0000000670,2024-11-25T14:43:03,ACC00006435,Debit,1059.94,-154519.84,EUR,Starbucks
TXN0000000671,2024-12-20T20:40:38,ACC00006694,Debit,72.41,-154592.25,JPY,Shell
TXN0000000672,2024-08-31T07:11:32,ACC00009434,Credit,686.49,-153905.76,GBP,Restaurant
TXN0000000673,2024-12-18T09:15:02,ACC00003760,ATM,1877.75,-155783.51,JPY,Restaurant
TXN0000000674,2024-06-10T21:27:09,ACC00005553,Credit,1441.45,-154342.06,USD,Amazon
TXN0000000675,2024-03-31T14:53:06,ACC00005191,Payment,1896.49,-156238.55,EUR,Walmart
TXN0000000676,2024-09-01T18:09:40,ACC00006126,Debit,1037.11,-157275.66,JPY,Shell
TXN0000000677,2024-03-08T01:54:28,ACC00005620,Payment,1757.63,-159033.29,GBP,Starbucks
TXN0000000678,2024-04-15T01:08:45,ACC00002726,Credit,1083.15,-157950.14,USD,Amazon
TXN0000000679,2024-02-20T22:20:28,ACC00008464,ATM,1869.26,-159819.4,USD,Walmart
TXN0000000680,2024-10-21T08:26:42,ACC00006923,Payment,768.65,-160588.05,USD,Shell
TXN0000000681,2024-03-17T02:22:40,ACC00008286,Payment,1010.36,-161598.41,GBP,Starbucks
TXN0000000682,2024-11-06T14:19:54,ACC00003504,ATM,1598.66,-163197.07,USD,Amazon
TXN0000000683,2024-11-02T04:28:12,ACC00007233,ATM,492.32,-163689.39,JPY,Grocery
TXN0000000684,2024-10-09T20:08:06,ACC00005984,Transfer,1460.27,-162229.12,USD,Online Store
TXN0000000685,2024-01-28T11:47:21,ACC00003717,Credit,853.27,-161375.85,EUR,Grocery
TXN0000000686,2024-09-15T13:39:11,ACC00003222,ATM,270.28,-161646.13,GBP,Restaurant
TXN0000000687,2024-03-12T15:50:32,ACC00000045,Transfer,719.92,-160926.21,EUR,Target
TXN0000000688,2024-03-28T13:41:21,ACC00002238,Transfer,1714.65,-159211.56,USD,Online Store
TXN0000000689,2024-05-06T10:16:50,ACC00003177,Debit,410.73,-159622.29,GBP,Shell
TXN0000000690,2024-07-27T06:33:31,ACC00004860,Transfer,1536.84,-158085.45,JPY,Starbucks
TXN0000000691,2024-05-11T22:21:57,ACC00003378,Credit,1909.2,-156176.25,USD,Target
TXN0000000692,2024-07-12T20:03:48,ACC00005485,ATM,895.42,-157071.67,USD,Target
TXN0000000693,2024-11-03T11:50:01,ACC00003104,Payment,1192.9,-158264.57,EUR,Starbucks
TXN0000000694,2024-11-02T19:26:12,ACC00006748,Debit,35.87,-158300.44,EUR,Online Store
TXN0000000695,2024-02-23T16:13:19,ACC00000913,ATM,1455.91,-159756.35,EUR,Shell
TXN0000000696,2024-10-08T05:36:17,ACC00001084,Payment,1818.22,-161574.57,JPY,Grocery
TXN0000000697,2024-09-16T00:10:10,ACC00007417,Payment,739.61,-162314.18,EUR,Shell
TXN0000000698,2024-03-09T12:23:39,ACC00008219,ATM,590.83,-162905.01,EUR,Online Store
TXN0000000699,2024-03-01T02:58:04,ACC00007146,Payment,361.24,-163266.25,GBP,Walmart
TXN0000000700,2024-07-23T19:36:03,ACC00004011,ATM,791.21,-164057.46,EUR,Walmart
TXN0000000701,2024-08-20T00:37:04,ACC00008325,Payment,559.56,-164617.02,USD,Target
TXN0000000702,2024-01-19T16:48:54,ACC00000244,ATM,842.75,-165459.77,GBP,Online Store
TXN0000000703,2024-02-23T10:24:10,ACC00000349,Transfer,1323.16,-164136.61,USD,Walmart
TXN0000000704,2024-02-22T03:36:50,ACC00008213,Transfer,579.99,-163556.62,JPY,Online Store
TXN0000000705,2024-12-26T09:24:56,ACC00003037,ATM,1343.12,-164899.74,USD,Shell
TXN0000000706,2024-10-03T04:17:38,ACC00008120,Debit,1383.78,-166283.52,USD,Restaurant
TXN0000000707,2024-02-17T18:06:49,ACC00005751,Credit,1836.02,-164447.5,GBP,Grocery
TXN0000000708,2024-03-15T09:15:33,ACC00006781,Payment,1226.93,-165674.43,EUR,Online Store
TXN0000000709,2024-02-02T14:50:24,ACC00000195,Debit,292.16,-165966.59,JPY,Shell
TXN0000000710,2024-10-06T21:53:41,ACC00007791,Transfer,275.45,-165691.14,EUR,Target
TXN0000000711,2024-08-16T19:49:58,ACC00008785,Debit,1417.43,-167108.57,GBP,Walmart
TXN0000000712,2024-11-06T05:07:24,ACC00009626,Transfer,493.36,-166615.21,EUR,Restaurant
TXN0000000713,2024-12-22T19:25:28,ACC00009216,Credit,134.53,-166480.68,EUR,Restaurant
TXN0000000714,2024-06-14T23:12:35,ACC00007484,ATM,506.55,-166987.23,GBP,Restaurant
TXN0000000715,2024-08-11T11:02:06,ACC00006973,Transfer,324.1,-166663.13,USD,Starbucks
TXN0000000716,2024-02-25T00:06:16,ACC00004211,Credit,1016.7,-165646.43,GBP,Walmart
TXN0000000717,2024-09-08T09:08:45,ACC00006381,Payment,1849.7,-167496.13,USD,Online Store
TXN0000000718,2024-05-28T03:12:56,ACC00008743,Credit,969.89,-166526.24,JPY,Grocery
TXN0000000719,2024-01-17T21:10:02,ACC00001854,Transfer,1482.92,-165043.32,EUR,Shell
TXN0000000720,2024-05-31T01:40:42,ACC00001071,Payment,1152.31,-166195.63,EUR,Online Store
TXN0000000721,2024-03-18T04:58:40,ACC00007052,Transfer,789.11,-165406.52,GBP,Shell
TXN0000000722,2024-03-01T22:13:43,ACC00000183,Transfer,200.45,-165206.07,JPY,Walmart
TXN0000000723,2024-03-21T03:25:51,ACC00009835,ATM,938.16,-166144.23,USD,Grocery
TXN0000000724,2024-08-06T20:36:00,ACC00004866,Debit,253.98,-166398.21,GBP,Starbucks
TXN0000000725,2024-07-05T09:42:46,ACC00004779,ATM,213.72,-166611.93,GBP,Online Store
TXN0000000726,2024-08-09T18:41:40,ACC00004080,Credit,1829.75,-164782.18,EUR,Shell
TXN0000000727,2024-07-27T03:15:26,ACC00009251,Credit,1236.14,-163546.04,USD,Shell
TXN0000000728,2024-12-18T23:31:10,ACC00006209,Payment,52.57,-163598.61,JPY,Grocery
TXN0000000729,2024-11-01T12:15:27,ACC00005721,Transfer,1556.17,-162042.44,USD,Amazon
TXN0000000730,2024-06-14T10:41:57,ACC00002782,Debit,380.72,-162423.16,EUR,Grocery
TXN0000000731,2024-07-05T14:40:38,ACC00000186,Payment,472.58,-162895.74,GBP,Online Store
TXN0000000732,2024-01-12T01:23:04,ACC00006732,Transfer,1665.0,-161230.74,EUR,Target
TXN0000000733,2024-04-09T12:43:35,ACC00003630,ATM,1407.74,-162638.48,GBP,Shell
TXN0000000734,2024-03-21T15:14:00,ACC00005066,Credit,185.54,-162452.94,USD,Walmart
TXN0000000735,2024-09-09T14:02:38,ACC00008791,Payment,627.88,-163080.82,JPY,Restaurant
TXN0000000736,2024-11-20T22:01:12,ACC00007462,Payment,1300.31,-164381.13,USD,Target
TXN0000000737,2024-10-29T21:18:01,ACC00009235,ATM,411.76,-164792.89,JPY,Target
TXN0000000738,2024-10-22T02:26:36,ACC00009743,Transfer,1556.41,-163236.48,USD,Target
TXN0000000739,2024-04-17T12:44:33,ACC00008109,Payment,1409.77,-164646.25,GBP,Amazon
TXN0000000740,2024-11-17T02:41:35,ACC00003854,Credit,1031.19,-163615.06,EUR,Online Store
TXN0000000741,2024-08-31T15:16:02,ACC00009882,Debit,1562.05,-165177.11,EUR,Online Store
TXN0000000742,2024-05-18T20:23:42,ACC00000079,ATM,607.58,-165784.69,USD,Walmart
TXN0000000743,2024-08-31T11:14:14,ACC00004527,Transfer,1050.68,-164734.01,USD,Starbucks
TXN0000000744,2024-06-01T13:06:30,ACC00009237,Debit,1987.07,-166721.08,JPY,Restaurant
TXN0000000745,2024-10-06T20:48:36,ACC00004654,ATM,675.31,-167396.39,JPY,Starbucks
TXN0000000746,2024-06-24T10:27:12,ACC00001024,ATM,1818.64,-169215.03,EUR,Target
TXN0000000747,2024-09-14T22:25:39,ACC00008899,Transfer,1760.62,-167454.41,EUR,Grocery
TXN0000000748,2024-04-20T12:19:43,ACC00005317,Credit,848.49,-166605.92,EUR,Grocery
TXN0000000749,2024-05-17T13:58:23,ACC00007898,Payment,1258.8,-167864.72,USD,Walmart
TXN0000000750,2024-12-30T07:05:27,ACC00005363,Debit,1957.17,-169821.89,JPY,Grocery
TXN0000000751,2024-03-20T06:49:10,ACC00008630,Payment,388.66,-170210.55,USD,Starbucks
TXN0000000752,2024-12-10T07:29:40,ACC00004279,Payment,110.96,-170321.51,GBP,Grocery
TXN0000000753,2024-09-13T21:17:36,ACC00001102,ATM,1199.29,-171520.8,USD,Grocery
TXN0000000754,2024-01-11T09:34:19,ACC00004830,Credit,1698.97,-169821.83,EUR,Grocery
TXN0000000755,2024-07-15T07:57:54,ACC00006179,Debit,1061.83,-170883.66,GBP,Amazon
TXN0000000756,2024-06-27T12:28:18,ACC00004598,Credit,1486.65,-169397.01,JPY,Amazon
TXN0000000757,2024-11-03T19:20:29,ACC00008153,Debit,918.37,-170315.38,GBP,Starbucks
TXN0000000758,2024-10-27T16:49:06,ACC00004648,Debit,1180.77,-171496.15,JPY,Grocery
TXN0000000759,2024-08-08T06:43:44,ACC00000726,Transfer,353.79,-171142.36,JPY,Amazon
TXN0000000760,2024-10-11T04:10:33,ACC00008553,Credit,888.62,-170253.74,USD,Walmart
TXN0000000761,2024-06-05T02:18:14,ACC00002043,Credit,1181.86,-169071.88,JPY,Online Store
TXN0000000762,2024-06-12T00:28:07,ACC00005773,Transfer,1265.84,-167806.04,USD,Walmart
TXN0000000763,2024-03-02T10:10:51,ACC00001181,Payment,729.34,-168535.38,EUR,Online Store
TXN0000000764,2024-04-02T07:50:06,ACC00009622,Transfer,241.69,-168293.69,JPY,Amazon
TXN0000000765,2024-08-08T15:34:26,ACC00006346,Debit,78.36,-168372.05,EUR,Shell
TXN0000000766,2024-03-26T06:41:22,ACC00002887,Credit,652.03,-167720.02,USD,Starbucks
TXN0000000767,2024-10-07T20:11:08,ACC00009539,Credit,778.49,-166941.53,EUR,Shell
TXN0000000768,2024-04-24T03:09:33,ACC00001654,ATM,1767.8,-168709.33,GBP,Walmart
TXN0000000769,2024-04-24T17:20:02,ACC00003073,Transfer,1855.76,-166853.57,EUR,Walmart
TXN0000000770,2024-11-10T07:30:29,ACC00006019,Debit,369.86,-167223.43,GBP,Target
TXN0000000771,2024-12-04T19:53:45,ACC00005575,ATM,1693.5,-168916.93,JPY,Target
TXN0000000772,2024-06-19T19:18:47,ACC00003308,Credit,830.33,-168086.6,EUR,Amazon
TXN0000000773,2024-08-15T22:46:24,ACC00008852,Transfer,988.41,-167098.19,JPY,Walmart
TXN0000000774,2024-09-23T22:55:47,ACC00007951,Payment,252.76,-167350.95,JPY,Restaurant
TXN0000000775,2024-08-10T08:17:20,ACC00004869,Credit,825.82,-166525.13,JPY,Starbucks
TXN0000000776,2024-01-05T22:53:38,ACC00001834,ATM,594.18,-167119.31,EUR,Grocery
TXN0000000777,2024-10-21T12:12:56,ACC00007196,Credit,1815.64,-165303.67,USD,Starbucks
TXN0000000778,2024-09-09T04:25:25,ACC00005155,Credit,1555.1,-163748.57,EUR,Walmart
TXN0000000779,2024-12-20T11:07:05,ACC00000749,ATM,1020.62,-164769.19,JPY,Shell
TXN0000000780,2024-08-26T21:45:48,ACC00006712,ATM,1359.3,-166128.49,GBP,Restaurant
TXN0000000781,2024-12-07T22:45:49,ACC00001087,Transfer,1217.79,-164910.7,GBP,Walmart
TXN0000000782,2024-08-06T18:38:12,ACC00005518,Debit,634.28,-165544.98,EUR,Shell
TXN0000000783,2024-01-24T15:37:35,ACC00005464,Payment,1276.96,-166821.94,JPY,Amazon
TXN0000000784,2024-11-08T12:52:35,ACC00001333,Transfer,866.27,-165955.67,EUR,Walmart
TXN0000000785,2024-01-15T18:15:03,ACC00007909,Transfer,1798.6,-164157.07,EUR,Walmart
TXN0000000786,2024-12-15T06:56:50,ACC00008554,Credit,601.8,-163555.27,GBP,Grocery
TXN0000000787,2024-10-30T07:30:16,ACC00007076,Payment,494.29,-164049.56,USD,Amazon
TXN0000000788,2024-03-13T09:15:57,ACC00003855,Transfer,1158.49,-162891.07,GBP,Target
TXN0000000789,2024-02-29T10:51:46,ACC00001091,Debit,1561.27,-164452.34,USD,Amazon
TXN0000000790,2024-05-15T04:29:10,ACC00006603,Transfer,177.63,-164274.71,USD,Starbucks
TXN0000000791,2024-02-21T00:24:48,ACC00008642,ATM,1903.1,-166177.81,JPY,Restaurant
TXN0000000792,2024-08-17T21:02:10,ACC00009173,Transfer,401.42,-165776.39,GBP,Grocery
TXN0000000793,2024-07-04T20:50:11,ACC00002034,Debit,60.86,-165837.25,JPY,Starbucks
TXN0000000794,2024-12-27T02:40:42,ACC00000212,Payment,1111.63,-166948.88,EUR,Target
TXN0000000795,2024-03-05T21:26:05,ACC00002503,ATM,354.57,-167303.45,USD,Starbucks
TXN0000000796,2024-05-02T09:21:10,ACC00002255,ATM,1310.76,-168614.21,JPY,Starbucks
TXN0000000797,2024-10-01T16:21:04,ACC00005189,Payment,1175.4,-169789.61,USD,Walmart
TXN0000000798,2024-03-01T10:20:47,ACC00005706,Debit,610.75,-170400.36,GBP,Grocery
TXN0000000799,2024-09-28T19:40:35,ACC00007129,Payment,937.21,-171337.57,EUR,Restaurant
TXN0000000800,2024-12-08T16:57:23,ACC00005083,ATM,1963.28,-173300.85,GBP,Target
TXN0000000801,2024-04-25T14:25:54,ACC00005624,ATM,615.18,-173916.03,GBP,Online Store
TXN0000000802,2024-09-09T00:14:27,ACC00002176,Payment,491.52,-174407.55,GBP,Restaurant
TXN0000000803,2024-06-01T10:43:25,ACC00009158,Payment,1432.76,-175840.31,GBP,Grocery
TXN0000000804,2024-01-12T20:29:14,ACC00009887,Transfer,428.24,-175412.07,USD,Restaurant
TXN0000000805,2024-08-03T00:30:07,ACC00004260,ATM,1653.74,-177065.81,EUR,Walmart
TXN0000000806,2024-01-04T18:07:13,ACC00008498,Payment,1398.28,-178464.09,EUR,Walmart
TXN0000000807,2024-07-21T09:38:56,ACC00000958,Payment,1303.02,-179767.11,EUR,Starbucks
TXN0000000808,2024-10-08T20:26:06,ACC00009390,Debit,792.62,-180559.73,GBP,Online Store
TXN0000000809,2024-09-23T12:20:34,ACC00006628,Debit,1179.27,-181739.0,JPY,Restaurant
TXN0000000810,2024-01-13T19:17:41,ACC00001446,Credit,1626.32,-180112.68,EUR,Online Store
TXN0000000811,2024-06-27T20:15:15,ACC00008857,Credit,1818.86,-178293.82,USD,Target
TXN0000000812,2024-12-17T07:41:58,ACC00004403,Payment,1274.94,-179568.76,JPY,Shell
TXN0000000813,2024-07-11T06:52:32,ACC00000826,Transfer,1066.22,-178502.54,EUR,Shell
TXN0000000814,2024-03-04T16:45:26,ACC00001428,ATM,1177.42,-179679.96,USD,Starbucks
TXN0000000815,2024-01-01T18:09:29,ACC00001630,Debit,22.93,-179702.89,USD,Online Store
TXN0000000816,2024-07-23T05:03:08,ACC00008045,ATM,865.24,-180568.13,USD,Amazon
TXN0000000817,2024-03-29T19:41:14,ACC00006425,Credit,430.82,-180137.31,JPY,Amazon
TXN0000000818,2024-01-16T20:46:17,ACC00000027,Transfer,745.75,-179391.56,USD,Grocery
TXN0000000819,2024-10-26T06:26:15,ACC00000397,Credit,807.78,-178583.78,EUR,Restaurant
TXN0000000820,2024-11-27T08:29:16,ACC00007281,ATM,1562.96,-180146.74,GBP,Restaurant
TXN0000000821,2024-02-20T04:51:26,ACC00009336,Payment,875.78,-181022.52,EUR,Starbucks
TXN0000000822,2024-07-10T20:49:14,ACC00004457,Transfer,1771.83,-179250.69,EUR,Grocery
TXN0000000823,2024-03-29T08:22:36,ACC00004486,Payment,1000.64,-180251.33,USD,Online Store
TXN0000000824,2024-05-24T03:13:57,ACC00009743,Debit,606.14,-180857.47,EUR,Grocery
TXN0000000825,2024-10-14T10:34:53,ACC00003102,ATM,1766.54,-182624.01,JPY,Target
TXN0000000826,2024-01-02T09:14:52,ACC00007662,ATM,208.79,-182832.8,JPY,Amazon
TXN0000000827,2024-02-14T02:09:54,ACC00006130,Debit,1969.44,-184802.24,JPY,Walmart
TXN0000000828,2024-12-16T11:02:02,ACC00000112,ATM,1492.67,-186294.91,GBP,Grocery
TXN0000000829,2024-06-22T05:04:12,ACC00001444,Payment,69.07,-186363.98,EUR,Target
TXN0000000830,2024-06-06T06:04:08,ACC00002329,Payment,950.34,-187314.32,USD,Grocery
TXN0000000831,2024-09-10T10:56:28,ACC00000961,Debit,294.88,-187609.2,GBP,Grocery
TXN0000000832,2024-01-29T23:39:55,ACC00005562,Credit,1178.19,-186431.01,GBP,Walmart
TXN0000000833,2024-09-01T00:41:00,ACC00002694,Transfer,1221.43,-185209.58,USD,Walmart
TXN0000000834,2024-01-22T18:33:31,ACC00000964,Transfer,1488.2,-183721.38,EUR,Shell
TXN0000000835,2024-07-30T03:13:14,ACC00006842,Payment,1786.35,-185507.73,EUR,Walmart
TXN0000000836,2024-04-10T17:59:21,ACC00007848,ATM,1595.79,-187103.52,USD,Restaurant
TXN0000000837,2024-04-12T17:55:57,ACC00002560,Credit,1780.99,-185322.53,USD,Restaurant
TXN0000000838,2024-04-22T11:33:59,ACC00008907,Debit,64.89,-185387.42,EUR,Starbucks
TXN0000000839,2024-05-14T18:54:54,ACC00005126,Transfer,1321.24,-184066.18,GBP,Target
TXN0000000840,2024-01-13T10:55:34,ACC00002059,Debit,1613.76,-185679.94,EUR,Amazon
TXN0000000841,2024-04-30T02:09:53,ACC00007593,Transfer,539.65,-185140.29,GBP,Amazon
TXN0000000842,2024-06-19T06:08:55,ACC00006232,Transfer,899.56,-184240.73,USD,Amazon
TXN0000000843,2024-04-30T15:26:29,ACC00005241,Transfer,1534.61,-182706.12,USD,Online Store
TXN0000000844,2024-09-14T12:20:27,ACC00001185,Debit,1875.32,-184581.44,GBP,Target
TXN0000000845,2024-12-11T18:32:03,ACC00004427,Debit,680.02,-185261.46,JPY,Walmart
TXN0000000846,2024-01-26T07:56:54,ACC00001786,Credit,428.44,-184833.02,JPY,Grocery
TXN0000000847,2024-08-31T07:57:16,ACC00000491,Debit,1083.62,-185916.64,GBP,Walmart
TXN0000000848,2024-09-11T03:52:08,ACC00009842,Payment,1684.91,-187601.55,JPY,Target
TXN0000000849,2024-09-26T08:48:53,ACC00009319,Transfer,870.57,-186730.98,GBP,Amazon
TXN0000000850,2024-10-19T02:32:14,ACC00006792,Payment,435.05,-187166.03,JPY,Walmart
TXN0000000851,2024-12-17T19:10:14,ACC00009632,Transfer,924.49,-186241.54,JPY,Restaurant
TXN0000000852,2024-07-16T01:34:14,ACC00000526,Payment,541.05,-186782.59,EUR,Starbucks
TXN0000000853,2024-06-21T14:17:00,ACC00004118,Transfer,87.34,-186695.25,GBP,Online Store
TXN0000000854,2024-11-14T10:40:36,ACC00006268,Transfer,712.24,-185983.01,EUR,Target
TXN0000000855,2024-12-25T10:52:16,ACC00008954,Credit,805.73,-185177.28,JPY,Amazon
TXN0000000856,2024-02-01T16:42:34,ACC00007141,Payment,839.48,-186016.76,USD,Online Store
TXN0000000857,2024-04-22T05:34:05,ACC00007745,Payment,1156.73,-187173.49,EUR,Restaurant
TXN0000000858,2024-09-11T00:19:16,ACC00005318,Credit,1665.08,-185508.41,GBP,Grocery
TXN0000000859,2024-05-04T03:02:31,ACC00004683,Debit,1770.33,-187278.74,JPY,Restaurant
TXN0000000860,2024-08-13T10:17:51,ACC00006697,Credit,1738.76,-185539.98,EUR,Amazon
TXN0000000861,2024-10-12T04:23:38,ACC00002346,Credit,70.26,-185469.72,GBP,Amazon
TXN0000000862,2024-11-24T07:21:41,ACC00005047,Transfer,1463.5,-184006.22,EUR,Amazon
TXN0000000863,2024-02-21T10:37:28,ACC00000217,Payment,1138.74,-185144.96,JPY,Shell
TXN0000000864,2024-06-12T13:19:57,ACC00002499,Debit,566.33,-185711.29,EUR,Target
TXN0000000865,2024-04-11T01:54:30,ACC00007394,Credit,1268.08,-184443.21,USD,Starbucks
TXN0000000866,2024-11-15T02:13:35,ACC00001570,Transfer,790.61,-183652.6,EUR,Amazon
TXN0000000867,2024-10-04T23:55:58,ACC00009233,Credit,1304.05,-182348.55,USD,Restaurant
TXN0000000868,2024-02-25T08:08:53,ACC00003044,Credit,397.11,-181951.44,GBP,Grocery
TXN0000000869,2024-04-12T19:11:31,ACC00001655,Payment,1053.48,-183004.92,EUR,Target
TXN0000000870,2024-01-16T20:34:26,ACC00000953,Payment,1886.74,-184891.66,EUR,Walmart
TXN0000000871,2024-02-16T13:54:29,ACC00006022,Payment,770.59,-185662.25,JPY,Walmart
TXN0000000872,2024-10-18T23:26:42,ACC00002413,Debit,724.31,-186386.56,USD,Grocery
TXN0000000873,2024-11-28T20:07:04,ACC00003817,Transfer,439.45,-185947.11,USD,Walmart
TXN0000000874,2024-10-11T17:03:34,ACC00002034,Credit,139.05,-185808.06,USD,Amazon
TXN0000000875,2024-08-09T20:37:59,ACC00009802,Debit,1082.74,-186890.8,GBP,Walmart
TXN0000000876,2024-08-24T04:13:10,ACC00006227,ATM,93.9,-186984.7,EUR,Grocery
TXN0000000877,2024-03-16T03:37:17,ACC00006396,ATM,156.83,-187141.53,JPY,Starbucks
TXN0000000878,2024-12-06T19:02:11,ACC00007654,Credit,385.26,-186756.27,JPY,Shell
TXN0000000879,2024-03-13T22:08:24,ACC00003879,Debit,312.24,-187068.51,GBP,Starbucks
TXN0000000880,2024-11-06T07:13:57,ACC00005539,Transfer,141.36,-186927.15,GBP,Shell
TXN0000000881,2024-02-16T07:58:42,ACC00002863,ATM,633.98,-187561.13,USD,Target
TXN0000000882,2024-03-17T18:14:04,ACC00002333,Debit,1839.7,-189400.83,GBP,Online Store
TXN0000000883,2024-03-22T18:30:29,ACC00003526,Credit,1218.73,-188182.1,JPY,Starbucks
TXN0000000884,2024-06-01T21:59:09,ACC00009286,ATM,177.7,-188359.8,JPY,Target
TXN0000000885,2024-04-09T04:38:26,ACC00003653,Credit,1578.95,-186780.85,EUR,Shell
TXN0000000886,2024-09-30T11:46:21,ACC00000475,Credit,701.6,-186079.25,GBP,Online Store
TXN0000000887,2024-12-30T23:39:49,ACC00007669,ATM,351.27,-186430.52,JPY,Restaurant
TXN0000000888,2024-10-24T17:29:46,ACC00006332,Debit,1655.22,-188085.74,GBP,Grocery
TXN0000000889,2024-01-14T19:15:45,ACC00006094,Credit,1422.55,-186663.19,EUR,Grocery
TXN0000000890,2024-04-09T09:38:24,ACC00005946,ATM,1454.06,-188117.25,JPY,Shell
TXN0000000891,2024-09-08T11:36:57,ACC00002989,ATM,37.43,-188154.68,EUR,Target
TXN0000000892,2024-02-17T19:50:05,ACC00003329,Debit,766.49,-188921.17,JPY,Walmart
TXN0000000893,2024-12-13T21:14:03,ACC00004009,ATM,1867.35,-190788.52,USD,Online Store
TXN0000000894,2024-02-16T13:33:27,ACC00006489,Credit,914.06,-189874.46,GBP,Online Store
TXN0000000895,2024-07-07T05:12:56,ACC00004546,Transfer,1689.5,-188184.96,GBP,Grocery
TXN0000000896,2024-07-26T20:10:46,ACC00006335,Transfer,1729.27,-186455.69,EUR,Grocery
TXN0000000897,2024-05-22T03:12:27,ACC00001220,Transfer,171.83,-186283.86,JPY,Walmart
TXN0000000898,2024-11-03T12:18:53,ACC00006719,Payment,1324.1,-187607.96,JPY,Target
TXN0000000899,2024-05-11T22:33:57,ACC00008119,Transfer,528.63,-187079.33,JPY,Walmart
TXN0000000900,2024-08-19T03:53:25,ACC00005256,Payment,402.73,-187482.06,EUR,Target
TXN0000000901,2024-02-15T11:03:31,ACC00003650,Credit,426.68,-187055.38,EUR,Walmart
TXN0000000902,2024-02-04T14:16:02,ACC00008858,Debit,650.63,-187706.01,USD,Starbucks
TXN0000000903,2024-06-25T10:41:09,ACC00003414,ATM,894.06,-188600.07,JPY,Restaurant
TXN0000000904,2024-12-04T11:00:47,ACC00006739,Transfer,262.77,-188337.3,USD,Shell
TXN0000000905,2024-05-30T09:11:19,ACC00009233,ATM,1002.69,-189339.99,GBP,Starbucks
TXN0000000906,2024-02-12T20:35:46,ACC00002043,Transfer,404.26,-188935.73,USD,Starbucks
TXN0000000907,2024-12-28T11:10:09,ACC00003809,Credit,198.24,-188737.49,GBP,Shell
TXN0000000908,2024-02-22T18:58:59,ACC00003578,Payment,1687.8,-190425.29,JPY,Target
TXN0000000909,2024-11-30T22:52:24,ACC00003818,Credit,694.82,-189730.47,USD,Online Store
TXN0000000910,2024-03-07T00:39:31,ACC00000176,ATM,1791.57,-191522.04,EUR,Restaurant
TXN0000000911,2024-11-25T00:45:13,ACC00006584,Transfer,1814.14,-189707.9,EUR,Starbucks
TXN0000000912,2024-06-18T12:10:06,ACC00007093,Debit,1193.91,-190901.81,JPY,Restaurant
TXN0000000913,2024-07-31T10:22:15,ACC00009982,ATM,1978.91,-192880.72,JPY,Online Store
TXN0000000914,2024-12-20T22:17:06,ACC00003618,Credit,674.05,-192206.67,JPY,Starbucks
TXN0000000915,2024-02-02T17:19:40,ACC00001027,Credit,1172.65,-191034.02,GBP,Shell
TXN0000000916,2024-12-01T15:29:27,ACC00005079,ATM,1139.74,-192173.76,EUR,Amazon
TXN0000000917,2024-07-22T16:33:46,ACC00006229,ATM,1621.36,-193795.12,USD,Shell
TXN0000000918,2024-08-10T07:23:13,ACC00003245,ATM,1580.0,-195375.12,JPY,Shell
TXN0000000919,2024-01-31T20:09:27,ACC00004527,Debit,1679.3,-197054.42,GBP,Shell
TXN0000000920,2024-11-12T21:29:07,ACC00007291,Credit,576.8,-196477.62,EUR,Restaurant
TXN0000000921,2024-11-13T09:10:50,ACC00008982,Credit,1057.35,-195420.27,GBP,Amazon
TXN0000000922,2024-08-01T12:26:31,ACC00003475,ATM,1702.81,-197123.08,EUR,Online Store
TXN0000000923,2024-01-15T04:37:43,ACC00002857,ATM,693.02,-197816.1,JPY,Starbucks
TXN0000000924,2024-12-17T09:40:35,ACC00000446,ATM,453.35,-198269.45,USD,Grocery
TXN0000000925,2024-10-12T05:54:08,ACC00007028,Debit,1604.68,-199874.13,JPY,Grocery
TXN0000000926,2024-04-18T23:17:33,ACC00000746,Transfer,419.58,-199454.55,USD,Target
TXN0000000927,2024-06-22T07:42:17,ACC00005732,Debit,1367.61,-200822.16,GBP,Starbucks
TXN0000000928,2024-07-16T07:03:36,ACC00005807,Debit,41.26,-200863.42,GBP,Grocery
TXN0000000929,2024-12-18T09:46:14,ACC00004637,Transfer,1982.81,-198880.61,GBP,Walmart
TXN0000000930,2024-03-02T01:59:51,ACC00004480,Debit,813.41,-199694.02,EUR,Starbucks
TXN0000000931,2024-07-09T23:43:23,ACC00006376,ATM,142.34,-199836.36,GBP,Amazon
TXN0000000932,2024-11-22T04:45:17,ACC00000555,ATM,611.09,-200447.45,JPY,Online Store
TXN0000000933,2024-09-13T10:27:31,ACC00002957,Credit,1823.82,-198623.63,GBP,Amazon
TXN0000000934,2024-10-04T03:56:04,ACC00001375,Credit,327.56,-198296.07,USD,Starbucks
TXN0000000935,2024-12-12T21:00:45,ACC00004065,Payment,1113.03,-199409.1,GBP,Starbucks
TXN0000000936,2024-06-19T03:31:48,ACC00001215,ATM,1072.53,-200481.63,USD,Restaurant
TXN0000000937,2024-02-02T19:46:52,ACC00000830,Payment,658.74,-201140.37,GBP,Amazon
TXN0000000938,2024-07-25T23:25:04,ACC00008037,Credit,239.46,-200900.91,USD,Shell
TXN0000000939,2024-03-10T22:04:07,ACC00001203,Credit,113.51,-200787.4,GBP,Restaurant
TXN0000000940,2024-06-01T03:03:17,ACC00007016,Transfer,1734.92,-199052.48,GBP,Restaurant
TXN0000000941,2024-05-18T06:28:42,ACC00007502,Transfer,1645.28,-197407.2,GBP,Target
TXN0000000942,2024-09-12T13:04:25,ACC00005726,Payment,847.2,-198254.4,EUR,Restaurant
TXN0000000943,2024-08-03T07:26:36,ACC00001679,ATM,253.71,-198508.11,EUR,Online Store
TXN0000000944,2024-12-09T15:21:56,ACC00002013,Credit,412.69,-198095.42,EUR,Online Store
TXN0000000945,2024-06-02T17:52:22,ACC00002473,Debit,219.36,-198314.78,JPY,Shell
TXN0000000946,2024-12-09T06:49:33,ACC00002901,Transfer,690.54,-197624.24,USD,Starbucks
TXN0000000947,2024-08-08T16:30:16,ACC00003295,Debit,1717.03,-199341.27,USD,Online Store
TXN0000000948,2024-01-20T08:50:36,ACC00000373,Payment,525.64,-199866.91,USD,Restaurant
TXN0000000949,2024-03-29T08:00:37,ACC00007675,Transfer,823.56,-199043.35,USD,Online Store
TXN0000000950,2024-12-23T18:08:17,ACC00006692,ATM,966.15,-200009.5,GBP,Starbucks
TXN0000000951,2024-04-20T15:24:38,ACC00004359,Payment,1456.05,-201465.55,JPY,Grocery
TXN0000000952,2024-11-14T11:36:57,ACC00009051,Credit,474.38,-200991.17,GBP,Shell
TXN0000000953,2024-11-05T02:27:48,ACC00008941,Payment,1512.8,-202503.97,EUR,Amazon
TXN0000000954,2024-09-12T00:18:47,ACC00006763,Payment,1656.79,-204160.76,GBP,Walmart
TXN0000000955,2024-06-03T07:32:09,ACC00009616,ATM,204.07,-204364.83,GBP,Restaurant
TXN0000000956,2024-04-30T22:22:43,ACC00004404,ATM,1358.13,-205722.96,JPY,Amazon
TXN0000000957,2024-12-18T19:03:31,ACC00001604,Payment,181.05,-205904.01,USD,Restaurant
TXN0000000958,2024-11-14T02:10:26,ACC00004083,Transfer,248.72,-205655.29,GBP,Online Store
TXN0000000959,2024-07-22T06:39:46,ACC00008930,Transfer,495.53,-205159.76,JPY,Grocery
TXN0000000960,2024-11-30T20:45:16,ACC00008433,ATM,1202.33,-206362.09,USD,Amazon
TXN0000000961,2024-03-29T11:27:33,ACC00008548,Payment,644.22,-207006.31,JPY,Amazon
TXN0000000962,2024-06-11T12:42:29,ACC00001448,Transfer,202.41,-206803.9,USD,Amazon
TXN0000000963,2024-11-22T19:02:38,ACC00009766,Debit,1523.97,-208327.87,JPY,Amazon
TXN0000000964,2024-09-05T09:34:48,ACC00003743,Transfer,940.13,-207387.74,EUR,Starbucks
TXN0000000965,2024-01-09T19:21:39,ACC00007645,ATM,281.82,-207669.56,GBP,Amazon
TXN0000000966,2024-04-18T21:57:19,ACC00001019,Debit,1996.1,-209665.66,JPY,Amazon
TXN0000000967,2024-07-10T01:30:33,ACC00009661,ATM,1248.86,-210914.52,GBP,Starbucks
TXN0000000968,2024-06-23T13:57:03,ACC00007810,ATM,1955.46,-212869.98,GBP,Online Store
TXN0000000969,2024-01-11T23:52:47,ACC00007804,Transfer,480.2,-212389.78,USD,Shell
TXN0000000970,2024-04-12T23:19:10,ACC00005072,Debit,1779.5,-214169.28,EUR,Walmart
TXN0000000971,2024-01-18T07:40:03,ACC00000870,ATM,46.33,-214215.61,USD,Starbucks
TXN0000000972,2024-05-03T08:22:25,ACC00008176,Transfer,1078.19,-213137.42,GBP,Target
TXN0000000973,2024-05-29T03:21:13,ACC00002935,Payment,1757.37,-214894.79,GBP,Restaurant
TXN0000000974,2024-12-06T08:59:29,ACC00007969,Transfer,1506.81,-213387.98,USD,Restaurant
TXN0000000975,2024-04-28T18:41:16,ACC00006972,Debit,46.0,-213433.98,USD,Online Store
TXN0000000976,2024-12-09T12:20:52,ACC00002422,Payment,1106.22,-214540.2,JPY,Online Store
TXN0000000977,2024-09-08T10:36:06,ACC00004896,Transfer,1660.37,-212879.83,EUR,Walmart
TXN0000000978,2024-10-23T15:46:02,ACC00007523,ATM,402.33,-213282.16,USD,Shell
TXN0000000979,2024-01-23T11:41:24,ACC00009511,Debit,1678.62,-214960.78,GBP,Online Store
TXN0000000980,2024-06-05T07:57:14,ACC00007257,Payment,239.55,-215200.33,USD,Shell
TXN0000000981,2024-05-19T00:55:52,ACC00003260,Debit,400.95,-215601.28,JPY,Starbucks
TXN0000000982,2024-06-05T05:10:54,ACC00004812,ATM,1906.43,-217507.71,JPY,Grocery
TXN0000000983,2024-07-14T14:14:04,ACC00008064,Payment,641.97,-218149.68,GBP,Restaurant
TXN0000000984,2024-08-17T13:26:37,ACC00004880,ATM,222.66,-218372.34,GBP,Starbucks
TXN0000000985,2024-11-11T00:05:54,ACC00008214,Payment,1754.14,-220126.48,JPY,Restaurant
TXN0000000986,2024-04-06T00:39:02,ACC00003032,Payment,627.4,-220753.88,EUR,Amazon
TXN0000000987,2024-05-29T16:30:43,ACC00001459,Transfer,340.35,-220413.53,JPY,Target
TXN0000000988,2024-01-26T01:27:57,ACC00003167,Payment,183.29,-220596.82,USD,Restaurant
TXN0000000989,2024-08-04T22:38:52,ACC00004929,ATM,1319.57,-221916.39,EUR,Target
TXN0000000990,2024-05-12T01:31:40,ACC00006244,Debit,1410.51,-223326.9,GBP,Starbucks
TXN0000000991,2024-12-23T10:47:10,ACC00003947,Payment,1839.31,-225166.21,JPY,Online Store
TXN0000000992,2024-08-31T19:57:49,ACC00008664,Transfer,349.4,-224816.81,EUR,Shell
TXN0000000993,2024-11-13T06:12:01,ACC00006997,Payment,1272.05,-226088.86,GBP,Target
TXN0000000994,2024-03-19T09:25:05,ACC00009381,ATM,1482.51,-227571.37,JPY,Shell
TXN0000000995,2024-03-02T08:38:15,ACC00008610,Debit,1561.38,-229132.75,EUR,Shell
TXN0000000996,2024-03-18T21:02:46,ACC00003683,Payment,1343.53,-230476.28,USD,Restaurant
TXN0000000997,2024-04-07T18:41:35,ACC00003097,Transfer,1482.22,-228994.06,EUR,Amazon
TXN0000000998,2024-04-21T20:51:19,ACC00006405,Credit,474.02,-228520.04,USD,Amazon
TXN0000000999,2024-07-06T11:34:13,ACC00006315,Payment,327.95,-228847.99,JPY,Grocery
TXN0000001000,2024-09-19T01:21:31,ACC00007843,Credit,1343.67,-227504.32,JPY,Walmart
TXN0000001001,2024-09-07T10:04:02,ACC00001712,Payment,462.63,-227966.95,EUR,Grocery
TXN0000001002,2024-12-01T19:35:02,ACC00004964,Payment,327.85,-228294.8,EUR,Walmart
TXN0000001003,2024-01-14T21:25:20,ACC00005355,Payment,383.46,-228678.26,USD,Amazon
TXN0000001004,2024-08-02T11:46:08,ACC00008182,Transfer,208.54,-228469.72,USD,Shell
TXN0000001005,2024-10-04T11:17:57,ACC00007501,Transfer,960.32,-227509.4,JPY,Amazon
TXN0000001006,2024-10-31T05:23:29,ACC00002020,Credit,130.56,-227378.84,JPY,Target
TXN0000001007,2024-01-14T11:53:55,ACC00001364,Credit,1947.35,-225431.49,GBP,Restaurant
TXN0000001008,2024-06-13T10:14:40,ACC00000914,ATM,635.3,-226066.79,USD,Online Store
TXN0000001009,2024-01-30T07:05:58,ACC00000031,Payment,785.51,-226852.3,USD,Grocery
TXN0000001010,2024-03-07T11:11:56,ACC00007596,Payment,1069.58,-227921.88,USD,Shell
TXN0000001011,2024-05-19T07:28:26,ACC00002557,ATM,1363.87,-229285.75,EUR,Amazon
TXN0000001012,2024-11-30T16:19:15,ACC00006931,Payment,62.9,-229348.65,EUR,Target
TXN0000001013,2024-04-26T21:58:58,ACC00002203,ATM,593.9,-229942.55,USD,Shell
TXN0000001014,2024-12-02T17:12:08,ACC00007817,Credit,846.47,-229096.08,GBP,Restaurant
TXN0000001015,2024-01-26T02:45:26,ACC00003169,Credit,1445.21,-227650.87,JPY,Restaurant
TXN0000001016,2024-11-01T09:24:26,ACC00007217,Debit,271.91,-227922.78,GBP,Amazon
TXN0000001017,2024-02-19T03:51:38,ACC00003891,Debit,715.82,-228638.6,GBP,Grocery
TXN0000001018,2024-12-01T02:12:11,ACC00001760,ATM,185.03,-228823.63,EUR,Target
TXN0000001019,2024-12-10T05:22:03,ACC00000989,Payment,278.56,-229102.19,JPY,Starbucks
TXN0000001020,2024-01-03T05:56:18,ACC00002116,ATM,1874.92,-230977.11,USD,Restaurant
TXN0000001021,2024-03-10T13:24:14,ACC00001907,Debit,385.59,-231362.7,USD,Grocery
TXN0000001022,2024-04-26T08:56:46,ACC00009686,Payment,1862.43,-233225.13,JPY,Amazon
TXN0000001023,2024-06-12T13:16:04,ACC00002410,Transfer,612.8,-232612.33,GBP,Amazon
TXN0000001024,2024-02-11T17:51:50,ACC00001663,Credit,1505.94,-231106.39,USD,Target
TXN0000001025,2024-02-13T14:12:07,ACC00009254,Credit,313.19,-230793.2,USD,Restaurant
TXN0000001026,2024-05-25T21:30:09,ACC00003785,ATM,492.06,-231285.26,USD,Amazon
TXN0000001027,2024-02-22T22:00:42,ACC00006703,Debit,1436.49,-232721.75,JPY,Restaurant
TXN0000001028,2024-02-05T14:30:33,ACC00003258,ATM,1117.75,-233839.5,USD,Target
TXN0000001029,2024-01-27T15:41:09,ACC00004737,Transfer,1577.8,-232261.7,JPY,Online Store
TXN0000001030,2024-04-02T13:53:12,ACC00007813,Payment,764.33,-233026.03,EUR,Target
TXN0000001031,2024-09-01T16:14:23,ACC00002248,Payment,1012.5,-234038.53,GBP,Restaurant
TXN0000001032,2024-12-28T00:21:47,ACC00007996,Transfer,1833.57,-232204.96,GBP,Target
TXN0000001033,2024-06-04T23:12:11,ACC00007584,Credit,1766.89,-230438.07,USD,Grocery
TXN0000001034,2024-11-15T00:08:46,ACC00003201,Debit,740.47,-231178.54,GBP,Walmart
TXN0000001035,2024-05-16T12:22:27,ACC00007870,Debit,469.95,-231648.49,JPY,Walmart
TXN0000001036,2024-04-13T11:16:08,ACC00008956,Debit,458.03,-232106.52,USD,Walmart
TXN0000001037,2024-09-16T21:35:58,ACC00003842,Credit,1696.73,-230409.79,EUR,Online Store
TXN0000001038,2024-09-06T13:56:19,ACC00001980,Credit,1155.64,-229254.15,USD,Online Store
TXN0000001039,2024-10-19T10:37:46,ACC00008599,ATM,1755.26,-231009.41,GBP,Shell
TXN0000001040,2024-12-27T02:30:59,ACC00007342,Payment,678.72,-231688.13,JPY,Target
TXN0000001041,2024-01-30T11:20:27,ACC00009359,Transfer,1968.44,-229719.69,GBP,Amazon
TXN0000001042,2024-11-27T08:41:58,ACC00006888,Debit,985.41,-230705.1,JPY,Amazon
TXN0000001043,2024-03-29T01:37:00,ACC00007887,ATM,649.46,-231354.56,EUR,Target
TXN0000001044,2024-02-20T12:40:43,ACC00009541,Transfer,1623.86,-229730.7,USD,Grocery
TXN0000001045,2024-12-09T17:09:06,ACC00003658,Debit,1059.42,-230790.12,USD,Shell
TXN0000001046,2024-12-29T07:16:13,ACC00000235,ATM,1443.0,-232233.12,JPY,Online Store
TXN0000001047,2024-06-12T09:27:10,ACC00007627,Debit,451.42,-232684.54,EUR,Amazon
TXN0000001048,2024-08-12T10:40:33,ACC00003536,Transfer,1407.61,-231276.93,USD,Grocery
TXN0000001049,2024-10-13T21:55:56,ACC00009332,ATM,1063.52,-232340.45,GBP,Target
TXN0000001050,2024-07-26T03:29:04,ACC00004609,Credit,751.0,-231589.45,GBP,Online Store
TXN0000001051,2024-02-20T21:36:21,ACC00006767,Debit,578.98,-232168.43,EUR,Amazon
TXN0000001052,2024-06-03T12:15:48,ACC00005785,Payment,469.77,-232638.2,USD,Shell
TXN0000001053,2024-04-07T15:33:33,ACC00005461,Credit,1947.88,-230690.32,USD,Walmart
TXN0000001054,2024-03-30T05:56:08,ACC00006375,Credit,1748.36,-228941.96,JPY,Starbucks
TXN0000001055,2024-03-08T09:22:19,ACC00002054,ATM,959.6,-229901.56,JPY,Restaurant
TXN0000001056,2024-06-21T01:54:06,ACC00006379,Transfer,1245.89,-228655.67,JPY,Target
TXN0000001057,2024-02-26T01:00:30,ACC00002079,ATM,1540.91,-230196.58,EUR,Shell
TXN0000001058,2024-07-19T03:41:45,ACC00001308,Transfer,1370.27,-228826.31,EUR,Amazon
TXN0000001059,2024-05-12T00:38:29,ACC00003558,ATM,894.79,-229721.1,USD,Shell
TXN0000001060,2024-05-04T10:11:36,ACC00007595,Debit,921.8,-230642.9,USD,Shell
TXN0000001061,2024-02-22T06:48:38,ACC00001391,ATM,1099.32,-231742.22,GBP,Online Store
TXN0000001062,2024-04-12T00:32:23,ACC00004150,Payment,843.84,-232586.06,USD,Amazon
TXN0000001063,2024-08-25T09:48:21,ACC00007180,Credit,1154.62,-231431.44,JPY,Shell
TXN0000001064,2024-06-12T07:28:22,ACC00002076,Payment,117.7,-231549.14,GBP,Online Store
TXN0000001065,2024-10-08T18:17:22,ACC00005362,Credit,1969.88,-229579.26,JPY,Online Store
TXN0000001066,2024-08-09T15:22:13,ACC00009645,Transfer,718.33,-228860.93,JPY,Restaurant
TXN0000001067,2024-03-11T16:07:38,ACC00003470,Transfer,1148.15,-227712.78,EUR,Walmart
TXN0000001068,2024-09-23T23:15:19,ACC00004146,Credit,1223.78,-226489.0,EUR,Online Store
TXN0000001069,2024-04-28T02:21:09,ACC00001784,Payment,817.36,-227306.36,EUR,Restaurant
TXN0000001070,2024-07-11T02:06:02,ACC00008369,ATM,569.16,-227875.52,GBP,Shell
TXN0000001071,2024-02-21T09:13:14,ACC00004512,Debit,1452.25,-229327.77,GBP,Online Store
TXN0000001072,2024-01-14T10:28:19,ACC00009623,ATM,595.41,-229923.18,GBP,Starbucks
TXN0000001073,2024-01-04T13:04:22,ACC00006033,Transfer,1882.08,-228041.1,USD,Amazon
TXN0000001074,2024-02-14T17:49:56,ACC00006474,Payment,1862.66,-229903.76,EUR,Online Store
TXN0000001075,2024-01-25T09:25:35,ACC00005421,Debit,488.43,-230392.19,EUR,Grocery
TXN0000001076,2024-02-11T07:28:37,ACC00007324,Transfer,491.91,-229900.28,JPY,Online Store
TXN0000001077,2024-06-26T08:42:25,ACC00007181,Payment,237.54,-230137.82,EUR,Restaurant
TXN0000001078,2024-10-06T03:30:31,ACC00000126,Transfer,1399.2,-228738.62,GBP,Starbucks
TXN0000001079,2024-07-29T23:22:21,ACC00003851,Debit,88.93,-228827.55,EUR,Walmart
TXN0000001080,2024-12-22T16:16:28,ACC00008266,Payment,313.28,-229140.83,JPY,Starbucks
TXN0000001081,2024-08-06T13:41:52,ACC00002490,Debit,1536.57,-230677.4,JPY,Grocery
TXN0000001082,2024-10-30T04:34:33,ACC00007664,Transfer,914.28,-229763.12,EUR,Grocery
TXN0000001083,2024-08-02T16:25:25,ACC00009524,Credit,1487.92,-228275.2,EUR,Amazon
TXN0000001084,2024-06-03T03:44:47,ACC00001871,ATM,1614.31,-229889.51,JPY,Restaurant
TXN0000001085,2024-05-14T21:05:25,ACC00001180,ATM,55.96,-229945.47,JPY,Starbucks
TXN0000001086,2024-01-06T06:15:44,ACC00000161,ATM,1680.35,-231625.82,USD,Walmart
TXN0000001087,2024-12-02T15:29:33,ACC00003821,Transfer,286.83,-231338.99,EUR,Grocery
TXN0000001088,2024-04-13T19:53:16,ACC00006360,ATM,249.96,-231588.95,JPY,Grocery
TXN0000001089,2024-07-29T03:22:05,ACC00000817,Debit,598.45,-232187.4,GBP,Starbucks
TXN0000001090,2024-04-19T15:16:22,ACC00007603,Transfer,309.51,-231877.89,EUR,Walmart
TXN0000001091,2024-09-30T21:35:09,ACC00003043,Payment,967.73,-232845.62,EUR,Restaurant
TXN0000001092,2024-09-05T21:31:59,ACC00002030,Payment,1867.66,-234713.28,JPY,Starbucks
TXN0000001093,2024-06-16T23:34:56,ACC00008395,Credit,462.13,-234251.15,GBP,Grocery
TXN0000001094,2024-10-10T17:44:05,ACC00005862,ATM,242.03,-234493.18,JPY,Grocery
TXN0000001095,2024-09-08T00:51:49,ACC00000186,ATM,466.34,-234959.52,GBP,Grocery
TXN0000001096,2024-11-24T08:10:56,ACC00009739,Credit,268.72,-234690.8,GBP,Target
TXN0000001097,2024-09-30T22:16:14,ACC00006114,ATM,921.46,-235612.26,EUR,Walmart
TXN0000001098,2024-05-27T01:37:11,ACC00006333,Credit,965.05,-234647.21,JPY,Grocery
TXN0000001099,2024-06-03T04:18:53,ACC00002291,Payment,1253.88,-235901.09,GBP,Online Store
TXN0000001100,2024-07-23T08:26:57,ACC00006740,ATM,1518.69,-237419.78,JPY,Online Store
TXN0000001101,2024-05-03T01:51:41,ACC00003312,Transfer,211.85,-237207.93,USD,Grocery
TXN0000001102,2024-09-22T15:23:37,ACC00004275,Debit,705.08,-237913.01,USD,Grocery
TXN0000001103,2024-11-26T16:45:47,ACC00008580,Debit,1655.76,-239568.77,GBP,Restaurant
TXN0000001104,2024-03-04T11:19:48,ACC00007925,ATM,949.77,-240518.54,USD,Grocery
TXN0000001105,2024-07-28T11:21:38,ACC00000590,Transfer,1042.14,-239476.4,EUR,Online Store
TXN0000001106,2024-03-27T10:15:19,ACC00007179,ATM,1957.53,-241433.93,EUR,Grocery
TXN0000001107,2024-07-08T16:33:51,ACC00002632,Transfer,1505.0,-239928.93,USD,Starbucks
TXN0000001108,2024-02-08T09:11:26,ACC00001445,Transfer,683.35,-239245.58,USD,Online Store
TXN0000001109,2024-06-14T05:50:55,ACC00004001,Payment,1533.35,-240778.93,GBP,Amazon
TXN0000001110,2024-07-16T03:28:49,ACC00003450,Credit,321.11,-240457.82,JPY,Target
TXN0000001111,2024-04-10T19:34:06,ACC00006694,Credit,1021.35,-239436.47,JPY,Shell
TXN0000001112,2024-08-09T14:22:28,ACC00004992,Transfer,1869.06,-237567.41,JPY,Amazon
TXN0000001113,2024-11-29T07:10:02,ACC00008346,Payment,551.18,-238118.59,EUR,Online Store
TXN0000001114,2024-02-13T19:39:33,ACC00000389,Transfer,1456.08,-236662.51,USD,Starbucks
TXN0000001115,2024-05-04T11:44:31,ACC00004036,Credit,940.02,-235722.49,JPY,Online Store
TXN0000001116,2024-12-14T07:42:34,ACC00008508,Payment,1824.9,-237547.39,GBP,Amazon
TXN0000001117,2024-12-09T10:35:23,ACC00005302,Debit,420.46,-237967.85,USD,Restaurant
TXN0000001118,2024-05-30T16:10:45,ACC00006124,Payment,202.53,-238170.38,USD,Amazon
TXN0000001119,2024-08-30T14:43:53,ACC00004064,ATM,592.67,-238763.05,EUR,Online Store
TXN0000001120,2024-03-03T05:10:52,ACC00002988,ATM,655.19,-239418.24,EUR,Grocery
TXN0000001121,2024-11-16T11:56:27,ACC00002329,Payment,1444.63,-240862.87,EUR,Walmart
TXN0000001122,2024-07-14T13:52:11,ACC00005062,Transfer,1500.83,-239362.04,JPY,Starbucks
TXN0000001123,2024-06-02T05:03:12,ACC00008972,Transfer,1245.74,-238116.3,EUR,Online Store
TXN0000001124,2024-03-26T20:29:00,ACC00005483,Payment,1092.29,-239208.59,EUR,Restaurant
TXN0000001125,2024-03-26T15:30:56,ACC00000816,Credit,1021.55,-238187.04,EUR,Target
TXN0000001126,2024-10-04T23:48:09,ACC00001219,Transfer,1087.33,-237099.71,GBP,Starbucks
TXN0000001127,2024-06-03T08:55:03,ACC00006920,ATM,302.98,-237402.69,JPY,Restaurant
TXN0000001128,2024-03-16T20:54:47,ACC00003711,Credit,397.82,-237004.87,USD,Online Store
TXN0000001129,2024-05-04T04:30:37,ACC00009102,ATM,1331.71,-238336.58,USD,Amazon
TXN0000001130,2024-09-24T13:26:25,ACC00008101,Debit,707.16,-239043.74,USD,Walmart
TXN0000001131,2024-05-28T20:56:27,ACC00002750,Debit,1074.01,-240117.75,USD,Online Store
TXN0000001132,2024-02-05T19:00:45,ACC00004053,Payment,1175.27,-241293.02,JPY,Grocery
TXN0000001133,2024-09-05T02:22:10,ACC00008803,Transfer,793.65,-240499.37,USD,Walmart
TXN0000001134,2024-01-08T12:44:04,ACC00002469,ATM,1667.63,-242167.0,JPY,Shell
TXN0000001135,2024-06-28T15:47:29,ACC00001646,Payment,222.32,-242389.32,USD,Online Store
TXN0000001136,2024-11-19T01:43:11,ACC00006807,Transfer,740.62,-241648.7,EUR,Restaurant
TXN0000001137,2024-03-08T19:34:35,ACC00001871,ATM,1960.82,-243609.52,GBP,Restaurant
TXN0000001138,2024-12-09T01:30:05,ACC00008358,Credit,1584.27,-242025.25,JPY,Walmart
TXN0000001139,2024-07-01T07:08:37,ACC00004081,ATM,806.31,-242831.56,JPY,Walmart
TXN0000001140,2024-04-10T07:10:56,ACC00003136,Debit,618.16,-243449.72,JPY,Shell
TXN0000001141,2024-12-23T18:40:04,ACC00006097,ATM,828.88,-244278.6,USD,Target
TXN0000001142,2024-05-07T20:04:39,ACC00008190,ATM,482.9,-244761.5,EUR,Grocery
TXN0000001143,2024-06-03T13:12:20,ACC00007060,ATM,136.84,-244898.34,USD,Amazon
TXN0000001144,2024-01-07T02:12:20,ACC00007774,Payment,1137.78,-246036.12,JPY,Starbucks
TXN0000001145,2024-06-13T20:09:55,ACC00003886,ATM,1271.34,-247307.46,GBP,Online Store
TXN0000001146,2024-05-24T00:08:24,ACC00001344,Payment,817.77,-248125.23,GBP,Online Store
TXN0000001147,2024-11-09T21:08:03,ACC00007532,Debit,488.19,-248613.42,EUR,Walmart
TXN0000001148,2024-02-25T18:54:02,ACC00006522,Payment,832.33,-249445.75,USD,Online Store
TXN0000001149,2024-06-07T08:27:06,ACC00005466,Credit,304.0,-249141.75,GBP,Restaurant
TXN0000001150,2024-03-28T12:57:47,ACC00003731,Debit,1655.15,-250796.9,EUR,Shell
TXN0000001151,2024-08-21T02:18:15,ACC00004329,ATM,1478.64,-252275.54,USD,Walmart
TXN0000001152,2024-10-17T10:51:56,ACC00009295,Payment,1959.61,-254235.15,JPY,Starbucks
TXN0000001153,2024-05-28T20:08:57,ACC00004686,Credit,229.08,-254006.07,EUR,Starbucks
TXN0000001154,2024-05-02T23:11:49,ACC00005678,Debit,1369.37,-255375.44,USD,Target
TXN0000001155,2024-10-25T04:11:38,ACC00006096,Debit,670.37,-256045.81,USD,Amazon
TXN0000001156,2024-05-19T09:49:18,ACC00009300,ATM,369.43,-256415.24,USD,Shell
TXN0000001157,2024-03-30T14:57:35,ACC00000153,ATM,230.32,-256645.56,GBP,Walmart
TXN0000001158,2024-12-04T04:30:52,ACC00001947,Payment,788.83,-257434.39,EUR,Restaurant
TXN0000001159,2024-08-18T08:20:26,ACC00006143,Debit,575.57,-258009.96,JPY,Online Store
TXN0000001160,2024-07-03T11:21:51,ACC00000260,Transfer,1850.93,-256159.03,USD,Walmart
TXN0000001161,2024-01-26T23:48:39,ACC00007725,Transfer,1726.45,-254432.58,GBP,Starbucks
TXN0000001162,2024-06-03T01:43:28,ACC00005764,Transfer,246.88,-254185.7,JPY,Walmart
TXN0000001163,2024-08-16T18:38:50,ACC00006565,Payment,1434.45,-255620.15,GBP,Walmart
TXN0000001164,2024-06-05T14:47:42,ACC00009216,Debit,1993.62,-257613.77,USD,Shell
TXN0000001165,2024-07-24T08:43:02,ACC00006579,Credit,1676.84,-255936.93,USD,Restaurant
TXN0000001166,2024-08-11T14:55:26,ACC00009179,Payment,1987.82,-257924.75,JPY,Restaurant
TXN0000001167,2024-03-12T04:45:12,ACC00001509,Payment,1465.17,-259389.92,USD,Starbucks
TXN0000001168,2024-01-30T15:11:00,ACC00000286,Debit,593.59,-259983.51,EUR,Amazon
TXN0000001169,2024-08-10T15:47:27,ACC00007488,ATM,1178.84,-261162.35,GBP,Shell
TXN0000001170,2024-09-21T14:48:47,ACC00004659,Payment,476.49,-261638.84,JPY,Online Store
TXN0000001171,2024-03-24T04:14:28,ACC00009811,ATM,1954.09,-263592.93,USD,Amazon
TXN0000001172,2024-09-18T22:57:38,ACC00009101,ATM,768.77,-264361.7,GBP,Grocery
TXN0000001173,2024-03-09T18:20:26,ACC00007863,Payment,1540.71,-265902.41,USD,Target
TXN0000001174,2024-10-11T13:24:30,ACC00006456,ATM,238.48,-266140.89,EUR,Walmart
TXN0000001175,2024-08-31T12:00:40,ACC00003290,Debit,477.97,-266618.86,GBP,Shell
TXN0000001176,2024-11-07T20:39:15,ACC00004265,ATM,1642.35,-268261.21,GBP,Online Store
TXN0000001177,2024-12-07T03:21:42,ACC00007488,Transfer,976.23,-267284.98,USD,Walmart
TXN0000001178,2024-12-28T13:16:34,ACC00003063,Debit,811.48,-268096.46,GBP,Walmart
TXN0000001179,2024-11-06T02:48:33,ACC00007157,Payment,605.48,-268701.94,USD,Walmart
TXN0000001180,2024-10-16T00:39:44,ACC00000178,Payment,372.06,-269074.0,JPY,Target
TXN0000001181,2024-10-22T12:59:21,ACC00001820,Transfer,765.75,-268308.25,JPY,Target
TXN0000001182,2024-04-07T00:06:56,ACC00005497,Payment,404.39,-268712.64,GBP,Shell
TXN0000001183,2024-06-01T19:39:23,ACC00003538,Debit,389.31,-269101.95,USD,Shell
TXN0000001184,2024-07-25T10:13:03,ACC00008135,Credit,1459.75,-267642.2,JPY,Amazon
TXN0000001185,2024-01-29T17:40:11,ACC00008213,Transfer,1758.16,-265884.04,EUR,Amazon
TXN0000001186,2024-12-13T05:55:30,ACC00008217,ATM,173.62,-266057.66,EUR,Restaurant
TXN0000001187,2024-07-20T16:46:12,ACC00007693,Payment,531.88,-266589.54,USD,Online Store
TXN0000001188,2024-11-30T02:15:30,ACC00009406,Credit,1930.99,-264658.55,GBP,Target
TXN0000001189,2024-03-19T05:01:10,ACC00005907,Credit,1235.06,-263423.49,JPY,Amazon
TXN0000001190,2024-03-18T04:13:43,ACC00003186,ATM,1048.46,-264471.95,GBP,Walmart
TXN0000001191,2024-05-16T12:51:00,ACC00000037,Transfer,511.31,-263960.64,GBP,Amazon
TXN0000001192,2024-09-09T05:54:16,ACC00006305,Debit,1363.96,-265324.6,JPY,Amazon
TXN0000001193,2024-02-18T07:23:30,ACC00004751,Transfer,355.92,-264968.68,USD,Target
TXN0000001194,2024-07-28T18:00:16,ACC00000110,ATM,583.47,-265552.15,USD,Online Store
TXN0000001195,2024-10-04T22:38:48,ACC00000965,ATM,1692.17,-267244.32,JPY,Grocery
TXN0000001196,2024-01-16T06:26:40,ACC00007574,Payment,365.95,-267610.27,JPY,Restaurant
TXN0000001197,2024-09-22T09:54:19,ACC00008691,Debit,228.69,-267838.96,GBP,Amazon
TXN0000001198,2024-02-06T11:20:18,ACC00000728,Debit,734.07,-268573.03,EUR,Target
TXN0000001199,2024-09-01T14:25:29,ACC00001105,Transfer,537.18,-268035.85,USD,Online Store
TXN0000001200,2024-08-07T09:24:29,ACC00007406,ATM,1935.37,-269971.22,USD,Target
TXN0000001201,2024-12-18T20:52:18,ACC00008115,Payment,355.6,-270326.82,EUR,Target
TXN0000001202,2024-02-29T23:09:46,ACC00005129,Transfer,248.87,-270077.95,EUR,Starbucks
TXN0000001203,2024-10-16T04:53:37,ACC00006109,Payment,773.41,-270851.36,JPY,Grocery
TXN0000001204,2024-10-18T23:47:57,ACC00006219,Credit,611.88,-270239.48,EUR,Walmart
TXN0000001205,2024-12-26T00:07:35,ACC00005263,Debit,1278.97,-271518.45,GBP,Amazon
TXN0000001206,2024-12-17T17:30:24,ACC00004521,ATM,1398.18,-272916.63,EUR,Restaurant
TXN0000001207,2024-12-22T16:31:04,ACC00000735,Transfer,763.49,-272153.14,USD,Amazon
TXN0000001208,2024-05-13T01:30:31,ACC00007036,Debit,756.05,-272909.19,JPY,Grocery
TXN0000001209,2024-06-29T16:39:58,ACC00009663,Payment,455.67,-273364.86,USD,Grocery
TXN0000001210,2024-01-22T18:42:17,ACC00001682,ATM,1153.61,-274518.47,EUR,Amazon
TXN0000001211,2024-11-11T07:53:09,ACC00004133,Debit,1366.65,-275885.12,JPY,Target
TXN0000001212,2024-05-17T09:21:18,ACC00001826,Payment,1636.2,-277521.32,GBP,Grocery
TXN0000001213,2024-08-20T11:59:14,ACC00007149,Payment,1620.71,-279142.03,USD,Amazon
TXN0000001214,2024-05-16T23:44:23,ACC00006192,Transfer,1010.76,-278131.27,GBP,Walmart
TXN0000001215,2024-03-29T16:45:38,ACC00001837,ATM,524.73,-278656.0,GBP,Grocery
TXN0000001216,2024-07-26T21:28:00,ACC00004258,Credit,396.96,-278259.04,EUR,Starbucks
TXN0000001217,2024-06-17T10:54:29,ACC00002589,Payment,980.64,-279239.68,USD,Grocery
TXN0000001218,2024-12-30T03:09:33,ACC00007578,Credit,453.22,-278786.46,EUR,Online Store
TXN0000001219,2024-12-11T19:45:47,ACC00004372,Payment,1297.67,-280084.13,USD,Target
TXN0000001220,2024-06-04T20:33:01,ACC00000073,Transfer,1520.61,-278563.52,EUR,Grocery
TXN0000001221,2024-02-21T18:17:03,ACC00009889,Transfer,1888.39,-276675.13,USD,Target
TXN0000001222,2024-01-25T23:38:56,ACC00009447,Transfer,1906.77,-274768.36,EUR,Online Store
TXN0000001223,2024-05-11T02:34:23,ACC00004832,Payment,958.5,-275726.86,USD,Shell
TXN0000001224,2024-07-21T13:02:42,ACC00006022,ATM,670.96,-276397.82,EUR,Walmart
TXN0000001225,2024-02-27T08:50:15,ACC00007701,Transfer,1080.7,-275317.12,JPY,Starbucks
TXN0000001226,2024-04-03T07:37:38,ACC00003388,Debit,1544.69,-276861.81,GBP,Shell
TXN0000001227,2024-05-29T04:17:11,ACC00002490,Debit,293.46,-277155.27,GBP,Shell
TXN0000001228,2024-11-10T00:04:42,ACC00000293,Credit,84.32,-277070.95,JPY,Restaurant
TXN0000001229,2024-10-25T05:50:37,ACC00009164,Debit,983.07,-278054.02,GBP,Shell
TXN0000001230,2024-01-24T18:29:12,ACC00006054,Transfer,1843.98,-276210.04,USD,Walmart
TXN0000001231,2024-08-04T20:48:59,ACC00009905,Credit,1693.13,-274516.91,USD,Restaurant
TXN0000001232,2024-04-07T00:03:07,ACC00007451,Payment,1731.89,-276248.8,EUR,Shell
TXN0000001233,2024-07-07T03:17:08,ACC00008417,Debit,604.22,-276853.02,USD,Amazon
TXN0000001234,2024-09-15T02:43:59,ACC00005009,Debit,993.59,-277846.61,JPY,Walmart
TXN0000001235,2024-11-20T14:06:19,ACC00004267,Debit,172.64,-278019.25,USD,Online Store
TXN0000001236,2024-01-25T04:26:02,ACC00007412,ATM,1188.57,-279207.82,JPY,Restaurant
TXN0000001237,2024-07-24T01:17:30,ACC00001462,Credit,1784.17,-277423.65,JPY,Amazon
TXN0000001238,2024-03-18T20:57:01,ACC00008473,Transfer,878.72,-276544.93,USD,Target
TXN0000001239,2024-07-04T12:55:02,ACC00002486,Transfer,110.82,-276434.11,USD,Shell
TXN0000001240,2024-07-12T22:54:19,ACC00000283,Transfer,346.77,-276087.34,GBP,Amazon
TXN0000001241,2024-07-20T20:11:08,ACC00008835,Debit,1129.18,-277216.52,EUR,Online Store
TXN0000001242,2024-08-22T18:54:44,ACC00005566,Credit,657.27,-276559.25,USD,Walmart
TXN0000001243,2024-09-03T00:44:44,ACC00006201,ATM,523.9,-277083.15,EUR,Amazon
TXN0000001244,2024-08-04T18:41:13,ACC00003270,ATM,39.34,-277122.49,EUR,Online Store
TXN0000001245,2024-06-15T23:26:11,ACC00005893,ATM,1050.53,-278173.02,USD,Grocery
TXN0000001246,2024-10-05T03:31:26,ACC00001924,ATM,1504.52,-279677.54,EUR,Shell
TXN0000001247,2024-11-27T04:52:30,ACC00005341,Transfer,253.29,-279424.25,EUR,Starbucks
TXN0000001248,2024-09-11T18:02:03,ACC00004725,Payment,318.55,-279742.8,JPY,Target
TXN0000001249,2024-06-13T01:45:39,ACC00007182,Transfer,1980.26,-277762.54,JPY,Target
TXN0000001250,2024-04-23T03:00:15,ACC00003218,Transfer,1421.0,-276341.54,USD,Walmart
TXN0000001251,2024-02-27T06:25:36,ACC00004766,Debit,1910.66,-278252.2,USD,Starbucks
TXN0000001252,2024-10-06T10:44:15,ACC00004179,Transfer,413.55,-277838.65,JPY,Grocery
TXN0000001253,2024-07-28T21:34:51,ACC00002925,Transfer,552.19,-277286.46,USD,Shell
TXN0000001254,2024-01-03T16:31:12,ACC00002814,Debit,1554.09,-278840.55,JPY,Starbucks
TXN0000001255,2024-10-18T21:26:36,ACC00008528,Debit,1181.16,-280021.71,GBP,Target
TXN0000001256,2024-02-05T00:18:42,ACC00004927,ATM,1762.93,-281784.64,USD,Online Store
TXN0000001257,2024-07-23T16:13:54,ACC00000082,Payment,1485.71,-283270.35,USD,Starbucks
TXN0000001258,2024-09-07T18:37:33,ACC00001668,ATM,364.98,-283635.33,JPY,Amazon
TXN0000001259,2024-02-23T18:53:16,ACC00003258,Transfer,1233.58,-282401.75,GBP,Starbucks
TXN0000001260,2024-08-12T10:29:14,ACC00001235,Credit,556.6,-281845.15,USD,Walmart
TXN0000001261,2024-08-02T23:45:38,ACC00009855,Debit,1585.13,-283430.28,USD,Grocery
TXN0000001262,2024-03-20T01:25:55,ACC00002714,Transfer,1281.14,-282149.14,JPY,Grocery
TXN0000001263,2024-06-29T03:56:44,ACC00007096,ATM,96.76,-282245.9,EUR,Starbucks
TXN0000001264,2024-07-09T06:09:40,ACC00006191,Transfer,347.95,-281897.95,EUR,Grocery
TXN0000001265,2024-01-27T19:47:42,ACC00005937,ATM,147.9,-282045.85,EUR,Online Store
TXN0000001266,2024-01-07T16:01:01,ACC00004800,Debit,592.1,-282637.95,GBP,Amazon
TXN0000001267,2024-11-25T16:33:55,ACC00009066,Debit,400.49,-283038.44,GBP,Amazon
TXN0000001268,2024-11-14T20:27:31,ACC00008469,Transfer,1085.18,-281953.26,JPY,Restaurant
TXN0000001269,2024-02-10T04:40:00,ACC00008459,Debit,148.67,-282101.93,GBP,Online Store
TXN0000001270,2024-01-28T22:32:05,ACC00000879,Credit,385.56,-281716.37,EUR,Restaurant
TXN0000001271,2024-04-13T22:35:12,ACC00009034,Transfer,1092.75,-280623.62,EUR,Target
TXN0000001272,2024-06-18T21:36:31,ACC00005619,Credit,1822.58,-278801.04,JPY,Amazon
TXN0000001273,2024-02-03T16:49:35,ACC00007901,Credit,625.19,-278175.85,JPY,Amazon
TXN0000001274,2024-08-24T11:26:59,ACC00007277,Credit,290.46,-277885.39,JPY,Shell
TXN0000001275,2024-02-22T22:01:27,ACC00009245,Transfer,1604.02,-276281.37,GBP,Grocery
TXN0000001276,2024-12-24T02:57:55,ACC00001223,Payment,1974.33,-278255.7,GBP,Shell
TXN0000001277,2024-04-07T13:20:30,ACC00003088,ATM,1705.23,-279960.93,USD,Amazon
TXN0000001278,2024-01-11T17:14:02,ACC00005827,ATM,1070.48,-281031.41,JPY,Grocery
TXN0000001279,2024-02-11T05:41:49,ACC00002555,ATM,1246.19,-282277.6,EUR,Target
TXN0000001280,2024-12-01T13:44:10,ACC00009241,ATM,1037.48,-283315.08,EUR,Starbucks
TXN0000001281,2024-02-15T10:01:42,ACC00004557,ATM,1400.31,-284715.39,USD,Grocery
TXN0000001282,2024-11-08T22:10:33,ACC00004934,Debit,1433.05,-286148.44,EUR,Grocery
TXN0000001283,2024-11-09T05:04:12,ACC00008411,Transfer,1121.07,-285027.37,GBP,Amazon
TXN0000001284,2024-08-28T10:25:40,ACC00007576,Debit,1545.5,-286572.87,GBP,Amazon
TXN0000001285,2024-05-18T13:07:27,ACC00006565,ATM,1728.12,-288300.99,GBP,Restaurant
TXN0000001286,2024-10-08T09:14:04,ACC00003913,Credit,742.11,-287558.88,EUR,Grocery
TXN0000001287,2024-04-26T06:31:16,ACC00001865,Payment,131.82,-287690.7,USD,Restaurant
TXN0000001288,2024-07-15T17:32:24,ACC00008716,Payment,232.06,-287922.76,USD,Starbucks
TXN0000001289,2024-10-15T06:00:09,ACC00008067,Payment,302.29,-288225.05,EUR,Restaurant
TXN0000001290,2024-09-12T08:29:24,ACC00009018,ATM,1521.92,-289746.97,USD,Target
TXN0000001291,2024-03-25T09:35:53,ACC00006670,ATM,1889.95,-291636.92,GBP,Restaurant
TXN0000001292,2024-01-12T12:36:30,ACC00008034,Debit,313.65,-291950.57,USD,Restaurant
TXN0000001293,2024-10-31T13:14:54,ACC00005077,Debit,1147.11,-293097.68,GBP,Shell
TXN0000001294,2024-09-13T05:45:31,ACC00002567,Payment,570.66,-293668.34,JPY,Amazon
TXN0000001295,2024-09-16T16:48:58,ACC00007047,ATM,1338.57,-295006.91,EUR,Restaurant
TXN0000001296,2024-06-02T00:44:45,ACC00005617,Debit,538.06,-295544.97,USD,Grocery
TXN0000001297,2024-10-03T09:15:17,ACC00009292,ATM,181.42,-295726.39,EUR,Online Store
TXN0000001298,2024-05-30T13:20:10,ACC00009415,Transfer,70.48,-295655.91,GBP,Grocery
TXN0000001299,2024-04-29T23:50:29,ACC00007099,Credit,152.41,-295503.5,GBP,Restaurant
TXN0000001300,2024-10-28T10:09:31,ACC00004771,Payment,1235.13,-296738.63,JPY,Restaurant
TXN0000001301,2024-05-17T09:46:22,ACC00008921,Credit,191.69,-296546.94,GBP,Online Store
TXN0000001302,2024-12-02T17:56:32,ACC00005158,Payment,1669.89,-298216.83,GBP,Walmart
TXN0000001303,2024-01-05T09:21:46,ACC00005264,Transfer,1896.52,-296320.31,USD,Shell
TXN0000001304,2024-12-24T16:35:58,ACC00002355,Debit,861.39,-297181.7,USD,Shell
TXN0000001305,2024-06-02T18:45:36,ACC00006883,Payment,797.89,-297979.59,USD,Shell
TXN0000001306,2024-07-11T11:33:37,ACC00002549,Payment,1795.84,-299775.43,JPY,Target
TXN0000001307,2024-04-18T10:21:14,ACC00002795,Payment,170.89,-299946.32,JPY,Grocery
TXN0000001308,2024-10-27T22:32:59,ACC00007779,Payment,1153.1,-301099.42,EUR,Target
TXN0000001309,2024-03-04T11:02:57,ACC00007033,Transfer,149.31,-300950.11,EUR,Walmart
TXN0000001310,2024-09-27T02:32:05,ACC00008337,Credit,428.88,-300521.23,GBP,Amazon
TXN0000001311,2024-09-10T05:46:46,ACC00008665,Credit,421.93,-300099.3,EUR,Target
TXN0000001312,2024-08-17T12:26:43,ACC00001703,Payment,914.2,-301013.5,GBP,Target
TXN0000001313,2024-07-27T17:29:46,ACC00008889,Credit,941.18,-300072.32,EUR,Target
TXN0000001314,2024-11-01T05:41:20,ACC00001535,Debit,1938.01,-302010.33,EUR,Restaurant
TXN0000001315,2024-10-08T07:17:26,ACC00007544,Transfer,592.28,-301418.05,JPY,Shell
TXN0000001316,2024-04-20T13:06:42,ACC00003219,ATM,1221.41,-302639.46,GBP,Starbucks
TXN0000001317,2024-02-07T04:49:27,ACC00009145,Payment,355.56,-302995.02,JPY,Restaurant
TXN0000001318,2024-04-11T11:20:52,ACC00008210,Payment,75.92,-303070.94,GBP,Grocery
TXN0000001319,2024-03-23T00:49:44,ACC00007180,Credit,1815.2,-301255.74,JPY,Restaurant
TXN0000001320,2024-03-15T19:05:49,ACC00003039,ATM,757.75,-302013.49,USD,Grocery
TXN0000001321,2024-06-23T00:23:09,ACC00000833,Debit,1689.22,-303702.71,GBP,Grocery
TXN0000001322,2024-03-20T22:23:00,ACC00002071,Debit,421.96,-304124.67,EUR,Shell
TXN0000001323,2024-01-06T23:32:19,ACC00006326,ATM,228.94,-304353.61,JPY,Amazon
TXN0000001324,2024-10-16T06:18:51,ACC00006135,Transfer,1820.94,-302532.67,JPY,Grocery
TXN0000001325,2024-01-12T23:40:30,ACC00001387,Credit,1887.4,-300645.27,USD,Online Store
TXN0000001326,2024-06-14T14:40:21,ACC00009923,Credit,1229.11,-299416.16,GBP,Online Store
TXN0000001327,2024-07-06T11:16:47,ACC00001242,Debit,541.53,-299957.69,JPY,Walmart
TXN0000001328,2024-12-21T10:39:58,ACC00003693,Credit,725.55,-299232.14,EUR,Target
TXN0000001329,2024-12-18T00:47:40,ACC00000953,ATM,1237.9,-300470.04,EUR,Starbucks
TXN0000001330,2024-01-31T02:21:26,ACC00007132,Credit,1034.06,-299435.98,GBP,Amazon
TXN0000001331,2024-10-20T19:48:58,ACC00007980,Credit,1814.32,-297621.66,JPY,Shell
TXN0000001332,2024-10-03T20:27:53,ACC00000965,Transfer,525.37,-297096.29,GBP,Amazon
TXN0000001333,2024-11-27T01:35:45,ACC00000642,Payment,344.26,-297440.55,USD,Restaurant
TXN0000001334,2024-08-25T00:33:35,ACC00004301,Credit,1293.24,-296147.31,GBP,Online Store
TXN0000001335,2024-07-03T11:05:42,ACC00007723,Debit,1609.52,-297756.83,JPY,Shell
TXN0000001336,2024-01-21T03:35:42,ACC00006484,Transfer,1550.42,-296206.41,EUR,Target
TXN0000001337,2024-09-20T01:37:28,ACC00005558,Payment,638.12,-296844.53,EUR,Grocery
TXN0000001338,2024-10-02T14:18:19,ACC00002102,ATM,1369.47,-298214.0,GBP,Online Store
TXN0000001339,2024-08-04T22:17:13,ACC00002068,Transfer,117.82,-298096.18,EUR,Online Store
TXN0000001340,2024-12-07T04:23:22,ACC00000071,Debit,985.14,-299081.32,JPY,Starbucks
TXN0000001341,2024-05-09T04:25:33,ACC00009255,ATM,1724.46,-300805.78,JPY,Shell
TXN0000001342,2024-05-18T18:15:00,ACC00000592,ATM,97.13,-300902.91,EUR,Walmart
TXN0000001343,2024-01-18T19:42:53,ACC00003573,ATM,754.1,-301657.01,USD,Target
TXN0000001344,2024-05-15T07:54:50,ACC00000592,Debit,1580.36,-303237.37,JPY,Starbucks
TXN0000001345,2024-08-01T18:33:37,ACC00002784,ATM,1805.96,-305043.33,USD,Shell
TXN0000001346,2024-05-12T18:24:41,ACC00007627,Credit,1801.24,-303242.09,GBP,Restaurant
TXN0000001347,2024-02-22T19:48:05,ACC00009878,Transfer,1121.2,-302120.89,GBP,Restaurant
TXN0000001348,2024-07-12T03:34:44,ACC00008565,Payment,162.15,-302283.04,USD,Walmart
TXN0000001349,2024-04-05T09:10:19,ACC00003941,Debit,1174.51,-303457.55,GBP,Target
TXN0000001350,2024-03-20T12:18:19,ACC00007216,ATM,1566.62,-305024.17,USD,Amazon
TXN0000001351,2024-11-03T12:27:12,ACC00007413,Transfer,1657.45,-303366.72,USD,Grocery
TXN0000001352,2024-10-27T04:55:45,ACC00008707,Transfer,1133.22,-302233.5,JPY,Amazon
TXN0000001353,2024-12-19T14:51:01,ACC00005216,Transfer,1293.21,-300940.29,USD,Starbucks
TXN0000001354,2024-12-10T12:41:55,ACC00008676,Debit,1673.29,-302613.58,GBP,Target
TXN0000001355,2024-09-23T18:11:24,ACC00001691,ATM,350.69,-302964.27,JPY,Starbucks
TXN0000001356,2024-11-22T14:04:05,ACC00006122,Debit,444.34,-303408.61,EUR,Starbucks
TXN0000001357,2024-01-25T08:11:51,ACC00003184,Transfer,1003.27,-302405.34,JPY,Grocery
TXN0000001358,2024-05-22T13:42:53,ACC00000019,Transfer,134.25,-302271.09,EUR,Restaurant
TXN0000001359,2024-02-04T16:58:28,ACC00000540,Transfer,1177.53,-301093.56,GBP,Online Store
TXN0000001360,2024-06-21T05:29:04,ACC00001973,Debit,572.91,-301666.47,JPY,Walmart
TXN0000001361,2024-06-12T19:19:38,ACC00004511,Payment,1027.58,-302694.05,EUR,Amazon
TXN0000001362,2024-03-09T07:54:30,ACC00001525,Payment,752.42,-303446.47,EUR,Grocery
TXN0000001363,2024-08-18T02:51:32,ACC00000484,Credit,272.47,-303174.0,EUR,Starbucks
TXN0000001364,2024-11-14T00:55:48,ACC00003056,Transfer,504.65,-302669.35,USD,Target
TXN0000001365,2024-05-18T16:29:05,ACC00008562,Debit,1391.72,-304061.07,EUR,Target
TXN0000001366,2024-05-31T16:31:02,ACC00009118,Debit,894.24,-304955.31,USD,Starbucks
TXN0000001367,2024-07-19T20:54:23,ACC00007312,Credit,1641.55,-303313.76,JPY,Amazon
TXN0000001368,2024-10-17T03:28:21,ACC00003090,Credit,975.96,-302337.8,GBP,Shell
TXN0000001369,2024-11-07T23:10:47,ACC00000956,Transfer,319.85,-302017.95,USD,Amazon
TXN0000001370,2024-03-07T05:13:44,ACC00008279,Credit,774.28,-301243.67,JPY,Online Store
TXN0000001371,2024-03-21T10:12:40,ACC00002529,Debit,352.19,-301595.86,JPY,Restaurant
TXN0000001372,2024-12-16T00:20:27,ACC00000721,Credit,369.24,-301226.62,USD,Shell
TXN0000001373,2024-03-30T07:02:45,ACC00007360,Debit,1754.79,-302981.41,GBP,Starbucks
TXN0000001374,2024-03-30T23:14:36,ACC00009793,Transfer,610.71,-302370.7,EUR,Walmart
TXN0000001375,2024-12-25T09:25:33,ACC00002996,ATM,1527.77,-303898.47,USD,Target
TXN0000001376,2024-05-06T02:30:05,ACC00007654,Credit,1071.46,-302827.01,GBP,Online Store
TXN0000001377,2024-12-24T09:29:25,ACC00005042,Credit,616.94,-302210.07,EUR,Restaurant
TXN0000001378,2024-03-05T21:19:50,ACC00008045,Payment,1241.61,-303451.68,JPY,Target
TXN0000001379,2024-08-10T17:40:34,ACC00006018,Payment,715.06,-304166.74,GBP,Online Store
TXN0000001380,2024-10-22T00:21:58,ACC00009692,Transfer,657.06,-303509.68,USD,Grocery
TXN0000001381,2024-08-23T02:10:05,ACC00002029,ATM,659.28,-304168.96,GBP,Restaurant
TXN0000001382,2024-08-29T17:59:41,ACC00003991,Transfer,661.13,-303507.83,JPY,Shell
TXN0000001383,2024-04-26T01:54:03,ACC00007396,Debit,402.94,-303910.77,JPY,Target
TXN0000001384,2024-07-03T00:38:45,ACC00006875,Debit,779.23,-304690.0,JPY,Starbucks
TXN0000001385,2024-10-23T17:52:36,ACC00000623,Credit,1378.71,-303311.29,GBP,Online Store
TXN0000001386,2024-05-02T22:07:52,ACC00006412,ATM,1538.44,-304849.73,EUR,Walmart
TXN0000001387,2024-05-23T12:34:08,ACC00004664,ATM,619.13,-305468.86,JPY,Amazon
TXN0000001388,2024-12-20T21:03:22,ACC00000090,Debit,1089.11,-306557.97,JPY,Online Store
TXN0000001389,2024-02-18T04:32:12,ACC00005151,Debit,1352.33,-307910.3,EUR,Grocery
TXN0000001390,2024-02-17T21:05:03,ACC00002312,ATM,1354.1,-309264.4,GBP,Target
TXN0000001391,2024-03-05T12:40:05,ACC00000950,Transfer,178.81,-309085.59,JPY,Online Store
TXN0000001392,2024-02-08T13:12:58,ACC00001066,Credit,1125.76,-307959.83,USD,Target
TXN0000001393,2024-08-28T22:40:10,ACC00005520,Payment,1857.25,-309817.08,GBP,Online Store
TXN0000001394,2024-10-27T16:07:59,ACC00003794,ATM,1745.41,-311562.49,EUR,Restaurant
TXN0000001395,2024-10-13T00:23:52,ACC00005699,Debit,46.47,-311608.96,JPY,Target
TXN0000001396,2024-02-11T17:03:28,ACC00002281,Transfer,1954.16,-309654.8,JPY,Grocery
TXN0000001397,2024-11-17T04:24:02,ACC00006106,Debit,659.58,-310314.38,JPY,Target
TXN0000001398,2024-04-14T22:52:56,ACC00009803,Transfer,1864.83,-308449.55,GBP,Starbucks
TXN0000001399,2024-02-05T11:10:01,ACC00009728,Credit,1746.48,-306703.07,GBP,Amazon
TXN0000001400,2024-06-20T21:11:04,ACC00005913,ATM,1085.75,-307788.82,USD,Restaurant
TXN0000001401,2024-06-14T23:11:48,ACC00008360,ATM,816.56,-308605.38,EUR,Target
TXN0000001402,2024-06-27T22:30:24,ACC00009576,Transfer,1806.47,-306798.91,JPY,Online Store
TXN0000001403,2024-01-31T22:28:43,ACC00006035,Transfer,232.5,-306566.41,JPY,Amazon
TXN0000001404,2024-12-16T09:43:58,ACC00000300,Debit,540.79,-307107.2,EUR,Amazon
TXN0000001405,2024-09-06T07:18:49,ACC00006128,Payment,955.71,-308062.91,GBP,Restaurant
TXN0000001406,2024-12-13T14:30:31,ACC00004569,Debit,1994.85,-310057.76,JPY,Grocery
TXN0000001407,2024-07-24T20:40:08,ACC00003822,Debit,1894.33,-311952.09,JPY,Online Store
TXN0000001408,2024-07-16T09:30:42,ACC00003565,Debit,833.14,-312785.23,JPY,Shell
TXN0000001409,2024-01-09T03:04:24,ACC00008651,ATM,1282.05,-314067.28,USD,Restaurant
TXN0000001410,2024-10-11T10:06:08,ACC00003132,Credit,1598.22,-312469.06,GBP,Shell
TXN0000001411,2024-11-19T06:25:06,ACC00004501,Transfer,1994.6,-310474.46,JPY,Restaurant
TXN0000001412,2024-06-28T09:27:32,ACC00008233,Transfer,936.69,-309537.77,EUR,Walmart
TXN0000001413,2024-02-12T01:29:48,ACC00006349,Transfer,1087.1,-308450.67,GBP,Starbucks
TXN0000001414,2024-11-11T21:13:43,ACC00006337,Transfer,102.73,-308347.94,EUR,Online Store
TXN0000001415,2024-06-18T17:14:46,ACC00007684,Credit,1849.38,-306498.56,EUR,Target
TXN0000001416,2024-07-05T12:11:57,ACC00003697,Credit,1771.61,-304726.95,JPY,Restaurant
TXN0000001417,2024-03-26T21:34:51,ACC00003748,Credit,1744.1,-302982.85,GBP,Walmart
TXN0000001418,2024-06-05T10:05:57,ACC00001666,Payment,18.6,-303001.45,JPY,Shell
TXN0000001419,2024-01-01T08:41:40,ACC00005906,Debit,1203.04,-304204.49,USD,Walmart
TXN0000001420,2024-12-26T21:54:04,ACC00007509,ATM,31.67,-304236.16,EUR,Starbucks
TXN0000001421,2024-08-09T12:17:15,ACC00007342,Credit,746.43,-303489.73,JPY,Restaurant
TXN0000001422,2024-10-23T10:57:20,ACC00002258,Debit,1177.55,-304667.28,GBP,Shell
TXN0000001423,2024-11-02T08:08:58,ACC00007852,ATM,1888.42,-306555.7,JPY,Starbucks
TXN0000001424,2024-10-21T04:07:28,ACC00006088,Transfer,476.96,-306078.74,GBP,Shell
TXN0000001425,2024-03-12T12:54:39,ACC00005111,Transfer,619.69,-305459.05,JPY,Amazon
TXN0000001426,2024-10-16T23:05:07,ACC00004497,Credit,1671.57,-303787.48,GBP,Grocery
TXN0000001427,2024-07-24T14:28:35,ACC00004076,Credit,1648.23,-302139.25,USD,Restaurant
TXN0000001428,2024-04-30T00:28:52,ACC00007296,ATM,1048.52,-303187.77,EUR,Shell
TXN0000001429,2024-04-13T01:59:13,ACC00008603,Transfer,1050.1,-302137.67,USD,Grocery
TXN0000001430,2024-06-17T12:51:21,ACC00003376,Transfer,1441.41,-300696.26,GBP,Restaurant
TXN0000001431,2024-10-17T13:46:33,ACC00002662,Payment,1668.42,-302364.68,EUR,Shell
TXN0000001432,2024-08-13T09:22:38,ACC00001678,Credit,1364.49,-301000.19,USD,Restaurant
TXN0000001433,2024-05-22T09:06:30,ACC00002566,Payment,672.11,-301672.3,USD,Amazon
TXN0000001434,2024-08-14T08:53:56,ACC00004673,Transfer,1973.35,-299698.95,GBP,Amazon
TXN0000001435,2024-03-22T19:42:55,ACC00006104,Payment,1976.78,-301675.73,JPY,Grocery
TXN0000001436,2024-01-06T21:55:53,ACC00004334,Payment,239.85,-301915.58,EUR,Shell
TXN0000001437,2024-05-07T20:29:09,ACC00008541,Transfer,758.1,-301157.48,EUR,Restaurant
TXN0000001438,2024-06-12T12:11:12,ACC00000883,Credit,1430.4,-299727.08,GBP,Shell
TXN0000001439,2024-12-09T16:25:38,ACC00008506,Debit,1726.83,-301453.91,JPY,Online Store
TXN0000001440,2024-07-04T19:02:31,ACC00009098,Debit,843.32,-302297.23,JPY,Amazon
TXN0000001441,2024-05-12T14:00:38,ACC00006300,Payment,1240.38,-303537.61,EUR,Grocery
TXN0000001442,2024-03-17T09:47:03,ACC00002679,Transfer,1792.56,-301745.05,EUR,Grocery
TXN0000001443,2024-01-12T04:10:07,ACC00009248,ATM,1746.42,-303491.47,EUR,Online Store
TXN0000001444,2024-12-17T17:31:28,ACC00001349,Transfer,1133.99,-302357.48,GBP,Grocery
TXN0000001445,2024-08-21T18:10:12,ACC00000177,Transfer,1799.33,-300558.15,GBP,Restaurant
TXN0000001446,2024-01-27T15:21:10,ACC00001860,ATM,1052.93,-301611.08,EUR,Starbucks
TXN0000001447,2024-05-03T19:46:54,ACC00003423,ATM,1033.71,-302644.79,JPY,Walmart
TXN0000001448,2024-09-14T14:08:16,ACC00002040,ATM,318.45,-302963.24,EUR,Shell
TXN0000001449,2024-08-12T15:02:58,ACC00003064,Debit,371.67,-303334.91,USD,Restaurant
TXN0000001450,2024-05-01T11:54:26,ACC00009651,Credit,1881.6,-301453.31,USD,Restaurant
TXN0000001451,2024-10-26T12:05:42,ACC00000981,ATM,274.7,-301728.01,USD,Grocery
TXN0000001452,2024-05-14T13:35:31,ACC00006578,Debit,1963.08,-303691.09,JPY,Walmart
TXN0000001453,2024-06-11T13:53:16,ACC00000392,Payment,1545.09,-305236.18,USD,Shell
TXN0000001454,2024-11-12T02:20:43,ACC00000825,Debit,98.77,-305334.95,GBP,Starbucks
TXN0000001455,2024-11-09T09:50:59,ACC00006389,Credit,1299.64,-304035.31,JPY,Shell
TXN0000001456,2024-08-10T22:49:20,ACC00001616,ATM,1090.78,-305126.09,EUR,Grocery
TXN0000001457,2024-08-31T16:30:19,ACC00001989,ATM,712.02,-305838.11,GBP,Amazon
TXN0000001458,2024-01-10T12:30:01,ACC00000868,Credit,620.66,-305217.45,JPY,Target
TXN0000001459,2024-09-24T04:18:27,ACC00000640,Transfer,605.2,-304612.25,JPY,Walmart
TXN0000001460,2024-08-07T07:39:39,ACC00007845,Debit,1838.92,-306451.17,JPY,Online Store
TXN0000001461,2024-08-28T21:29:07,ACC00008702,Debit,1178.87,-307630.04,EUR,Amazon
TXN0000001462,2024-04-23T08:19:42,ACC00005821,Payment,174.13,-307804.17,USD,Restaurant
TXN0000001463,2024-05-28T06:18:42,ACC00000846,ATM,395.81,-308199.98,USD,Walmart
TXN0000001464,2024-11-13T21:44:42,ACC00002916,Transfer,1937.59,-306262.39,JPY,Starbucks
TXN0000001465,2024-08-10T19:46:06,ACC00009232,Debit,989.51,-307251.9,EUR,Target
TXN0000001466,2024-07-29T10:49:12,ACC00003964,ATM,1818.53,-309070.43,EUR,Online Store
TXN0000001467,2024-09-16T00:27:10,ACC00005998,Debit,928.54,-309998.97,JPY,Walmart
TXN0000001468,2024-01-17T20:46:58,ACC00008276,Payment,550.05,-310549.02,JPY,Restaurant
TXN0000001469,2024-03-12T01:55:40,ACC00005327,ATM,761.4,-311310.42,GBP,Online Store
TXN0000001470,2024-03-28T04:30:54,ACC00002416,Credit,614.68,-310695.74,USD,Starbucks
TXN0000001471,2024-03-04T15:16:52,ACC00005971,ATM,405.5,-311101.24,JPY,Starbucks
TXN0000001472,2024-06-29T15:52:45,ACC00009686,Debit,211.53,-311312.77,GBP,Shell
TXN0000001473,2024-07-23T17:29:17,ACC00002263,ATM,1430.06,-312742.83,EUR,Walmart
TXN0000001474,2024-02-22T16:47:01,ACC00005115,Credit,993.25,-311749.58,USD,Target
TXN0000001475,2024-02-11T11:55:52,ACC00007694,Payment,138.66,-311888.24,USD,Shell
TXN0000001476,2024-02-14T01:01:55,ACC00004467,Credit,1476.46,-310411.78,EUR,Target
TXN0000001477,2024-05-22T05:38:34,ACC00002185,Payment,1527.7,-311939.48,JPY,Target
TXN0000001478,2024-09-16T23:36:58,ACC00003319,ATM,1612.58,-313552.06,GBP,Starbucks
TXN0000001479,2024-02-02T00:35:33,ACC00004368,Payment,1632.56,-315184.62,USD,Restaurant
TXN0000001480,2024-06-14T02:46:34,ACC00003582,Payment,778.14,-315962.76,USD,Starbucks
TXN0000001481,2024-01-27T20:59:14,ACC00009116,Credit,136.48,-315826.28,JPY,Target
TXN0000001482,2024-09-21T18:08:44,ACC00009545,Credit,1758.31,-314067.97,GBP,Starbucks
TXN0000001483,2024-10-06T05:45:06,ACC00007088,Payment,1888.01,-315955.98,JPY,Restaurant
TXN0000001484,2024-10-25T21:38:10,ACC00008408,Transfer,1911.45,-314044.53,GBP,Amazon
TXN0000001485,2024-12-06T11:43:36,ACC00009142,Transfer,885.56,-313158.97,USD,Restaurant
TXN0000001486,2024-01-19T07:14:47,ACC00005262,ATM,1473.39,-314632.36,EUR,Walmart
TXN0000001487,2024-06-08T13:44:05,ACC00000428,Transfer,889.61,-313742.75,USD,Online Store
TXN0000001488,2024-02-07T07:14:12,ACC00003545,Transfer,548.26,-313194.49,GBP,Restaurant
TXN0000001489,2024-11-09T20:53:32,ACC00002562,Payment,713.41,-313907.9,GBP,Grocery
TXN0000001490,2024-02-21T12:27:24,ACC00008032,ATM,189.12,-314097.02,EUR,Shell
TXN0000001491,2024-08-03T04:26:01,ACC00000385,Payment,880.7,-314977.72,USD,Online Store
TXN0000001492,2024-11-24T03:04:57,ACC00004605,Payment,1280.54,-316258.26,USD,Starbucks
TXN0000001493,2024-09-21T05:53:47,ACC00001535,Debit,1744.27,-318002.53,JPY,Shell
TXN0000001494,2024-05-29T21:01:14,ACC00008614,Credit,681.74,-317320.79,EUR,Walmart
TXN0000001495,2024-06-14T05:12:39,ACC00005596,ATM,625.52,-317946.31,GBP,Shell
TXN0000001496,2024-02-07T17:54:53,ACC00003995,Payment,807.13,-318753.44,USD,Walmart
TXN0000001497,2024-12-30T06:14:49,ACC00009020,ATM,334.51,-319087.95,EUR,Target
TXN0000001498,2024-04-21T07:47:39,ACC00000653,Transfer,1106.19,-317981.76,USD,Restaurant
TXN0000001499,2024-04-03T18:16:16,ACC00005835,Transfer,359.82,-317621.94,USD,Target
TXN0000001500,2024-02-27T13:11:34,ACC00009833,ATM,832.46,-318454.4,USD,Online Store
TXN0000001501,2024-04-16T06:57:05,ACC00007052,Debit,1754.05,-320208.45,EUR,Restaurant
TXN0000001502,2024-04-22T10:32:47,ACC00007840,Credit,1474.83,-318733.62,GBP,Restaurant
TXN0000001503,2024-05-15T02:55:50,ACC00005526,Credit,1002.62,-317731.0,USD,Walmart
TXN0000001504,2024-03-19T04:14:00,ACC00001013,Credit,1828.59,-315902.41,GBP,Online Store
TXN0000001505,2024-03-01T00:34:32,ACC00007786,ATM,1067.23,-316969.64,GBP,Restaurant
TXN0000001506,2024-11-24T06:34:21,ACC00001235,Debit,1745.87,-318715.51,EUR,Grocery
TXN0000001507,2024-04-07T08:07:33,ACC00001622,Debit,806.41,-319521.92,EUR,Grocery
TXN0000001508,2024-11-13T15:49:49,ACC00009102,Payment,1374.82,-320896.74,USD,Shell
TXN0000001509,2024-06-04T09:05:51,ACC00002064,Debit,1149.62,-322046.36,GBP,Restaurant
TXN0000001510,2024-09-06T15:06:00,ACC00000687,Transfer,24.26,-322022.1,USD,Grocery
TXN0000001511,2024-01-16T03:11:58,ACC00007572,Debit,757.84,-322779.94,USD,Grocery
TXN0000001512,2024-04-16T17:17:55,ACC00003488,Credit,1920.99,-320858.95,USD,Target
TXN0000001513,2024-07-13T08:26:32,ACC00003313,Debit,1032.71,-321891.66,GBP,Grocery
TXN0000001514,2024-12-07T15:12:02,ACC00000647,Debit,1675.9,-323567.56,EUR,Grocery
TXN0000001515,2024-11-09T01:17:47,ACC00006001,Transfer,961.88,-322605.68,USD,Restaurant
TXN0000001516,2024-09-19T15:09:29,ACC00008348,Debit,402.12,-323007.8,EUR,Grocery
TXN0000001517,2024-11-23T12:24:23,ACC00006133,Payment,423.41,-323431.21,EUR,Starbucks
TXN0000001518,2024-02-12T06:12:48,ACC00005721,Payment,945.43,-324376.64,GBP,Starbucks
TXN0000001519,2024-03-26T05:04:17,ACC00001142,Debit,1622.59,-325999.23,USD,Shell
TXN0000001520,2024-12-27T21:48:05,ACC00005503,ATM,1582.3,-327581.53,GBP,Walmart
TXN0000001521,2024-02-27T10:11:31,ACC00005433,Credit,977.55,-326603.98,JPY,Amazon
TXN0000001522,2024-03-19T05:36:52,ACC00008764,Payment,621.18,-327225.16,JPY,Online Store
TXN0000001523,2024-09-29T20:42:02,ACC00002458,ATM,198.36,-327423.52,JPY,Shell
TXN0000001524,2024-04-04T17:39:53,ACC00001119,Debit,1780.64,-329204.16,EUR,Amazon
TXN0000001525,2024-11-16T08:26:51,ACC00002778,Payment,1951.48,-331155.64,GBP,Online Store
TXN0000001526,2024-11-02T04:44:13,ACC00004629,Credit,1858.32,-329297.32,GBP,Starbucks
TXN0000001527,2024-03-08T12:30:27,ACC00000142,Debit,1280.38,-330577.7,JPY,Starbucks
TXN0000001528,2024-04-17T01:46:14,ACC00005982,Credit,823.93,-329753.77,USD,Walmart
TXN0000001529,2024-03-01T11:59:35,ACC00006420,Transfer,1284.76,-328469.01,GBP,Starbucks
TXN0000001530,2024-06-04T18:46:54,ACC00000768,Payment,806.78,-329275.79,EUR,Target
TXN0000001531,2024-09-09T18:01:32,ACC00000640,Debit,934.3,-330210.09,GBP,Shell
TXN0000001532,2024-04-29T06:06:06,ACC00000127,Payment,1106.39,-331316.48,USD,Grocery
TXN0000001533,2024-03-02T18:32:16,ACC00008440,Credit,1709.88,-329606.6,EUR,Shell
TXN0000001534,2024-11-26T14:39:21,ACC00005570,ATM,1144.84,-330751.44,EUR,Online Store
TXN0000001535,2024-02-09T23:41:22,ACC00003929,Transfer,1230.81,-329520.63,GBP,Walmart
TXN0000001536,2024-06-25T14:27:22,ACC00004848,Debit,1668.76,-331189.39,JPY,Target
TXN0000001537,2024-08-18T17:02:38,ACC00009081,Payment,925.12,-332114.51,JPY,Walmart
TXN0000001538,2024-12-10T11:12:44,ACC00005798,Credit,487.85,-331626.66,EUR,Amazon
TXN0000001539,2024-10-18T07:14:38,ACC00002662,Payment,757.56,-332384.22,GBP,Amazon
TXN0000001540,2024-07-22T07:43:54,ACC00003900,Debit,1398.42,-333782.64,JPY,Target
TXN0000001541,2024-11-08T18:14:16,ACC00007092,Debit,1216.27,-334998.91,USD,Walmart
TXN0000001542,2024-10-18T23:40:15,ACC00004287,Credit,755.72,-334243.19,USD,Restaurant
TXN0000001543,2024-03-19T16:31:06,ACC00009945,Credit,716.93,-333526.26,EUR,Online Store
TXN0000001544,2024-10-23T14:59:33,ACC00007061,Debit,759.91,-334286.17,JPY,Shell
TXN0000001545,2024-07-13T10:37:30,ACC00002372,Payment,759.69,-335045.86,JPY,Walmart
TXN0000001546,2024-12-11T04:19:34,ACC00008284,Credit,286.84,-334759.02,EUR,Restaurant
TXN0000001547,2024-08-18T20:40:43,ACC00007141,Credit,1547.98,-333211.04,GBP,Restaurant
TXN0000001548,2024-09-18T00:39:57,ACC00006118,Transfer,1516.86,-331694.18,USD,Online Store
TXN0000001549,2024-06-18T07:57:33,ACC00009406,ATM,904.5,-332598.68,GBP,Shell
TXN0000001550,2024-09-04T17:23:24,ACC00005849,Transfer,1453.95,-331144.73,JPY,Grocery
TXN0000001551,2024-05-22T15:35:51,ACC00001877,Credit,1687.74,-329456.99,EUR,Grocery
TXN0000001552,2024-10-22T10:23:18,ACC00001386,Credit,1651.85,-327805.14,EUR,Walmart
TXN0000001553,2024-09-30T18:58:09,ACC00001343,Credit,691.62,-327113.52,GBP,Target
TXN0000001554,2024-09-10T13:39:26,ACC00006022,Credit,1223.35,-325890.17,USD,Restaurant
TXN0000001555,2024-03-26T16:06:52,ACC00006713,ATM,376.94,-326267.11,JPY,Starbucks
TXN0000001556,2024-10-13T11:11:02,ACC00003832,Credit,1674.48,-324592.63,JPY,Amazon
TXN0000001557,2024-02-26T18:43:17,ACC00002638,ATM,985.03,-325577.66,USD,Shell
TXN0000001558,2024-10-06T19:55:23,ACC00009706,Debit,1341.43,-326919.09,GBP,Shell
TXN0000001559,2024-05-12T13:00:09,ACC00002638,ATM,774.85,-327693.94,GBP,Target
TXN0000001560,2024-08-22T23:26:27,ACC00000594,Debit,1350.08,-329044.02,USD,Online Store
TXN0000001561,2024-12-24T20:30:04,ACC00003362,Transfer,1235.09,-327808.93,EUR,Starbucks
TXN0000001562,2024-11-03T06:02:30,ACC00000360,Payment,129.52,-327938.45,USD,Starbucks
TXN0000001563,2024-11-21T10:24:55,ACC00006914,ATM,843.4,-328781.85,JPY,Online Store
TXN0000001564,2024-07-06T01:33:10,ACC00006425,Debit,545.62,-329327.47,USD,Online Store
TXN0000001565,2024-02-28T17:56:12,ACC00001932,ATM,988.45,-330315.92,EUR,Online Store
TXN0000001566,2024-08-19T11:48:10,ACC00001003,Payment,544.62,-330860.54,GBP,Grocery
TXN0000001567,2024-04-30T06:25:05,ACC00009395,Credit,1689.77,-329170.77,EUR,Grocery
TXN0000001568,2024-09-12T14:00:28,ACC00000215,Credit,1737.82,-327432.95,JPY,Grocery
TXN0000001569,2024-02-08T08:03:33,ACC00006688,Transfer,1244.09,-326188.86,EUR,Amazon
TXN0000001570,2024-11-06T17:01:32,ACC00001052,Transfer,1413.36,-324775.5,GBP,Target
TXN0000001571,2024-07-24T12:32:09,ACC00008053,Transfer,1453.78,-323321.72,EUR,Restaurant
TXN0000001572,2024-11-21T05:19:24,ACC00004926,Transfer,840.33,-322481.39,EUR,Walmart
TXN0000001573,2024-10-10T23:13:01,ACC00004295,Payment,1788.72,-324270.11,JPY,Target
TXN0000001574,2024-08-02T14:29:14,ACC00000398,Transfer,1803.38,-322466.73,GBP,Walmart
TXN0000001575,2024-12-16T13:37:47,ACC00002471,ATM,916.22,-323382.95,USD,Target
TXN0000001576,2024-03-18T02:12:07,ACC00008927,Transfer,1503.01,-321879.94,JPY,Amazon
TXN0000001577,2024-08-12T23:12:39,ACC00000969,Payment,1294.91,-323174.85,USD,Online Store
TXN0000001578,2024-04-05T04:33:12,ACC00001666,Debit,1150.55,-324325.4,USD,Shell
TXN0000001579,2024-11-29T08:21:22,ACC00000373,Transfer,1667.34,-322658.06,USD,Amazon
TXN0000001580,2024-01-16T22:51:18,ACC00008823,Debit,1915.8,-324573.86,USD,Amazon
TXN0000001581,2024-09-25T21:10:35,ACC00005653,Transfer,1599.66,-322974.2,EUR,Shell
TXN0000001582,2024-07-10T20:52:42,ACC00002406,Payment,282.11,-323256.31,USD,Online Store
TXN0000001583,2024-06-25T12:25:38,ACC00005449,Credit,1574.38,-321681.93,EUR,Restaurant
TXN0000001584,2024-04-26T09:13:25,ACC00007162,ATM,1883.57,-323565.5,USD,Online Store
TXN0000001585,2024-04-01T17:56:43,ACC00004420,Credit,218.75,-323346.75,GBP,Restaurant
TXN0000001586,2024-07-13T08:38:21,ACC00002553,Transfer,412.07,-322934.68,EUR,Grocery
TXN0000001587,2024-07-21T04:43:36,ACC00009995,Transfer,282.21,-322652.47,USD,Shell
TXN0000001588,2024-11-14T22:19:22,ACC00005851,Credit,1434.37,-321218.1,GBP,Shell
TXN0000001589,2024-02-06T07:29:57,ACC00003669,Debit,32.31,-321250.41,GBP,Walmart
TXN0000001590,2024-08-20T05:24:10,ACC00000512,Payment,1451.0,-322701.41,EUR,Online Store
TXN0000001591,2024-12-23T21:32:36,ACC00002766,Transfer,533.45,-322167.96,EUR,Online Store
TXN0000001592,2024-04-09T15:17:03,ACC00000684,Payment,61.17,-322229.13,USD,Starbucks
TXN0000001593,2024-12-16T14:58:23,ACC00001996,ATM,1922.61,-324151.74,EUR,Online Store
TXN0000001594,2024-04-21T19:11:12,ACC00005129,Payment,673.1,-324824.84,JPY,Online Store
TXN0000001595,2024-07-28T00:21:44,ACC00009617,Transfer,438.94,-324385.9,GBP,Shell
TXN0000001596,2024-05-11T14:42:52,ACC00003810,Credit,1913.87,-322472.03,GBP,Amazon
TXN0000001597,2024-02-19T05:42:28,ACC00009866,Transfer,1568.13,-320903.9,EUR,Amazon
TXN0000001598,2024-05-11T18:39:15,ACC00003147,Debit,1404.45,-322308.35,EUR,Grocery
TXN0000001599,2024-04-08T10:06:44,ACC00003277,Credit,1236.89,-321071.46,USD,Starbucks
TXN0000001600,2024-10-01T19:32:15,ACC00006426,ATM,1174.02,-322245.48,GBP,Grocery
TXN0000001601,2024-11-23T04:55:58,ACC00008579,ATM,698.67,-322944.15,EUR,Target
TXN0000001602,2024-12-22T23:32:42,ACC00009282,Transfer,1706.61,-321237.54,USD,Amazon
TXN0000001603,2024-01-21T19:50:20,ACC00005135,Credit,972.04,-320265.5,GBP,Target
TXN0000001604,2024-07-14T20:06:27,ACC00003191,Credit,1358.46,-318907.04,JPY,Restaurant
TXN0000001605,2024-08-09T08:10:13,ACC00004707,ATM,323.43,-319230.47,JPY,Target
TXN0000001606,2024-11-13T19:44:14,ACC00009168,Transfer,1303.43,-317927.04,EUR,Amazon
TXN0000001607,2024-09-23T01:23:40,ACC00004937,Payment,1474.9,-319401.94,JPY,Starbucks
TXN0000001608,2024-04-19T01:35:16,ACC00006851,Transfer,1493.99,-317907.95,JPY,Restaurant
TXN0000001609,2024-09-03T17:44:52,ACC00001980,Transfer,1652.03,-316255.92,JPY,Online Store
TXN0000001610,2024-06-15T13:48:15,ACC00000849,Debit,1858.04,-318113.96,USD,Online Store
TXN0000001611,2024-10-30T17:36:54,ACC00004277,Payment,1655.0,-319768.96,EUR,Walmart
TXN0000001612,2024-06-05T10:50:34,ACC00007085,Transfer,755.57,-319013.39,JPY,Starbucks
TXN0000001613,2024-07-11T17:53:32,ACC00002804,ATM,91.77,-319105.16,EUR,Online Store
TXN0000001614,2024-02-12T16:07:11,ACC00004053,Transfer,1534.4,-317570.76,JPY,Starbucks
TXN0000001615,2024-10-10T18:58:55,ACC00000522,Credit,56.01,-317514.75,EUR,Online Store
TXN0000001616,2024-11-03T21:01:37,ACC00009442,Transfer,1744.27,-315770.48,JPY,Online Store
TXN0000001617,2024-01-13T08:13:27,ACC00005659,ATM,235.0,-316005.48,USD,Target
TXN0000001618,2024-06-13T05:44:13,ACC00009720,Payment,1105.5,-317110.98,EUR,Grocery
TXN0000001619,2024-10-03T11:29:37,ACC00005734,Credit,539.87,-316571.11,USD,Walmart
TXN0000001620,2024-05-24T04:59:01,ACC00005742,Debit,1467.75,-318038.86,EUR,Restaurant
TXN0000001621,2024-11-18T20:52:50,ACC00008093,Debit,356.44,-318395.3,GBP,Grocery
TXN0000001622,2024-12-26T12:33:25,ACC00003390,ATM,1080.73,-319476.03,USD,Grocery
TXN0000001623,2024-07-05T11:54:55,ACC00004403,Credit,262.44,-319213.59,EUR,Target
TXN0000001624,2024-08-27T10:00:51,ACC00003236,Credit,1218.82,-317994.77,GBP,Online Store
TXN0000001625,2024-09-09T09:56:04,ACC00001284,Debit,976.08,-318970.85,EUR,Online Store
TXN0000001626,2024-01-27T01:13:38,ACC00001960,ATM,1238.68,-320209.53,USD,Restaurant
TXN0000001627,2024-05-20T12:19:31,ACC00003379,Payment,183.12,-320392.65,JPY,Starbucks
TXN0000001628,2024-01-31T06:51:50,ACC00000108,Credit,1269.69,-319122.96,GBP,Target
TXN0000001629,2024-11-03T02:11:04,ACC00009378,ATM,461.54,-319584.5,USD,Walmart
TXN0000001630,2024-01-28T10:20:01,ACC00002587,Transfer,885.65,-318698.85,USD,Walmart
TXN0000001631,2024-07-13T11:05:40,ACC00001130,Payment,1862.19,-320561.04,USD,Online Store
TXN0000001632,2024-07-09T01:33:58,ACC00009974,Payment,514.87,-321075.91,USD,Online Store
TXN0000001633,2024-11-28T18:09:31,ACC00004350,Debit,1745.69,-322821.6,JPY,Restaurant
TXN0000001634,2024-02-16T09:49:32,ACC00004666,Debit,1309.2,-324130.8,EUR,Shell
TXN0000001635,2024-05-02T04:24:11,ACC00006242,Debit,321.95,-324452.75,EUR,Online Store
TXN0000001636,2024-04-09T08:32:54,ACC00007243,ATM,475.59,-324928.34,JPY,Restaurant
TXN0000001637,2024-10-10T00:34:03,ACC00001685,Debit,1636.47,-326564.81,GBP,Restaurant
TXN0000001638,2024-05-21T22:53:16,ACC00005680,Payment,951.75,-327516.56,USD,Shell
TXN0000001639,2024-11-15T01:14:01,ACC00005753,Payment,1683.8,-329200.36,JPY,Grocery
TXN0000001640,2024-02-26T02:46:31,ACC00004994,Payment,19.34,-329219.7,GBP,Walmart
TXN0000001641,2024-03-10T17:09:15,ACC00002536,Transfer,176.15,-329043.55,USD,Starbucks
TXN0000001642,2024-02-08T00:39:27,ACC00005345,Transfer,1832.86,-327210.69,EUR,Online Store
TXN0000001643,2024-07-18T00:09:56,ACC00006824,Credit,968.45,-326242.24,GBP,Amazon
TXN0000001644,2024-08-27T16:44:40,ACC00003160,Transfer,1643.29,-324598.95,GBP,Online Store
TXN0000001645,2024-05-25T23:21:32,ACC00007554,Credit,1056.29,-323542.66,JPY,Amazon
TXN0000001646,2024-12-30T08:07:49,ACC00002991,Payment,784.06,-324326.72,JPY,Restaurant
TXN0000001647,2024-07-12T12:43:37,ACC00007657,ATM,974.22,-325300.94,GBP,Online Store
TXN0000001648,2024-10-18T09:41:28,ACC00004402,Debit,666.13,-325967.07,GBP,Starbucks
TXN0000001649,2024-04-19T07:15:24,ACC00006221,Credit,1675.11,-324291.96,JPY,Restaurant
TXN0000001650,2024-09-18T01:54:58,ACC00003011,Debit,324.84,-324616.8,USD,Starbucks
TXN0000001651,2024-12-26T12:51:26,ACC00004676,Debit,1422.26,-326039.06,JPY,Restaurant
TXN0000001652,2024-07-24T08:26:06,ACC00006569,Transfer,467.18,-325571.88,USD,Walmart
TXN0000001653,2024-11-11T14:39:23,ACC00006367,Payment,1216.26,-326788.14,GBP,Starbucks
TXN0000001654,2024-11-25T07:47:12,ACC00007304,Transfer,129.06,-326659.08,EUR,Shell
TXN0000001655,2024-01-11T15:45:20,ACC00009463,ATM,1885.74,-328544.82,JPY,Grocery
TXN0000001656,2024-05-12T02:57:35,ACC00009014,Debit,1846.14,-330390.96,GBP,Target
TXN0000001657,2024-10-13T18:33:52,ACC00000600,Payment,624.44,-331015.4,JPY,Restaurant
TXN0000001658,2024-05-24T11:51:19,ACC00005622,Credit,1276.63,-329738.77,USD,Grocery
TXN0000001659,2024-10-06T05:46:53,ACC00006405,ATM,1092.26,-330831.03,GBP,Amazon
TXN0000001660,2024-07-08T03:14:25,ACC00007532,Debit,679.95,-331510.98,EUR,Starbucks
TXN0000001661,2024-10-20T20:48:13,ACC00004397,Transfer,1243.63,-330267.35,USD,Shell
TXN0000001662,2024-05-21T22:09:00,ACC00004794,Transfer,338.46,-329928.89,GBP,Amazon
TXN0000001663,2024-10-05T07:34:42,ACC00002684,Credit,549.37,-329379.52,JPY,Online Store
TXN0000001664,2024-09-21T15:17:25,ACC00000060,Payment,1180.73,-330560.25,JPY,Walmart
TXN0000001665,2024-01-17T07:31:57,ACC00008026,Debit,515.76,-331076.01,GBP,Grocery
TXN0000001666,2024-11-15T02:04:50,ACC00003046,Debit,413.06,-331489.07,JPY,Walmart
TXN0000001667,2024-12-28T03:55:25,ACC00006068,Transfer,1299.62,-330189.45,GBP,Online Store
TXN0000001668,2024-06-23T13:53:27,ACC00002755,Debit,1637.54,-331826.99,GBP,Amazon
TXN0000001669,2024-03-17T09:27:30,ACC00002867,Transfer,1863.54,-329963.45,EUR,Target
TXN0000001670,2024-04-03T03:45:30,ACC00009354,Payment,304.95,-330268.4,JPY,Restaurant
TXN0000001671,2024-04-17T02:52:16,ACC00002410,Credit,603.14,-329665.26,JPY,Walmart
TXN0000001672,2024-07-08T06:15:55,ACC00000583,Debit,1335.35,-331000.61,JPY,Amazon
TXN0000001673,2024-07-19T19:47:03,ACC00004523,Payment,901.47,-331902.08,JPY,Restaurant
TXN0000001674,2024-09-11T21:39:53,ACC00000629,Debit,383.63,-332285.71,JPY,Walmart
TXN0000001675,2024-03-24T18:30:07,ACC00006535,Payment,509.47,-332795.18,GBP,Target
TXN0000001676,2024-11-21T19:22:44,ACC00002266,ATM,1570.59,-334365.77,GBP,Restaurant
TXN0000001677,2024-05-16T21:05:47,ACC00003379,Debit,1104.66,-335470.43,USD,Starbucks
TXN0000001678,2024-12-06T01:41:54,ACC00005550,Payment,145.52,-335615.95,USD,Amazon
TXN0000001679,2024-02-08T05:03:19,ACC00003913,Debit,18.98,-335634.93,EUR,Restaurant
TXN0000001680,2024-12-11T03:35:09,ACC00004364,ATM,741.28,-336376.21,GBP,Restaurant
TXN0000001681,2024-02-09T03:26:37,ACC00001354,Debit,1783.6,-338159.81,JPY,Amazon
TXN0000001682,2024-03-23T19:14:47,ACC00003902,Debit,756.89,-338916.7,JPY,Online Store
TXN0000001683,2024-09-04T13:00:55,ACC00001619,Payment,950.91,-339867.61,JPY,Grocery
TXN0000001684,2024-07-25T23:53:54,ACC00004757,Transfer,861.41,-339006.2,EUR,Online Store
TXN0000001685,2024-02-28T00:41:23,ACC00008988,Payment,1622.24,-340628.44,EUR,Target
TXN0000001686,2024-10-16T11:45:27,ACC00005637,Transfer,340.39,-340288.05,JPY,Restaurant
TXN0000001687,2024-11-01T18:04:18,ACC00002828,Payment,1900.48,-342188.53,EUR,Starbucks
TXN0000001688,2024-10-04T01:04:44,ACC00008706,Debit,1761.65,-343950.18,EUR,Grocery
TXN0000001689,2024-05-18T20:27:36,ACC00008973,Debit,1569.62,-345519.8,USD,Shell
TXN0000001690,2024-12-26T14:10:09,ACC00004597,ATM,253.96,-345773.76,EUR,Shell
TXN0000001691,2024-11-22T12:52:30,ACC00004784,Credit,1615.79,-344157.97,USD,Walmart
TXN0000001692,2024-08-23T04:36:20,ACC00001860,ATM,610.68,-344768.65,USD,Grocery
TXN0000001693,2024-02-29T18:53:22,ACC00006996,Transfer,442.12,-344326.53,JPY,Amazon
TXN0000001694,2024-11-21T17:28:10,ACC00001910,Credit,719.49,-343607.04,USD,Online Store
TXN0000001695,2024-12-16T00:41:57,ACC00001399,Payment,282.51,-343889.55,GBP,Target
TXN0000001696,2024-06-12T13:45:03,ACC00001854,Credit,258.27,-343631.28,GBP,Grocery
TXN0000001697,2024-09-18T07:59:02,ACC00007757,ATM,1001.53,-344632.81,GBP,Restaurant
TXN0000001698,2024-04-26T17:17:21,ACC00003223,ATM,884.61,-345517.42,JPY,Restaurant
TXN0000001699,2024-09-08T11:49:33,ACC00009098,Transfer,624.93,-344892.49,EUR,Walmart
TXN0000001700,2024-06-17T14:32:17,ACC00000569,ATM,1436.3,-346328.79,USD,Online Store
TXN0000001701,2024-03-09T22:58:10,ACC00000728,ATM,838.21,-347167.0,USD,Target
TXN0000001702,2024-07-23T23:13:31,ACC00004076,Payment,1024.46,-348191.46,USD,Target
TXN0000001703,2024-08-10T00:18:17,ACC00007940,Debit,1287.81,-349479.27,JPY,Shell
TXN0000001704,2024-03-08T12:41:27,ACC00007601,Credit,1802.94,-347676.33,GBP,Shell
TXN0000001705,2024-01-04T04:38:27,ACC00009466,ATM,764.23,-348440.56,JPY,Target
TXN0000001706,2024-03-16T11:10:27,ACC00008175,Debit,573.98,-349014.54,EUR,Grocery
TXN0000001707,2024-09-15T10:40:37,ACC00009123,ATM,1929.2,-350943.74,GBP,Walmart
TXN0000001708,2024-07-17T11:03:07,ACC00004959,Payment,593.45,-351537.19,JPY,Starbucks
TXN0000001709,2024-03-23T18:43:21,ACC00000537,Payment,380.65,-351917.84,EUR,Grocery
TXN0000001710,2024-12-08T01:50:54,ACC00004288,ATM,1444.39,-353362.23,JPY,Target
TXN0000001711,2024-09-25T14:14:38,ACC00006579,Debit,1773.58,-355135.81,GBP,Grocery
TXN0000001712,2024-09-30T22:57:54,ACC00004454,Payment,539.86,-355675.67,GBP,Starbucks
TXN0000001713,2024-09-29T11:47:38,ACC00001668,ATM,703.67,-356379.34,JPY,Starbucks
TXN0000001714,2024-01-31T16:13:41,ACC00006479,Transfer,595.07,-355784.27,GBP,Amazon
TXN0000001715,2024-06-10T04:09:07,ACC00007514,Credit,1216.63,-354567.64,GBP,Online Store
TXN0000001716,2024-03-08T21:13:46,ACC00007445,ATM,541.8,-355109.44,USD,Walmart
TXN0000001717,2024-07-12T15:14:21,ACC00008673,Payment,122.44,-355231.88,JPY,Walmart
TXN0000001718,2024-06-08T20:05:17,ACC00002804,Payment,377.06,-355608.94,GBP,Starbucks
TXN0000001719,2024-08-08T13:10:19,ACC00002259,Transfer,1636.08,-353972.86,GBP,Amazon
TXN0000001720,2024-09-27T10:48:49,ACC00002940,Payment,1970.09,-355942.95,USD,Restaurant
TXN0000001721,2024-08-25T11:47:05,ACC00009042,ATM,231.36,-356174.31,EUR,Shell
TXN0000001722,2024-08-12T07:57:42,ACC00001748,Transfer,1321.08,-354853.23,USD,Starbucks
TXN0000001723,2024-06-22T19:42:54,ACC00000802,Credit,1535.31,-353317.92,JPY,Restaurant
TXN0000001724,2024-07-21T01:14:13,ACC00003711,Transfer,1785.69,-351532.23,JPY,Walmart
TXN0000001725,2024-09-20T14:45:02,ACC00002985,Payment,395.59,-351927.82,GBP,Shell
TXN0000001726,2024-01-29T06:37:47,ACC00000226,ATM,1693.29,-353621.11,USD,Grocery
TXN0000001727,2024-07-18T11:16:51,ACC00003109,Payment,1526.43,-355147.54,EUR,Walmart
TXN0000001728,2024-03-14T06:29:15,ACC00006239,Transfer,1733.92,-353413.62,USD,Amazon
TXN0000001729,2024-05-01T09:44:06,ACC00005367,Transfer,412.92,-353000.7,GBP,Starbucks
TXN0000001730,2024-03-22T06:14:33,ACC00003497,Credit,584.32,-352416.38,JPY,Online Store
TXN0000001731,2024-11-02T06:50:45,ACC00002608,Transfer,964.3,-351452.08,EUR,Shell
TXN0000001732,2024-07-17T06:13:49,ACC00008651,Debit,38.63,-351490.71,JPY,Shell
TXN0000001733,2024-10-05T05:26:46,ACC00000700,Payment,352.03,-351842.74,EUR,Shell
TXN0000001734,2024-12-17T14:23:59,ACC00005881,Transfer,1920.07,-349922.67,USD,Amazon
TXN0000001735,2024-08-17T13:16:26,ACC00002196,ATM,346.74,-350269.41,JPY,Restaurant
TXN0000001736,2024-03-26T23:04:43,ACC00001187,Debit,1424.22,-351693.63,USD,Restaurant
TXN0000001737,2024-10-11T23:23:21,ACC00008039,Transfer,65.32,-351628.31,JPY,Walmart
TXN0000001738,2024-11-28T13:42:29,ACC00003243,ATM,651.39,-352279.7,GBP,Amazon
TXN0000001739,2024-06-06T03:36:54,ACC00009829,Debit,1272.89,-353552.59,GBP,Online Store
TXN0000001740,2024-07-08T23:56:42,ACC00003186,Debit,377.9,-353930.49,USD,Online Store
TXN0000001741,2024-01-02T11:58:27,ACC00009051,ATM,1866.91,-355797.4,JPY,Online Store
TXN0000001742,2024-01-29T06:51:14,ACC00009357,Payment,1166.81,-356964.21,GBP,Shell
TXN0000001743,2024-09-26T08:23:15,ACC00007108,ATM,694.65,-357658.86,EUR,Online Store
TXN0000001744,2024-10-18T11:48:17,ACC00002941,Credit,1995.51,-355663.35,USD,Shell
TXN0000001745,2024-10-05T17:20:16,ACC00006094,Credit,1258.5,-354404.85,EUR,Amazon
TXN0000001746,2024-09-29T08:43:44,ACC00007542,ATM,161.76,-354566.61,USD,Walmart
TXN0000001747,2024-05-09T07:54:24,ACC00009430,Debit,1050.85,-355617.46,EUR,Shell
TXN0000001748,2024-01-21T18:02:12,ACC00004600,Transfer,1587.92,-354029.54,JPY,Shell
TXN0000001749,2024-05-11T19:31:13,ACC00009605,Payment,1887.52,-355917.06,JPY,Walmart
TXN0000001750,2024-12-28T16:36:24,ACC00009299,Credit,1358.48,-354558.58,USD,Target
TXN0000001751,2024-12-29T18:15:02,ACC00005084,Payment,1993.45,-356552.03,GBP,Restaurant
TXN0000001752,2024-06-14T19:19:10,ACC00007964,Transfer,1028.27,-355523.76,GBP,Walmart
TXN0000001753,2024-08-03T18:09:12,ACC00002210,Payment,847.93,-356371.69,JPY,Target
TXN0000001754,2024-01-19T14:12:49,ACC00000277,Credit,1491.3,-354880.39,EUR,Grocery
TXN0000001755,2024-01-24T14:57:03,ACC00004615,Payment,876.08,-355756.47,EUR,Walmart
TXN0000001756,2024-12-12T11:28:21,ACC00000313,ATM,1395.45,-357151.92,USD,Shell
TXN0000001757,2024-08-27T09:28:25,ACC00006508,ATM,778.58,-357930.5,GBP,Starbucks
TXN0000001758,2024-08-27T23:32:20,ACC00004401,Credit,194.68,-357735.82,EUR,Grocery
TXN0000001759,2024-10-14T20:36:22,ACC00008632,Payment,1958.6,-359694.42,GBP,Walmart
TXN0000001760,2024-05-16T14:53:32,ACC00001177,Transfer,1946.61,-357747.81,EUR,Walmart
TXN0000001761,2024-12-17T21:29:49,ACC00001064,Payment,842.67,-358590.48,JPY,Target
TXN0000001762,2024-10-30T19:37:58,ACC00002734,Transfer,1393.89,-357196.59,EUR,Online Store
TXN0000001763,2024-07-09T11:03:24,ACC00008086,ATM,383.81,-357580.4,GBP,Starbucks
TXN0000001764,2024-10-22T12:45:47,ACC00007884,Credit,922.58,-356657.82,EUR,Walmart
TXN0000001765,2024-08-12T23:57:30,ACC00005442,Credit,820.17,-355837.65,USD,Online Store
TXN0000001766,2024-01-21T13:31:12,ACC00004362,Transfer,1573.05,-354264.6,USD,Target
TXN0000001767,2024-12-02T11:45:18,ACC00005873,ATM,1042.71,-355307.31,USD,Starbucks
TXN0000001768,2024-01-01T07:52:49,ACC00002207,Credit,1227.02,-354080.29,JPY,Restaurant
TXN0000001769,2024-11-21T05:02:52,ACC00001945,Debit,321.6,-354401.89,EUR,Online Store
TXN0000001770,2024-12-28T05:55:37,ACC00006709,Debit,1338.8,-355740.69,USD,Restaurant
TXN0000001771,2024-07-05T20:15:22,ACC00001037,Transfer,1572.0,-354168.69,GBP,Restaurant
TXN0000001772,2024-11-01T08:58:56,ACC00003813,Credit,837.71,-353330.98,GBP,Target
TXN0000001773,2024-10-15T11:46:35,ACC00006157,Payment,1936.97,-355267.95,USD,Grocery
TXN0000001774,2024-04-03T08:30:27,ACC00000252,Debit,1377.05,-356645.0,JPY,Amazon
TXN0000001775,2024-12-01T16:19:08,ACC00002554,Transfer,1250.19,-355394.81,USD,Restaurant
TXN0000001776,2024-08-21T02:09:32,ACC00000440,Payment,1469.34,-356864.15,EUR,Amazon
TXN0000001777,2024-11-22T20:56:06,ACC00006898,ATM,1092.71,-357956.86,GBP,Target
TXN0000001778,2024-09-01T14:04:56,ACC00005896,ATM,1075.44,-359032.3,JPY,Restaurant
TXN0000001779,2024-02-18T00:04:38,ACC00002674,Payment,594.04,-359626.34,USD,Target
TXN0000001780,2024-09-20T23:21:21,ACC00005831,Transfer,1202.06,-358424.28,USD,Online Store
TXN0000001781,2024-04-13T11:36:51,ACC00006497,Credit,824.93,-357599.35,EUR,Walmart
TXN0000001782,2024-09-25T14:04:59,ACC00008981,Credit,903.85,-356695.5,GBP,Target
TXN0000001783,2024-11-03T21:51:21,ACC00003866,Debit,1861.06,-358556.56,GBP,Shell
TXN0000001784,2024-04-14T01:58:47,ACC00006590,Credit,754.2,-357802.36,JPY,Target
TXN0000001785,2024-02-26T16:43:55,ACC00005231,Debit,319.2,-358121.56,USD,Online Store
TXN0000001786,2024-09-07T14:57:50,ACC00007021,Debit,1497.19,-359618.75,JPY,Starbucks
TXN0000001787,2024-01-23T12:02:18,ACC00007050,Payment,354.64,-359973.39,GBP,Restaurant
TXN0000001788,2024-02-05T10:47:22,ACC00001205,ATM,1553.51,-361526.9,GBP,Target
TXN0000001789,2024-02-10T01:36:58,ACC00002829,ATM,1303.97,-362830.87,GBP,Shell
TXN0000001790,2024-04-21T08:37:36,ACC00008432,Payment,1912.79,-364743.66,EUR,Restaurant
TXN0000001791,2024-06-19T05:09:35,ACC00004015,Credit,793.47,-363950.19,JPY,Shell
TXN0000001792,2024-06-10T14:39:34,ACC00006264,Credit,1654.09,-362296.1,USD,Starbucks
TXN0000001793,2024-08-13T12:53:14,ACC00006227,ATM,861.36,-363157.46,JPY,Walmart
TXN0000001794,2024-06-21T21:32:31,ACC00001228,Credit,1184.72,-361972.74,EUR,Walmart
TXN0000001795,2024-02-20T17:09:30,ACC00002446,Transfer,653.09,-361319.65,EUR,Restaurant
TXN0000001796,2024-02-21T09:09:45,ACC00009202,Credit,743.09,-360576.56,JPY,Restaurant
TXN0000001797,2024-09-29T02:50:40,ACC00008426,Debit,116.86,-360693.42,EUR,Online Store
TXN0000001798,2024-02-17T20:43:11,ACC00005474,ATM,1198.6,-361892.02,USD,Online Store
TXN0000001799,2024-04-25T05:50:22,ACC00009236,Debit,1665.97,-363557.99,USD,Amazon
TXN0000001800,2024-04-29T10:56:55,ACC00002558,Payment,701.95,-364259.94,EUR,Online Store
TXN0000001801,2024-08-08T20:58:20,ACC00008826,Credit,208.5,-364051.44,GBP,Starbucks
TXN0000001802,2024-01-02T10:25:01,ACC00008565,Debit,1195.67,-365247.11,JPY,Starbucks
TXN0000001803,2024-04-02T03:28:46,ACC00003018,Payment,1964.61,-367211.72,USD,Starbucks
TXN0000001804,2024-08-14T17:52:31,ACC00004007,Debit,174.11,-367385.83,GBP,Amazon
TXN0000001805,2024-04-09T09:36:54,ACC00005528,Debit,1236.47,-368622.3,EUR,Restaurant
TXN0000001806,2024-11-11T09:08:25,ACC00001216,Payment,1847.48,-370469.78,GBP,Starbucks
TXN0000001807,2024-04-16T13:35:39,ACC00008816,Credit,818.93,-369650.85,GBP,Online Store
TXN0000001808,2024-04-23T10:17:14,ACC00006386,Payment,1398.06,-371048.91,GBP,Target
TXN0000001809,2024-02-21T13:22:35,ACC00005410,Credit,824.99,-370223.92,USD,Grocery
TXN0000001810,2024-03-28T00:02:49,ACC00005004,ATM,66.09,-370290.01,GBP,Shell
TXN0000001811,2024-06-15T20:12:02,ACC00006209,Credit,468.67,-369821.34,EUR,Restaurant
TXN0000001812,2024-06-27T22:19:53,ACC00008415,ATM,1047.25,-370868.59,USD,Starbucks
TXN0000001813,2024-03-14T13:04:39,ACC00009816,ATM,1088.94,-371957.53,EUR,Walmart
TXN0000001814,2024-01-09T09:31:39,ACC00003600,Transfer,914.72,-371042.81,JPY,Walmart
TXN0000001815,2024-01-31T08:26:09,ACC00003552,Payment,1502.64,-372545.45,GBP,Restaurant
TXN0000001816,2024-02-25T03:44:41,ACC00000383,Debit,147.73,-372693.18,JPY,Restaurant
TXN0000001817,2024-05-03T17:41:36,ACC00001455,ATM,1826.76,-374519.94,USD,Shell
TXN0000001818,2024-09-11T23:14:21,ACC00000412,Debit,1430.4,-375950.34,GBP,Amazon
TXN0000001819,2024-06-25T14:29:02,ACC00007198,ATM,281.33,-376231.67,JPY,Shell
TXN0000001820,2024-03-07T13:16:20,ACC00007430,Transfer,1511.5,-374720.17,USD,Restaurant
TXN0000001821,2024-11-04T12:26:14,ACC00002886,Credit,679.4,-374040.77,GBP,Amazon
TXN0000001822,2024-06-01T21:46:15,ACC00009646,Payment,328.3,-374369.07,USD,Starbucks
TXN0000001823,2024-07-19T01:54:52,ACC00004617,ATM,1804.76,-376173.83,GBP,Online Store
TXN0000001824,2024-05-31T20:10:47,ACC00009751,Transfer,195.87,-375977.96,USD,Walmart
TXN0000001825,2024-08-19T01:15:19,ACC00001846,Payment,549.24,-376527.2,JPY,Shell
TXN0000001826,2024-07-25T17:29:30,ACC00007210,Credit,1449.56,-375077.64,GBP,Grocery
TXN0000001827,2024-04-10T23:04:25,ACC00003956,ATM,702.42,-375780.06,EUR,Restaurant
TXN0000001828,2024-10-10T07:42:16,ACC00009419,Debit,382.74,-376162.8,GBP,Amazon
TXN0000001829,2024-12-23T20:30:01,ACC00003364,Debit,306.33,-376469.13,USD,Online Store
TXN0000001830,2024-02-18T03:21:21,ACC00007034,ATM,711.4,-377180.53,USD,Restaurant
TXN0000001831,2024-07-19T11:40:10,ACC00003730,Transfer,1488.0,-375692.53,GBP,Grocery
TXN0000001832,2024-10-03T12:42:53,ACC00001423,ATM,857.36,-376549.89,GBP,Grocery
TXN0000001833,2024-06-04T17:04:13,ACC00000412,Debit,1828.32,-378378.21,EUR,Walmart
TXN0000001834,2024-12-06T08:35:20,ACC00001327,ATM,1172.06,-379550.27,GBP,Amazon
TXN0000001835,2024-03-30T18:34:25,ACC00005556,Debit,733.68,-380283.95,USD,Amazon
TXN0000001836,2024-02-03T02:03:42,ACC00003065,Debit,1277.53,-381561.48,GBP,Target
TXN0000001837,2024-10-15T23:05:25,ACC00005419,Transfer,518.64,-381042.84,EUR,Shell
TXN0000001838,2024-05-10T08:44:33,ACC00003313,Credit,632.45,-380410.39,JPY,Grocery
TXN0000001839,2024-07-13T15:02:20,ACC00004168,Credit,1397.2,-379013.19,JPY,Amazon
TXN0000001840,2024-12-14T01:46:27,ACC00006317,Debit,1428.25,-380441.44,EUR,Online Store
TXN0000001841,2024-09-02T21:07:30,ACC00001533,Transfer,1470.8,-378970.64,USD,Amazon
TXN0000001842,2024-08-13T09:19:59,ACC00007890,ATM,1617.55,-380588.19,USD,Walmart
TXN0000001843,2024-12-18T00:26:28,ACC00002464,Debit,327.1,-380915.29,EUR,Shell
TXN0000001844,2024-05-21T00:05:24,ACC00006632,Debit,1865.95,-382781.24,EUR,Walmart
TXN0000001845,2024-09-03T12:24:21,ACC00005424,Transfer,228.96,-382552.28,EUR,Restaurant
TXN0000001846,2024-09-24T08:13:25,ACC00000499,ATM,347.16,-382899.44,EUR,Restaurant
TXN0000001847,2024-02-03T17:57:42,ACC00006892,Payment,778.53,-383677.97,GBP,Grocery
TXN0000001848,2024-10-12T01:30:17,ACC00008237,Credit,313.17,-383364.8,EUR,Starbucks
TXN0000001849,2024-02-16T14:24:40,ACC00001604,Credit,407.69,-382957.11,EUR,Walmart
TXN0000001850,2024-09-10T07:55:04,ACC00000955,Debit,1887.35,-384844.46,EUR,Restaurant
TXN0000001851,2024-04-21T08:04:26,ACC00009145,ATM,1307.9,-386152.36,EUR,Restaurant
TXN0000001852,2024-08-12T09:53:11,ACC00008251,Credit,1330.26,-384822.1,USD,Online Store
TXN0000001853,2024-05-15T04:34:11,ACC00004368,ATM,1225.64,-386047.74,GBP,Grocery
TXN0000001854,2024-11-20T02:16:51,ACC00001800,Transfer,1292.25,-384755.49,JPY,Target
TXN0000001855,2024-02-15T10:39:27,ACC00000857,ATM,1046.73,-385802.22,EUR,Amazon
TXN0000001856,2024-08-14T03:08:16,ACC00007625,Credit,837.55,-384964.67,JPY,Amazon
TXN0000001857,2024-02-05T21:24:01,ACC00004977,Credit,79.05,-384885.62,JPY,Target
TXN0000001858,2024-02-12T15:01:21,ACC00005304,ATM,674.27,-385559.89,USD,Target
TXN0000001859,2024-09-11T16:18:59,ACC00003823,Transfer,1931.18,-383628.71,EUR,Grocery
TXN0000001860,2024-03-01T15:31:21,ACC00007858,Debit,1378.23,-385006.94,EUR,Target
TXN0000001861,2024-12-08T14:19:10,ACC00009276,Credit,1980.75,-383026.19,EUR,Starbucks
TXN0000001862,2024-04-18T22:01:57,ACC00002237,ATM,1593.09,-384619.28,EUR,Online Store
TXN0000001863,2024-01-18T03:56:15,ACC00006440,Credit,1311.64,-383307.64,EUR,Walmart
TXN0000001864,2024-11-28T04:19:12,ACC00001239,Transfer,58.34,-383249.3,GBP,Walmart
TXN0000001865,2024-01-30T10:20:04,ACC00007342,Payment,673.29,-383922.59,EUR,Grocery
TXN0000001866,2024-02-05T17:25:15,ACC00004099,ATM,1894.44,-385817.03,GBP,Shell
TXN0000001867,2024-12-30T17:16:10,ACC00003703,Payment,825.59,-386642.62,JPY,Shell
TXN0000001868,2024-11-19T11:11:51,ACC00006208,Debit,741.21,-387383.83,GBP,Walmart
TXN0000001869,2024-05-04T01:34:13,ACC00007636,Credit,810.79,-386573.04,EUR,Walmart
TXN0000001870,2024-08-25T13:48:34,ACC00008293,Debit,1703.66,-388276.7,GBP,Shell
TXN0000001871,2024-11-05T05:49:13,ACC00001946,Credit,1724.26,-386552.44,EUR,Online Store
TXN0000001872,2024-11-28T03:24:37,ACC00001170,Payment,1172.01,-387724.45,JPY,Grocery
TXN0000001873,2024-01-16T23:26:20,ACC00004207,ATM,977.77,-388702.22,JPY,Grocery
TXN0000001874,2024-07-14T08:49:38,ACC00005606,Payment,1354.08,-390056.3,JPY,Target
TXN0000001875,2024-02-09T20:00:37,ACC00000848,Transfer,269.3,-389787.0,GBP,Target
TXN0000001876,2024-09-10T05:20:05,ACC00008817,Credit,1435.16,-388351.84,USD,Starbucks
TXN0000001877,2024-01-05T22:38:53,ACC00000092,Transfer,1760.26,-386591.58,JPY,Starbucks
TXN0000001878,2024-03-10T02:08:30,ACC00003641,Credit,620.3,-385971.28,JPY,Online Store
TXN0000001879,2024-01-08T18:06:55,ACC00000298,Transfer,740.95,-385230.33,EUR,Restaurant
TXN0000001880,2024-06-20T21:57:33,ACC00008632,Transfer,1936.79,-383293.54,GBP,Online Store
TXN0000001881,2024-10-22T12:14:52,ACC00006371,Transfer,813.78,-382479.76,GBP,Shell
TXN0000001882,2024-11-15T17:26:12,ACC00000668,Payment,1894.92,-384374.68,JPY,Starbucks
TXN0000001883,2024-09-04T09:48:23,ACC00003932,Debit,506.85,-384881.53,JPY,Starbucks
TXN0000001884,2024-05-26T14:04:41,ACC00006733,Transfer,1217.72,-383663.81,USD,Online Store
TXN0000001885,2024-05-18T19:37:29,ACC00004489,Transfer,1668.72,-381995.09,GBP,Target
TXN0000001886,2024-09-26T19:29:06,ACC00002437,Credit,25.3,-381969.79,USD,Restaurant
TXN0000001887,2024-11-14T10:58:08,ACC00003006,Debit,515.48,-382485.27,JPY,Shell
TXN0000001888,2024-11-27T13:50:50,ACC00004632,Debit,324.14,-382809.41,GBP,Restaurant
TXN0000001889,2024-04-02T02:34:19,ACC00008513,Debit,1679.59,-384489.0,USD,Shell
TXN0000001890,2024-10-23T05:01:17,ACC00006086,ATM,1448.89,-385937.89,USD,Online Store
TXN0000001891,2024-12-11T08:04:56,ACC00006546,Payment,1389.12,-387327.01,USD,Amazon
TXN0000001892,2024-03-13T02:09:52,ACC00005722,Credit,1202.14,-386124.87,USD,Walmart
TXN0000001893,2024-06-17T18:02:14,ACC00003192,Debit,337.89,-386462.76,EUR,Starbucks
TXN0000001894,2024-08-15T10:25:21,ACC00006761,Credit,1224.19,-385238.57,GBP,Walmart
TXN0000001895,2024-06-16T05:19:50,ACC00009752,Credit,1892.54,-383346.03,EUR,Online Store
TXN0000001896,2024-11-09T21:32:36,ACC00003675,Debit,1979.06,-385325.09,JPY,Target
TXN0000001897,2024-03-21T00:38:39,ACC00006961,Credit,1833.82,-383491.27,USD,Restaurant
TXN0000001898,2024-03-06T14:03:54,ACC00006191,ATM,1718.91,-385210.18,EUR,Amazon
TXN0000001899,2024-10-25T18:37:48,ACC00001212,Transfer,1763.42,-383446.76,EUR,Grocery
TXN0000001900,2024-11-25T19:55:48,ACC00004111,Debit,1285.26,-384732.02,EUR,Walmart
TXN0000001901,2024-11-30T04:29:02,ACC00009498,Credit,936.88,-383795.14,GBP,Shell
TXN0000001902,2024-09-26T11:28:21,ACC00004933,Credit,1373.23,-382421.91,EUR,Amazon
TXN0000001903,2024-06-20T17:33:23,ACC00006800,Credit,1906.16,-380515.75,JPY,Walmart
TXN0000001904,2024-02-15T17:38:44,ACC00004747,Credit,1931.77,-378583.98,USD,Shell
TXN0000001905,2024-11-17T10:26:44,ACC00006885,Credit,1779.07,-376804.91,JPY,Grocery
TXN0000001906,2024-10-10T21:21:27,ACC00004682,ATM,390.55,-377195.46,USD,Walmart
TXN0000001907,2024-06-27T00:37:26,ACC00008419,ATM,1041.77,-378237.23,EUR,Grocery
TXN0000001908,2024-07-04T18:47:32,ACC00001286,Transfer,160.91,-378076.32,USD,Restaurant
TXN0000001909,2024-05-12T17:18:09,ACC00004207,Debit,1806.79,-379883.11,GBP,Walmart
TXN0000001910,2024-09-20T03:18:32,ACC00007994,Debit,399.04,-380282.15,EUR,Starbucks
TXN0000001911,2024-06-12T14:55:51,ACC00002202,ATM,1178.99,-381461.14,EUR,Amazon
TXN0000001912,2024-09-25T08:20:06,ACC00004139,Payment,1360.75,-382821.89,EUR,Grocery
TXN0000001913,2024-11-09T22:32:37,ACC00004252,Payment,1622.26,-384444.15,EUR,Grocery
TXN0000001914,2024-02-06T02:34:41,ACC00007022,ATM,1413.02,-385857.17,EUR,Starbucks
TXN0000001915,2024-12-12T13:37:52,ACC00001932,Payment,1553.53,-387410.7,JPY,Amazon
TXN0000001916,2024-06-09T18:38:37,ACC00005856,Debit,1854.25,-389264.95,GBP,Walmart
TXN0000001917,2024-11-17T17:56:05,ACC00004529,ATM,555.88,-389820.83,USD,Walmart
TXN0000001918,2024-08-20T12:12:05,ACC00002383,Payment,1544.85,-391365.68,USD,Online Store
TXN0000001919,2024-01-25T05:07:35,ACC00006884,Debit,1000.36,-392366.04,USD,Online Store
TXN0000001920,2024-06-03T20:33:28,ACC00007999,Credit,646.98,-391719.06,USD,Grocery
TXN0000001921,2024-04-01T22:23:25,ACC00001220,Debit,1779.2,-393498.26,GBP,Walmart
TXN0000001922,2024-02-24T03:33:33,ACC00000846,Transfer,263.01,-393235.25,GBP,Restaurant
TXN0000001923,2024-05-13T13:04:46,ACC00006316,Transfer,1391.82,-391843.43,GBP,Amazon
TXN0000001924,2024-09-01T08:02:26,ACC00005436,Payment,1884.7,-393728.13,USD,Starbucks
TXN0000001925,2024-04-23T11:45:59,ACC00008280,Transfer,1757.01,-391971.12,USD,Target
TXN0000001926,2024-09-15T14:38:43,ACC00009502,Credit,1725.39,-390245.73,EUR,Online Store
TXN0000001927,2024-08-07T09:30:59,ACC00007884,Debit,1434.56,-391680.29,USD,Shell
TXN0000001928,2024-04-12T03:06:23,ACC00009920,Transfer,544.83,-391135.46,EUR,Amazon
TXN0000001929,2024-07-06T04:10:28,ACC00003083,ATM,1615.27,-392750.73,GBP,Restaurant
TXN0000001930,2024-04-11T04:20:15,ACC00000452,Payment,1315.28,-394066.01,JPY,Restaurant
TXN0000001931,2024-03-24T14:42:27,ACC00008613,ATM,874.09,-394940.1,USD,Starbucks
TXN0000001932,2024-11-09T10:51:55,ACC00008709,Transfer,1914.85,-393025.25,GBP,Restaurant
TXN0000001933,2024-11-25T04:30:35,ACC00005754,ATM,1304.44,-394329.69,USD,Target
TXN0000001934,2024-04-01T19:36:40,ACC00005316,Debit,799.35,-395129.04,JPY,Restaurant
TXN0000001935,2024-03-01T13:01:30,ACC00005928,Payment,259.51,-395388.55,EUR,Walmart
TXN0000001936,2024-06-20T21:21:10,ACC00002716,Transfer,1148.09,-394240.46,JPY,Starbucks
TXN0000001937,2024-01-10T09:46:49,ACC00007783,Debit,1086.51,-395326.97,USD,Online Store
TXN0000001938,2024-09-20T11:58:04,ACC00003731,Transfer,977.31,-394349.66,JPY,Restaurant
TXN0000001939,2024-12-30T08:12:28,ACC00009761,Transfer,1517.36,-392832.3,USD,Amazon
TXN0000001940,2024-07-16T02:04:53,ACC00000673,Debit,156.24,-392988.54,GBP,Target
TXN0000001941,2024-11-30T10:44:46,ACC00002141,Credit,1494.69,-391493.85,JPY,Amazon
TXN0000001942,2024-08-14T22:35:20,ACC00006223,Transfer,1396.1,-390097.75,EUR,Restaurant
TXN0000001943,2024-04-15T18:59:43,ACC00001443,Debit,723.3,-390821.05,USD,Shell
TXN0000001944,2024-01-13T13:09:02,ACC00006879,ATM,753.04,-391574.09,JPY,Restaurant
TXN0000001945,2024-02-12T12:15:03,ACC00000433,Debit,1957.41,-393531.5,JPY,Target
TXN0000001946,2024-08-15T18:39:12,ACC00005099,Credit,126.16,-393405.34,USD,Online Store
TXN0000001947,2024-04-16T01:50:47,ACC00002968,Transfer,741.4,-392663.94,USD,Amazon
TXN0000001948,2024-09-19T01:02:47,ACC00009967,Debit,1962.88,-394626.82,JPY,Target
TXN0000001949,2024-08-09T13:51:55,ACC00008939,Credit,1262.34,-393364.48,JPY,Online Store
TXN0000001950,2024-09-08T18:21:57,ACC00006699,ATM,976.8,-394341.28,JPY,Amazon
TXN0000001951,2024-11-04T07:46:18,ACC00006180,Payment,710.7,-395051.98,JPY,Walmart
TXN0000001952,2024-11-06T06:33:54,ACC00004043,ATM,291.77,-395343.75,USD,Amazon
TXN0000001953,2024-01-08T18:55:54,ACC00003989,ATM,1478.91,-396822.66,USD,Grocery
TXN0000001954,2024-11-27T09:37:00,ACC00005558,Payment,1041.74,-397864.4,GBP,Grocery
TXN0000001955,2024-06-27T14:20:28,ACC00005199,ATM,573.27,-398437.67,GBP,Grocery
TXN0000001956,2024-11-17T19:04:30,ACC00006236,ATM,1763.16,-400200.83,JPY,Amazon
TXN0000001957,2024-04-11T07:32:24,ACC00006017,Credit,1411.96,-398788.87,GBP,Amazon
TXN0000001958,2024-09-06T20:53:13,ACC00008403,Transfer,1837.3,-396951.57,USD,Online Store
TXN0000001959,2024-07-04T19:26:02,ACC00005200,Transfer,1777.42,-395174.15,GBP,Shell
TXN0000001960,2024-09-04T05:57:59,ACC00002242,Debit,910.28,-396084.43,USD,Target
TXN0000001961,2024-08-05T13:10:40,ACC00008954,Payment,170.27,-396254.7,USD,Walmart
TXN0000001962,2024-09-04T16:49:42,ACC00004464,Credit,863.29,-395391.41,GBP,Online Store
TXN0000001963,2024-01-16T23:09:22,ACC00000149,Transfer,382.12,-395009.29,JPY,Restaurant
TXN0000001964,2024-03-28T21:01:34,ACC00003665,ATM,11.45,-395020.74,EUR,Online Store
TXN0000001965,2024-10-04T12:09:50,ACC00005320,Payment,897.77,-395918.51,JPY,Starbucks
TXN0000001966,2024-05-21T03:46:47,ACC00004714,Credit,996.12,-394922.39,JPY,Grocery
TXN0000001967,2024-01-11T09:34:28,ACC00004051,Debit,1880.27,-396802.66,JPY,Shell
TXN0000001968,2024-04-27T20:16:17,ACC00009704,ATM,1703.86,-398506.52,JPY,Shell
TXN0000001969,2024-07-02T01:37:30,ACC00004101,Transfer,1020.88,-397485.64,GBP,Walmart
TXN0000001970,2024-03-03T21:28:14,ACC00002177,ATM,88.31,-397573.95,GBP,Online Store
TXN0000001971,2024-06-25T10:10:33,ACC00007248,ATM,959.21,-398533.16,JPY,Starbucks
TXN0000001972,2024-04-30T19:29:25,ACC00002272,Credit,1341.69,-397191.47,GBP,Restaurant
TXN0000001973,2024-09-27T05:26:06,ACC00001179,ATM,1841.72,-399033.19,JPY,Grocery
TXN0000001974,2024-07-27T23:24:45,ACC00001471,Debit,440.93,-399474.12,JPY,Amazon
TXN0000001975,2024-03-08T12:22:31,ACC00008442,Debit,1636.31,-401110.43,USD,Walmart
TXN0000001976,2024-04-28T02:24:53,ACC00004373,Credit,513.28,-400597.15,USD,Grocery
TXN0000001977,2024-05-28T17:19:43,ACC00008877,Payment,1478.78,-402075.93,USD,Target
TXN0000001978,2024-09-23T03:52:49,ACC00000003,ATM,1761.17,-403837.1,GBP,Shell
TXN0000001979,2024-08-02T14:16:20,ACC00004946,ATM,994.57,-404831.67,GBP,Walmart
TXN0000001980,2024-02-13T03:43:08,ACC00001258,Credit,527.34,-404304.33,GBP,Shell
TXN0000001981,2024-02-14T01:09:51,ACC00009422,Payment,827.24,-405131.57,GBP,Shell
TXN0000001982,2024-12-25T23:49:13,ACC00004220,Transfer,1307.37,-403824.2,USD,Target
TXN0000001983,2024-07-01T01:49:51,ACC00001048,Payment,1677.43,-405501.63,JPY,Target
TXN0000001984,2024-11-12T16:07:06,ACC00005004,ATM,910.72,-406412.35,GBP,Amazon
TXN0000001985,2024-04-16T18:31:44,ACC00003823,Payment,1919.96,-408332.31,JPY,Amazon
TXN0000001986,2024-02-23T22:28:45,ACC00002920,Transfer,979.03,-407353.28,JPY,Online Store
TXN0000001987,2024-11-19T22:25:00,ACC00002013,Debit,1141.07,-408494.35,EUR,Restaurant
TXN0000001988,2024-07-23T02:25:10,ACC00007570,Payment,349.53,-408843.88,GBP,Walmart
TXN0000001989,2024-06-29T18:34:36,ACC00007176,Debit,851.48,-409695.36,GBP,Starbucks
TXN0000001990,2024-11-18T06:12:48,ACC00003271,Debit,495.56,-410190.92,JPY,Starbucks
TXN0000001991,2024-07-30T19:46:24,ACC00002366,Transfer,1430.51,-408760.41,EUR,Online Store
TXN0000001992,2024-06-27T15:06:48,ACC00001760,Payment,1889.77,-410650.18,EUR,Grocery
TXN0000001993,2024-02-04T00:58:06,ACC00009388,Transfer,1293.75,-409356.43,JPY,Online Store
TXN0000001994,2024-01-25T16:13:18,ACC00001323,Debit,1124.07,-410480.5,EUR,Walmart
TXN0000001995,2024-03-30T03:05:25,ACC00000354,Credit,517.6,-409962.9,EUR,Target
TXN0000001996,2024-07-28T20:24:05,ACC00007624,Transfer,962.14,-409000.76,USD,Online Store
TXN0000001997,2024-05-08T01:47:11,ACC00006151,ATM,361.62,-409362.38,GBP,Grocery
TXN0000001998,2024-01-25T19:32:22,ACC00009651,ATM,1076.43,-410438.81,GBP,Grocery
TXN0000001999,2024-02-13T13:12:29,ACC00004576,Credit,278.65,-410160.16,GBP,Grocery
TXN0000002000,2024-02-12T04:54:24,ACC00009735,ATM,583.24,-410743.4,JPY,Restaurant
TXN0000002001,2024-12-05T16:16:17,ACC00008862,Debit,1623.32,-412366.72,GBP,Restaurant
TXN0000002002,2024-10-20T03:42:51,ACC00006564,ATM,650.61,-413017.33,EUR,Amazon
TXN0000002003,2024-06-16T19:40:26,ACC00005613,Transfer,1073.16,-411944.17,USD,Walmart
TXN0000002004,2024-08-22T06:32:02,ACC00001760,Debit,1513.76,-413457.93,GBP,Target
TXN0000002005,2024-03-04T14:22:27,ACC00006028,Transfer,1344.52,-412113.41,EUR,Restaurant
TXN0000002006,2024-03-03T02:51:55,ACC00004977,Transfer,934.8,-411178.61,JPY,Amazon
TXN0000002007,2024-04-22T18:47:51,ACC00002911,Debit,121.05,-411299.66,GBP,Amazon
TXN0000002008,2024-01-02T18:38:27,ACC00004085,Credit,1157.54,-410142.12,EUR,Online Store
TXN0000002009,2024-01-17T05:11:40,ACC00008599,ATM,508.38,-410650.5,JPY,Grocery
TXN0000002010,2024-03-20T14:31:02,ACC00008322,Credit,1155.58,-409494.92,JPY,Shell
TXN0000002011,2024-02-21T21:41:41,ACC00002977,Credit,57.28,-409437.64,GBP,Grocery
TXN0000002012,2024-04-16T11:12:18,ACC00009870,ATM,1742.3,-411179.94,JPY,Target
TXN0000002013,2024-12-12T07:05:45,ACC00006888,ATM,499.31,-411679.25,GBP,Grocery
TXN0000002014,2024-05-02T06:19:22,ACC00001092,Credit,1107.54,-410571.71,EUR,Restaurant
TXN0000002015,2024-05-22T17:15:20,ACC00002157,Payment,670.26,-411241.97,USD,Starbucks
TXN0000002016,2024-09-29T06:22:05,ACC00004287,Debit,1128.86,-412370.83,EUR,Starbucks
TXN0000002017,2024-12-22T12:34:46,ACC00004862,Debit,1826.37,-414197.2,GBP,Restaurant
TXN0000002018,2024-01-10T08:33:38,ACC00004601,Transfer,1449.7,-412747.5,EUR,Online Store
TXN0000002019,2024-03-16T16:48:10,ACC00005083,Debit,1999.87,-414747.37,EUR,Starbucks
TXN0000002020,2024-12-18T17:18:50,ACC00009860,Credit,447.29,-414300.08,EUR,Shell
TXN0000002021,2024-09-30T14:03:37,ACC00003700,Credit,1909.04,-412391.04,GBP,Target
TXN0000002022,2024-12-01T12:37:03,ACC00005638,Credit,1472.3,-410918.74,GBP,Grocery
TXN0000002023,2024-04-14T00:03:31,ACC00003908,Payment,1114.09,-412032.83,USD,Starbucks
TXN0000002024,2024-06-26T01:03:31,ACC00006511,Credit,1297.35,-410735.48,JPY,Amazon
TXN0000002025,2024-06-15T13:27:06,ACC00002839,Transfer,1665.67,-409069.81,USD,Starbucks
TXN0000002026,2024-11-05T01:02:20,ACC00005989,Payment,20.42,-409090.23,USD,Restaurant
TXN0000002027,2024-10-17T08:19:55,ACC00009495,Transfer,1527.49,-407562.74,GBP,Walmart
TXN0000002028,2024-10-08T12:17:19,ACC00000147,Credit,514.93,-407047.81,JPY,Target
TXN0000002029,2024-09-16T20:09:42,ACC00000840,Credit,1823.0,-405224.81,EUR,Starbucks
TXN0000002030,2024-11-11T23:27:30,ACC00001171,Transfer,1244.84,-403979.97,GBP,Amazon
TXN0000002031,2024-03-11T07:31:09,ACC00003963,Payment,1228.19,-405208.16,EUR,Grocery
TXN0000002032,2024-08-26T08:50:43,ACC00000835,Credit,1750.72,-403457.44,USD,Amazon
TXN0000002033,2024-06-29T09:02:24,ACC00007057,Transfer,1921.01,-401536.43,JPY,Target
TXN0000002034,2024-03-06T22:38:51,ACC00009508,Debit,1190.55,-402726.98,GBP,Restaurant
TXN0000002035,2024-03-03T17:02:46,ACC00007843,ATM,1257.91,-403984.89,JPY,Walmart
TXN0000002036,2024-11-27T09:15:32,ACC00007284,Payment,304.21,-404289.1,JPY,Walmart
TXN0000002037,2024-12-09T23:37:13,ACC00007663,Credit,1035.05,-403254.05,JPY,Starbucks
TXN0000002038,2024-01-16T21:43:43,ACC00002965,Payment,1113.88,-404367.93,EUR,Walmart
TXN0000002039,2024-11-28T12:47:20,ACC00009376,Transfer,1249.23,-403118.7,EUR,Starbucks
TXN0000002040,2024-03-05T16:15:21,ACC00009789,Transfer,1416.27,-401702.43,GBP,Grocery
TXN0000002041,2024-12-16T06:24:42,ACC00006072,Transfer,336.03,-401366.4,EUR,Amazon
TXN0000002042,2024-08-26T22:58:18,ACC00005963,Debit,1461.2,-402827.6,EUR,Shell
TXN0000002043,2024-10-27T00:31:18,ACC00006631,Transfer,1118.61,-401708.99,USD,Walmart
TXN0000002044,2024-03-07T22:31:56,ACC00007837,Payment,1491.29,-403200.28,EUR,Online Store
TXN0000002045,2024-06-27T06:19:30,ACC00004925,ATM,82.09,-403282.37,USD,Grocery
TXN0000002046,2024-10-05T05:23:40,ACC00006015,Payment,1372.22,-404654.59,GBP,Restaurant
TXN0000002047,2024-07-09T10:21:03,ACC00004281,Payment,629.27,-405283.86,GBP,Walmart
TXN0000002048,2024-10-05T18:07:42,ACC00002567,Credit,1619.18,-403664.68,JPY,Grocery
TXN0000002049,2024-03-31T13:24:46,ACC00002580,Credit,833.85,-402830.83,EUR,Target
TXN0000002050,2024-03-03T23:23:22,ACC00005268,Credit,58.18,-402772.65,EUR,Online Store
TXN0000002051,2024-07-20T00:09:11,ACC00006694,Debit,1555.37,-404328.02,EUR,Online Store
TXN0000002052,2024-04-01T03:34:05,ACC00002229,Debit,1726.76,-406054.78,GBP,Walmart
TXN0000002053,2024-07-21T19:33:21,ACC00001147,Debit,1167.45,-407222.23,JPY,Grocery
TXN0000002054,2024-05-14T09:19:18,ACC00004402,Transfer,1015.57,-406206.66,JPY,Restaurant
TXN0000002055,2024-03-15T13:41:38,ACC00009440,Debit,971.71,-407178.37,GBP,Starbucks
TXN0000002056,2024-03-10T23:58:04,ACC00004018,Payment,1719.83,-408898.2,JPY,Grocery
TXN0000002057,2024-06-11T14:47:52,ACC00002491,Debit,1509.03,-410407.23,JPY,Target
TXN0000002058,2024-02-09T18:46:45,ACC00005737,Transfer,724.72,-409682.51,USD,Restaurant
TXN0000002059,2024-05-04T19:37:22,ACC00006603,Credit,601.51,-409081.0,USD,Grocery
TXN0000002060,2024-12-29T22:49:59,ACC00006563,Transfer,924.96,-408156.04,JPY,Starbucks
TXN0000002061,2024-06-30T02:29:27,ACC00008941,Debit,1898.89,-410054.93,EUR,Starbucks
TXN0000002062,2024-04-12T10:00:31,ACC00007928,Debit,353.14,-410408.07,GBP,Restaurant
TXN0000002063,2024-07-24T02:00:38,ACC00008133,ATM,1025.59,-411433.66,GBP,Target
TXN0000002064,2024-01-25T04:39:52,ACC00008989,ATM,480.73,-411914.39,JPY,Grocery
TXN0000002065,2024-07-11T08:26:25,ACC00004868,Debit,1393.0,-413307.39,GBP,Grocery
TXN0000002066,2024-07-29T02:41:38,ACC00006018,Payment,880.88,-414188.27,GBP,Target
TXN0000002067,2024-03-17T09:20:40,ACC00001902,Payment,1435.19,-415623.46,GBP,Online Store
TXN0000002068,2024-03-06T07:34:21,ACC00005944,Transfer,399.11,-415224.35,USD,Starbucks
TXN0000002069,2024-06-02T14:40:28,ACC00004024,Credit,326.23,-414898.12,GBP,Amazon
TXN0000002070,2024-03-26T14:09:26,ACC00001993,Payment,871.3,-415769.42,USD,Walmart
TXN0000002071,2024-08-12T17:57:09,ACC00009924,Payment,1883.97,-417653.39,USD,Restaurant
TXN0000002072,2024-08-31T19:20:53,ACC00005702,Debit,487.95,-418141.34,USD,Grocery
TXN0000002073,2024-05-27T04:33:28,ACC00000971,Debit,49.0,-418190.34,EUR,Walmart
TXN0000002074,2024-11-10T23:05:48,ACC00005378,Credit,527.52,-417662.82,JPY,Grocery
TXN0000002075,2024-07-22T13:27:08,ACC00007945,Payment,737.29,-418400.11,GBP,Grocery
TXN0000002076,2024-07-09T23:43:27,ACC00002146,ATM,356.61,-418756.72,USD,Restaurant
TXN0000002077,2024-06-04T15:07:18,ACC00008033,Payment,1120.79,-419877.51,GBP,Restaurant
TXN0000002078,2024-02-06T23:11:07,ACC00008567,Payment,670.6,-420548.11,EUR,Online Store
TXN0000002079,2024-02-03T17:09:28,ACC00006739,Payment,1251.15,-421799.26,GBP,Grocery
TXN0000002080,2024-11-27T03:11:34,ACC00004445,Debit,1715.0,-423514.26,GBP,Walmart
TXN0000002081,2024-10-16T01:58:03,ACC00005783,Payment,1537.59,-425051.85,EUR,Target
TXN0000002082,2024-08-20T21:38:06,ACC00002463,Credit,1986.66,-423065.19,USD,Walmart
TXN0000002083,2024-02-17T06:53:32,ACC00007732,ATM,1132.31,-424197.5,USD,Online Store
TXN0000002084,2024-07-17T00:54:30,ACC00001402,Debit,477.61,-424675.11,GBP,Amazon
TXN0000002085,2024-10-20T12:17:11,ACC00002457,Credit,1568.87,-423106.24,EUR,Walmart
TXN0000002086,2024-11-24T18:36:50,ACC00008826,Credit,1810.87,-421295.37,EUR,Target
TXN0000002087,2024-12-06T14:58:31,ACC00000101,Payment,1902.62,-423197.99,GBP,Online Store
TXN0000002088,2024-01-30T08:31:41,ACC00006084,Debit,793.61,-423991.6,JPY,Starbucks
TXN0000002089,2024-10-24T05:04:53,ACC00001370,Transfer,1643.4,-422348.2,GBP,Restaurant
TXN0000002090,2024-10-25T21:30:03,ACC00005990,Transfer,1743.33,-420604.87,USD,Online Store
TXN0000002091,2024-02-16T10:06:25,ACC00009979,Debit,910.41,-421515.28,JPY,Shell
TXN0000002092,2024-07-15T01:53:58,ACC00000154,ATM,1678.24,-423193.52,EUR,Starbucks
TXN0000002093,2024-01-13T22:17:36,ACC00001151,Credit,1806.1,-421387.42,EUR,Amazon
TXN0000002094,2024-06-30T10:28:48,ACC00002108,Credit,1433.03,-419954.39,GBP,Amazon
TXN0000002095,2024-06-23T08:00:45,ACC00001719,Payment,1120.5,-421074.89,EUR,Starbucks
TXN0000002096,2024-04-02T08:02:46,ACC00008756,Transfer,1189.87,-419885.02,GBP,Walmart
TXN0000002097,2024-09-25T04:04:55,ACC00004987,ATM,945.12,-420830.14,EUR,Walmart
TXN0000002098,2024-10-01T19:28:15,ACC00001479,Transfer,145.21,-420684.93,GBP,Starbucks
TXN0000002099,2024-12-07T13:12:02,ACC00005487,Payment,802.16,-421487.09,JPY,Shell
TXN0000002100,2024-07-22T01:39:15,ACC00005649,Credit,15.33,-421471.76,JPY,Grocery
TXN0000002101,2024-09-14T00:46:33,ACC00001939,Credit,1589.07,-419882.69,GBP,Walmart
TXN0000002102,2024-07-15T05:07:02,ACC00002384,ATM,1297.69,-421180.38,EUR,Target
TXN0000002103,2024-08-14T21:07:25,ACC00008681,Transfer,224.26,-420956.12,GBP,Walmart
TXN0000002104,2024-11-13T23:13:01,ACC00002321,Payment,1146.81,-422102.93,GBP,Starbucks
TXN0000002105,2024-08-07T15:59:52,ACC00000409,Payment,381.71,-422484.64,USD,Walmart
TXN0000002106,2024-09-19T04:44:45,ACC00000930,ATM,1619.21,-424103.85,GBP,Shell
TXN0000002107,2024-05-05T19:39:38,ACC00004144,Credit,12.27,-424091.58,USD,Grocery
TXN0000002108,2024-06-10T09:00:27,ACC00009502,Credit,747.61,-423343.97,JPY,Online Store
TXN0000002109,2024-02-10T09:17:07,ACC00006396,Credit,1893.14,-421450.83,USD,Shell
TXN0000002110,2024-01-13T08:18:39,ACC00003177,Payment,1683.77,-423134.6,EUR,Grocery
TXN0000002111,2024-01-10T23:07:20,ACC00009867,Payment,843.89,-423978.49,GBP,Target
TXN0000002112,2024-02-29T10:51:48,ACC00005840,Transfer,1838.72,-422139.77,EUR,Online Store
TXN0000002113,2024-03-13T06:38:47,ACC00001502,Transfer,1806.51,-420333.26,EUR,Starbucks
TXN0000002114,2024-11-17T04:12:36,ACC00001737,Debit,47.32,-420380.58,GBP,Walmart
TXN0000002115,2024-01-11T13:33:08,ACC00005302,ATM,583.58,-420964.16,JPY,Online Store
TXN0000002116,2024-09-30T23:35:55,ACC00000915,Payment,467.02,-421431.18,USD,Grocery
TXN0000002117,2024-05-06T07:04:06,ACC00005394,Debit,1790.34,-423221.52,JPY,Starbucks
TXN0000002118,2024-11-10T08:39:55,ACC00003039,Payment,199.83,-423421.35,GBP,Restaurant
TXN0000002119,2024-05-29T19:15:20,ACC00007813,Debit,640.65,-424062.0,JPY,Target
TXN0000002120,2024-06-22T12:28:16,ACC00002084,Credit,889.22,-423172.78,EUR,Starbucks
TXN0000002121,2024-12-11T09:38:45,ACC00007206,ATM,538.72,-423711.5,GBP,Online Store
TXN0000002122,2024-04-13T11:05:07,ACC00003272,Credit,1126.51,-422584.99,USD,Grocery
TXN0000002123,2024-11-12T23:22:11,ACC00006832,Debit,1308.11,-423893.1,GBP,Shell
TXN0000002124,2024-07-12T15:16:15,ACC00005206,ATM,921.86,-424814.96,USD,Starbucks
TXN0000002125,2024-01-25T04:46:19,ACC00006455,ATM,1501.63,-426316.59,JPY,Amazon
TXN0000002126,2024-05-29T14:15:39,ACC00003155,Credit,1647.17,-424669.42,EUR,Online Store
TXN0000002127,2024-07-08T10:44:04,ACC00004893,Debit,55.61,-424725.03,USD,Walmart
TXN0000002128,2024-11-19T03:33:34,ACC00006438,Debit,883.4,-425608.43,JPY,Online Store
TXN0000002129,2024-06-29T06:46:30,ACC00005111,Payment,715.37,-426323.8,JPY,Amazon
TXN0000002130,2024-06-16T06:50:24,ACC00006005,Debit,977.99,-427301.79,USD,Grocery
TXN0000002131,2024-06-06T07:43:09,ACC00003461,Transfer,802.59,-426499.2,JPY,Amazon
TXN0000002132,2024-10-09T16:30:01,ACC00002863,Transfer,1441.16,-425058.04,JPY,Starbucks
TXN0000002133,2024-01-05T05:37:50,ACC00006391,Credit,514.15,-424543.89,GBP,Shell
TXN0000002134,2024-08-04T02:01:27,ACC00002464,Credit,1761.87,-422782.02,USD,Walmart
TXN0000002135,2024-12-14T14:38:33,ACC00007322,Debit,514.69,-423296.71,EUR,Starbucks
TXN0000002136,2024-10-09T00:39:05,ACC00006343,Debit,1428.55,-424725.26,EUR,Shell
TXN0000002137,2024-04-28T08:43:14,ACC00009926,ATM,263.51,-424988.77,EUR,Starbucks
TXN0000002138,2024-11-08T02:23:06,ACC00003260,Credit,977.02,-424011.75,USD,Shell
TXN0000002139,2024-07-03T05:19:43,ACC00006149,ATM,1528.62,-425540.37,JPY,Amazon
TXN0000002140,2024-08-30T12:29:58,ACC00004255,Payment,947.49,-426487.86,EUR,Target
TXN0000002141,2024-10-26T21:33:15,ACC00007909,Credit,1420.72,-425067.14,USD,Target
TXN0000002142,2024-03-12T12:24:42,ACC00002751,Credit,398.5,-424668.64,GBP,Shell
TXN0000002143,2024-12-09T19:54:07,ACC00002595,Credit,182.2,-424486.44,USD,Restaurant
TXN0000002144,2024-07-01T22:50:44,ACC00008557,Payment,567.75,-425054.19,GBP,Restaurant
TXN0000002145,2024-09-01T05:45:23,ACC00002895,Payment,1546.92,-426601.11,JPY,Amazon
TXN0000002146,2024-02-19T06:18:11,ACC00003131,Payment,769.91,-427371.02,JPY,Amazon
TXN0000002147,2024-09-19T00:13:37,ACC00001797,Credit,414.4,-426956.62,EUR,Amazon
TXN0000002148,2024-08-02T07:22:21,ACC00004987,Credit,1832.48,-425124.14,JPY,Starbucks
TXN0000002149,2024-06-01T02:23:45,ACC00006912,Transfer,1961.22,-423162.92,USD,Grocery
TXN0000002150,2024-02-11T12:42:16,ACC00004210,ATM,1985.83,-425148.75,USD,Starbucks
TXN0000002151,2024-07-29T07:33:27,ACC00003883,Debit,341.07,-425489.82,EUR,Walmart
TXN0000002152,2024-07-29T18:42:40,ACC00003020,Transfer,93.59,-425396.23,USD,Amazon
TXN0000002153,2024-12-25T15:27:15,ACC00006198,Transfer,1233.7,-424162.53,USD,Walmart
TXN0000002154,2024-12-15T12:33:17,ACC00008628,Debit,1296.56,-425459.09,USD,Online Store
TXN0000002155,2024-09-01T08:44:33,ACC00008793,Debit,953.06,-426412.15,JPY,Restaurant
TXN0000002156,2024-10-01T22:03:48,ACC00007487,Debit,1683.58,-428095.73,EUR,Shell
TXN0000002157,2024-02-16T18:02:08,ACC00002708,ATM,1026.82,-429122.55,EUR,Grocery
TXN0000002158,2024-08-17T22:26:47,ACC00005584,Credit,1338.4,-427784.15,JPY,Restaurant
TXN0000002159,2024-02-23T04:02:25,ACC00002458,ATM,1662.51,-429446.66,EUR,Target
TXN0000002160,2024-04-16T02:32:18,ACC00000055,Transfer,1461.48,-427985.18,EUR,Online Store
TXN0000002161,2024-03-28T16:25:19,ACC00003829,Credit,1890.39,-426094.79,EUR,Restaurant
TXN0000002162,2024-08-31T08:43:24,ACC00001702,Transfer,1547.68,-424547.11,USD,Online Store
TXN0000002163,2024-07-11T02:26:33,ACC00002315,ATM,1093.31,-425640.42,GBP,Starbucks
TXN0000002164,2024-09-01T02:22:34,ACC00000495,Transfer,1497.16,-424143.26,GBP,Shell
TXN0000002165,2024-07-30T09:51:53,ACC00003778,Payment,347.2,-424490.46,JPY,Online Store
TXN0000002166,2024-04-22T21:10:13,ACC00003624,Debit,1038.19,-425528.65,JPY,Amazon
TXN0000002167,2024-09-12T14:12:07,ACC00006804,Payment,1358.03,-426886.68,EUR,Target
TXN0000002168,2024-07-27T17:00:09,ACC00004526,Transfer,1199.97,-425686.71,GBP,Online Store
TXN0000002169,2024-03-17T07:21:33,ACC00004756,Payment,1532.75,-427219.46,GBP,Starbucks
TXN0000002170,2024-02-07T18:34:59,ACC00009438,Transfer,494.62,-426724.84,GBP,Grocery
TXN0000002171,2024-05-06T04:59:55,ACC00008659,Transfer,1598.6,-425126.24,USD,Starbucks
TXN0000002172,2024-11-20T08:33:31,ACC00002158,Payment,1686.63,-426812.87,USD,Restaurant
TXN0000002173,2024-10-08T07:54:31,ACC00004487,Transfer,163.43,-426649.44,USD,Starbucks
TXN0000002174,2024-10-07T15:59:39,ACC00006113,Credit,1432.72,-425216.72,GBP,Walmart
TXN0000002175,2024-04-20T01:21:20,ACC00007443,Transfer,1577.63,-423639.09,GBP,Amazon
TXN0000002176,2024-08-13T09:11:58,ACC00001397,ATM,1318.91,-424958.0,USD,Target
TXN0000002177,2024-05-27T22:21:53,ACC00001759,Credit,1363.37,-423594.63,USD,Online Store
TXN0000002178,2024-04-29T07:25:36,ACC00004014,ATM,285.49,-423880.12,JPY,Amazon
TXN0000002179,2024-09-04T20:01:23,ACC00005950,Transfer,1854.42,-422025.7,GBP,Online Store
TXN0000002180,2024-02-07T11:43:14,ACC00004048,Transfer,1295.24,-420730.46,EUR,Amazon
TXN0000002181,2024-12-15T00:46:25,ACC00003968,ATM,960.27,-421690.73,USD,Target
TXN0000002182,2024-02-19T08:55:21,ACC00005010,Payment,370.39,-422061.12,USD,Amazon
TXN0000002183,2024-01-25T22:55:59,ACC00002643,Transfer,1964.72,-420096.4,EUR,Online Store
TXN0000002184,2024-11-20T17:05:54,ACC00004498,Credit,1883.31,-418213.09,GBP,Grocery
TXN0000002185,2024-07-09T05:19:12,ACC00001221,ATM,1570.1,-419783.19,EUR,Target
TXN0000002186,2024-05-07T08:56:29,ACC00001840,Transfer,142.43,-419640.76,JPY,Shell
TXN0000002187,2024-02-06T23:30:10,ACC00008429,Transfer,57.51,-419583.25,GBP,Starbucks
TXN0000002188,2024-06-05T11:39:18,ACC00009748,Transfer,499.29,-419083.96,JPY,Online Store
TXN0000002189,2024-11-12T00:05:17,ACC00003337,Debit,1119.71,-420203.67,EUR,Shell
TXN0000002190,2024-03-05T21:30:34,ACC00009972,Debit,1187.98,-421391.65,GBP,Restaurant
TXN0000002191,2024-06-03T18:38:46,ACC00001363,Debit,62.41,-421454.06,GBP,Restaurant
TXN0000002192,2024-10-04T02:45:31,ACC00006740,ATM,876.41,-422330.47,USD,Walmart
TXN0000002193,2024-10-04T15:47:45,ACC00002120,Payment,326.66,-422657.13,GBP,Starbucks
TXN0000002194,2024-07-12T16:28:35,ACC00006319,Payment,242.63,-422899.76,GBP,Starbucks
TXN0000002195,2024-11-29T21:09:47,ACC00003079,Transfer,1756.05,-421143.71,USD,Shell
TXN0000002196,2024-12-07T03:35:34,ACC00007910,Payment,1994.77,-423138.48,EUR,Amazon
TXN0000002197,2024-08-03T00:23:53,ACC00004238,Debit,1912.1,-425050.58,GBP,Starbucks
TXN0000002198,2024-10-11T17:40:30,ACC00003931,ATM,271.44,-425322.02,EUR,Online Store
TXN0000002199,2024-12-19T13:25:13,ACC00001650,Transfer,544.57,-424777.45,GBP,Amazon
TXN0000002200,2024-09-08T21:19:07,ACC00000592,ATM,924.29,-425701.74,JPY,Starbucks
TXN0000002201,2024-02-22T16:42:46,ACC00004148,Payment,1872.84,-427574.58,JPY,Shell
TXN0000002202,2024-09-08T17:32:06,ACC00002182,ATM,89.33,-427663.91,GBP,Restaurant
TXN0000002203,2024-08-20T12:26:43,ACC00001964,ATM,1009.25,-428673.16,GBP,Target
TXN0000002204,2024-04-23T07:06:53,ACC00005438,Payment,1025.12,-429698.28,EUR,Target
TXN0000002205,2024-11-11T07:29:28,ACC00004302,Credit,207.79,-429490.49,JPY,Shell
TXN0000002206,2024-04-06T09:59:52,ACC00007480,Payment,96.66,-429587.15,USD,Shell
TXN0000002207,2024-09-28T10:33:04,ACC00000738,Transfer,1829.86,-427757.29,GBP,Starbucks
TXN0000002208,2024-05-09T21:13:36,ACC00001171,Payment,467.7,-428224.99,USD,Amazon
TXN0000002209,2024-02-16T14:18:18,ACC00006942,ATM,1136.32,-429361.31,USD,Shell
TXN0000002210,2024-06-03T05:33:22,ACC00005437,Credit,664.98,-428696.33,USD,Shell
TXN0000002211,2024-09-25T16:15:58,ACC00006207,Payment,976.58,-429672.91,GBP,Online Store
TXN0000002212,2024-02-09T13:32:48,ACC00000730,ATM,1422.07,-431094.98,EUR,Target
TXN0000002213,2024-10-22T07:30:20,ACC00002605,ATM,530.05,-431625.03,USD,Walmart
TXN0000002214,2024-10-01T12:30:28,ACC00008671,Credit,222.37,-431402.66,USD,Shell
TXN0000002215,2024-03-30T19:01:26,ACC00008217,Credit,1140.36,-430262.3,GBP,Amazon
TXN0000002216,2024-09-02T02:34:03,ACC00009625,Payment,1500.99,-431763.29,JPY,Restaurant
TXN0000002217,2024-01-08T00:13:33,ACC00006601,ATM,1415.56,-433178.85,GBP,Restaurant
TXN0000002218,2024-02-19T00:58:05,ACC00008120,Payment,653.78,-433832.63,USD,Online Store
TXN0000002219,2024-04-25T02:54:24,ACC00008433,Credit,240.7,-433591.93,JPY,Online Store
TXN0000002220,2024-09-30T20:53:19,ACC00008295,ATM,578.77,-434170.7,USD,Online Store
TXN0000002221,2024-08-03T14:10:59,ACC00009043,ATM,1470.06,-435640.76,USD,Restaurant
TXN0000002222,2024-02-23T03:12:50,ACC00008146,Transfer,1693.63,-433947.13,USD,Shell
TXN0000002223,2024-10-29T13:36:49,ACC00006974,Credit,338.48,-433608.65,EUR,Starbucks
TXN0000002224,2024-03-07T13:44:06,ACC00000260,Debit,1108.8,-434717.45,EUR,Online Store
TXN0000002225,2024-10-05T13:25:50,ACC00004304,Debit,991.48,-435708.93,EUR,Amazon
TXN0000002226,2024-03-07T22:53:20,ACC00006055,ATM,1062.99,-436771.92,USD,Shell
TXN0000002227,2024-01-11T21:38:39,ACC00003664,Transfer,1518.59,-435253.33,JPY,Shell
TXN0000002228,2024-06-13T14:07:17,ACC00009164,Payment,1634.58,-436887.91,USD,Target
TXN0000002229,2024-04-05T12:26:44,ACC00002975,Payment,656.12,-437544.03,USD,Grocery
TXN0000002230,2024-04-04T03:29:15,ACC00007606,Transfer,1866.07,-435677.96,EUR,Starbucks
TXN0000002231,2024-03-05T01:35:59,ACC00002462,Payment,866.92,-436544.88,JPY,Online Store
TXN0000002232,2024-07-18T05:12:40,ACC00007577,ATM,645.8,-437190.68,JPY,Amazon
TXN0000002233,2024-11-18T20:58:41,ACC00008979,ATM,1076.31,-438266.99,USD,Online Store
TXN0000002234,2024-07-27T22:45:44,ACC00008734,Credit,597.62,-437669.37,JPY,Shell
TXN0000002235,2024-02-22T11:19:16,ACC00007925,Transfer,449.11,-437220.26,USD,Amazon
TXN0000002236,2024-11-08T18:41:16,ACC00000097,ATM,1536.16,-438756.42,GBP,Online Store
TXN0000002237,2024-07-23T08:41:33,ACC00008400,Credit,1468.17,-437288.25,JPY,Grocery
TXN0000002238,2024-08-20T07:17:06,ACC00009945,Debit,992.94,-438281.19,USD,Starbucks
TXN0000002239,2024-03-07T14:31:20,ACC00007155,Payment,309.18,-438590.37,GBP,Online Store
TXN0000002240,2024-03-21T08:36:33,ACC00000550,Debit,1969.66,-440560.03,JPY,Walmart
TXN0000002241,2024-03-01T23:42:14,ACC00001064,Transfer,877.92,-439682.11,JPY,Shell
TXN0000002242,2024-04-09T23:22:38,ACC00006662,Credit,1714.22,-437967.89,JPY,Amazon
TXN0000002243,2024-01-13T15:04:42,ACC00002225,Payment,1826.96,-439794.85,JPY,Shell
TXN0000002244,2024-08-12T21:15:54,ACC00000350,Payment,29.88,-439824.73,EUR,Restaurant
TXN0000002245,2024-05-30T23:02:02,ACC00006824,Debit,215.31,-440040.04,JPY,Grocery
TXN0000002246,2024-02-25T13:49:53,ACC00000938,Debit,265.95,-440305.99,GBP,Amazon
TXN0000002247,2024-10-25T16:04:35,ACC00005350,Credit,346.8,-439959.19,USD,Amazon
TXN0000002248,2024-04-23T09:32:02,ACC00004120,Credit,1619.91,-438339.28,GBP,Grocery
TXN0000002249,2024-03-17T04:41:40,ACC00004741,Transfer,967.27,-437372.01,GBP,Walmart
TXN0000002250,2024-08-22T16:22:40,ACC00006331,Transfer,267.34,-437104.67,GBP,Amazon
TXN0000002251,2024-08-26T21:24:30,ACC00002554,Transfer,1887.71,-435216.96,USD,Walmart
TXN0000002252,2024-08-27T14:02:55,ACC00002667,Payment,1724.91,-436941.87,JPY,Walmart
TXN0000002253,2024-07-26T07:08:17,ACC00006740,ATM,65.38,-437007.25,EUR,Amazon
TXN0000002254,2024-01-15T21:03:40,ACC00009811,ATM,1649.14,-438656.39,JPY,Online Store
TXN0000002255,2024-10-06T15:06:59,ACC00008205,Payment,576.24,-439232.63,GBP,Restaurant
TXN0000002256,2024-08-23T12:07:52,ACC00001268,Debit,1451.77,-440684.4,JPY,Shell
TXN0000002257,2024-04-29T04:13:37,ACC00001644,Payment,930.02,-441614.42,EUR,Shell
TXN0000002258,2024-07-07T11:54:11,ACC00002060,Payment,1314.75,-442929.17,GBP,Target
TXN0000002259,2024-08-18T06:17:23,ACC00009031,Payment,1888.08,-444817.25,USD,Grocery
TXN0000002260,2024-09-26T16:36:51,ACC00007266,Credit,1722.2,-443095.05,JPY,Shell
TXN0000002261,2024-04-01T03:58:52,ACC00000754,Payment,55.24,-443150.29,GBP,Walmart
TXN0000002262,2024-11-15T08:53:36,ACC00005255,Credit,1804.87,-441345.42,USD,Walmart
TXN0000002263,2024-09-16T07:21:58,ACC00000550,ATM,1835.41,-443180.83,JPY,Online Store
TXN0000002264,2024-10-22T06:22:28,ACC00001874,Debit,61.05,-443241.88,USD,Online Store
TXN0000002265,2024-02-29T13:22:08,ACC00009932,Debit,417.56,-443659.44,EUR,Walmart
TXN0000002266,2024-01-06T00:23:19,ACC00006714,Transfer,291.33,-443368.11,JPY,Walmart
TXN0000002267,2024-12-28T10:16:05,ACC00002205,Payment,472.87,-443840.98,USD,Amazon
TXN0000002268,2024-12-27T00:09:21,ACC00005053,Credit,1152.13,-442688.85,GBP,Walmart
TXN0000002269,2024-01-22T03:08:17,ACC00005636,Transfer,351.31,-442337.54,EUR,Walmart
TXN0000002270,2024-09-04T23:20:30,ACC00007430,ATM,983.17,-443320.71,USD,Target
TXN0000002271,2024-09-19T15:51:18,ACC00006730,Credit,376.39,-442944.32,EUR,Online Store
TXN0000002272,2024-10-17T19:16:45,ACC00009053,Transfer,874.97,-442069.35,JPY,Restaurant
TXN0000002273,2024-08-01T19:13:06,ACC00005053,Debit,1775.6,-443844.95,USD,Starbucks
TXN0000002274,2024-12-27T06:36:35,ACC00005992,ATM,551.55,-444396.5,GBP,Grocery
TXN0000002275,2024-06-29T02:11:31,ACC00008995,Credit,1222.75,-443173.75,EUR,Grocery
TXN0000002276,2024-05-18T06:28:55,ACC00009897,ATM,1520.34,-444694.09,USD,Grocery
TXN0000002277,2024-04-13T18:34:17,ACC00002919,ATM,150.03,-444844.12,USD,Online Store
TXN0000002278,2024-10-27T00:56:55,ACC00001537,Credit,1354.91,-443489.21,GBP,Walmart
TXN0000002279,2024-10-25T11:50:35,ACC00007535,Payment,319.46,-443808.67,GBP,Starbucks
TXN0000002280,2024-02-21T17:07:10,ACC00002297,Transfer,1301.9,-442506.77,GBP,Online Store
TXN0000002281,2024-11-12T08:15:30,ACC00008933,Payment,1723.98,-444230.75,JPY,Grocery
TXN0000002282,2024-02-16T20:39:23,ACC00009031,Credit,1700.02,-442530.73,JPY,Shell
TXN0000002283,2024-04-24T10:05:46,ACC00000120,Payment,841.84,-443372.57,JPY,Online Store
TXN0000002284,2024-12-01T00:55:32,ACC00007133,Debit,823.61,-444196.18,JPY,Walmart
TXN0000002285,2024-01-29T07:27:08,ACC00005595,ATM,730.84,-444927.02,EUR,Starbucks
TXN0000002286,2024-04-20T09:53:32,ACC00009270,Payment,1323.91,-446250.93,EUR,Starbucks
TXN0000002287,2024-02-01T03:00:33,ACC00007759,Debit,595.89,-446846.82,GBP,Online Store
TXN0000002288,2024-09-04T15:09:15,ACC00001276,Payment,1583.01,-448429.83,EUR,Online Store
TXN0000002289,2024-12-04T05:04:48,ACC00006825,Debit,988.99,-449418.82,USD,Walmart
TXN0000002290,2024-07-23T22:33:32,ACC00004892,Credit,983.75,-448435.07,USD,Starbucks
TXN0000002291,2024-03-20T19:04:14,ACC00007459,Credit,140.14,-448294.93,GBP,Shell
TXN0000002292,2024-12-24T23:24:57,ACC00004037,Transfer,1747.44,-446547.49,USD,Amazon
TXN0000002293,2024-07-17T02:47:29,ACC00009821,Credit,1775.5,-444771.99,GBP,Walmart
TXN0000002294,2024-03-03T11:53:21,ACC00002673,Transfer,918.75,-443853.24,EUR,Walmart
TXN0000002295,2024-07-13T12:19:48,ACC00008839,Debit,934.2,-444787.44,EUR,Target
TXN0000002296,2024-03-31T06:08:15,ACC00002646,Payment,1552.93,-446340.37,JPY,Starbucks
TXN0000002297,2024-04-13T08:46:30,ACC00003309,ATM,1860.29,-448200.66,GBP,Amazon
TXN0000002298,2024-06-20T00:51:08,ACC00008412,ATM,432.49,-448633.15,USD,Restaurant
TXN0000002299,2024-01-28T07:12:30,ACC00003939,ATM,1085.83,-449718.98,USD,Starbucks
TXN0000002300,2024-12-27T21:40:10,ACC00009171,Debit,1982.05,-451701.03,EUR,Amazon
TXN0000002301,2024-09-26T10:02:49,ACC00003769,Payment,216.63,-451917.66,EUR,Target
TXN0000002302,2024-03-04T14:59:43,ACC00002977,Payment,1406.65,-453324.31,GBP,Amazon
TXN0000002303,2024-06-02T19:53:57,ACC00006247,Debit,1936.06,-455260.37,EUR,Walmart
TXN0000002304,2024-06-24T09:58:15,ACC00003770,Transfer,1856.99,-453403.38,USD,Grocery
TXN0000002305,2024-06-06T01:31:36,ACC00009585,ATM,1229.01,-454632.39,GBP,Online Store
TXN0000002306,2024-06-30T17:35:12,ACC00004609,Credit,62.93,-454569.46,EUR,Grocery
TXN0000002307,2024-12-09T22:27:45,ACC00002724,Transfer,1512.56,-453056.9,JPY,Online Store
TXN0000002308,2024-09-17T15:11:54,ACC00007108,Debit,1947.01,-455003.91,JPY,Walmart
TXN0000002309,2024-03-19T14:43:03,ACC00002419,ATM,516.63,-455520.54,USD,Grocery
TXN0000002310,2024-12-13T04:07:53,ACC00001990,Credit,987.78,-454532.76,EUR,Amazon
TXN0000002311,2024-05-01T05:09:41,ACC00000347,Credit,1675.4,-452857.36,JPY,Online Store
TXN0000002312,2024-04-16T03:10:00,ACC00003187,ATM,799.45,-453656.81,USD,Target
TXN0000002313,2024-03-29T17:23:37,ACC00007894,Payment,365.05,-454021.86,EUR,Grocery
TXN0000002314,2024-05-14T21:08:23,ACC00006346,Transfer,1742.72,-452279.14,EUR,Walmart
TXN0000002315,2024-12-20T08:24:50,ACC00003219,ATM,432.88,-452712.02,GBP,Restaurant
TXN0000002316,2024-02-26T05:48:04,ACC00002744,ATM,816.48,-453528.5,USD,Shell
TXN0000002317,2024-12-07T07:54:03,ACC00001173,Credit,898.79,-452629.71,EUR,Shell
TXN0000002318,2024-05-14T23:43:35,ACC00003814,Payment,747.8,-453377.51,USD,Restaurant
TXN0000002319,2024-08-01T15:40:09,ACC00000461,ATM,1271.78,-454649.29,GBP,Walmart
TXN0000002320,2024-12-19T12:01:42,ACC00002116,Transfer,950.97,-453698.32,GBP,Restaurant
TXN0000002321,2024-08-10T03:22:35,ACC00004549,Debit,1712.85,-455411.17,USD,Grocery
TXN0000002322,2024-04-15T08:07:40,ACC00004266,Credit,325.22,-455085.95,EUR,Target
TXN0000002323,2024-04-18T07:32:43,ACC00004611,Debit,926.68,-456012.63,GBP,Shell
TXN0000002324,2024-07-12T14:26:28,ACC00002913,Credit,1207.99,-454804.64,EUR,Grocery
TXN0000002325,2024-07-09T08:11:54,ACC00001785,Transfer,635.28,-454169.36,EUR,Online Store
TXN0000002326,2024-07-12T17:19:13,ACC00009028,Transfer,913.86,-453255.5,JPY,Shell
TXN0000002327,2024-02-11T11:35:30,ACC00006262,Credit,1562.14,-451693.36,EUR,Starbucks
TXN0000002328,2024-10-13T06:36:04,ACC00000459,ATM,92.38,-451785.74,GBP,Starbucks
TXN0000002329,2024-06-20T15:52:39,ACC00006604,Debit,1143.06,-452928.8,JPY,Walmart
TXN0000002330,2024-05-28T19:56:19,ACC00000964,Debit,1618.35,-454547.15,JPY,Restaurant
TXN0000002331,2024-11-20T14:35:12,ACC00009003,Credit,177.87,-454369.28,GBP,Target
TXN0000002332,2024-10-06T00:36:57,ACC00006715,Transfer,259.41,-454109.87,JPY,Target
TXN0000002333,2024-05-30T01:36:49,ACC00000263,Credit,833.92,-453275.95,JPY,Grocery
TXN0000002334,2024-09-18T03:09:04,ACC00005819,ATM,1188.13,-454464.08,GBP,Target
TXN0000002335,2024-04-25T07:46:34,ACC00000509,Payment,901.53,-455365.61,EUR,Starbucks
TXN0000002336,2024-05-22T00:49:25,ACC00000100,Credit,330.44,-455035.17,EUR,Online Store
TXN0000002337,2024-09-08T06:32:37,ACC00003831,Credit,663.44,-454371.73,JPY,Online Store
TXN0000002338,2024-10-02T07:01:11,ACC00008862,Credit,1157.72,-453214.01,USD,Online Store
TXN0000002339,2024-11-14T09:06:46,ACC00005705,Payment,421.18,-453635.19,USD,Online Store
TXN0000002340,2024-10-13T13:08:22,ACC00008080,Payment,1262.63,-454897.82,EUR,Online Store
TXN0000002341,2024-06-30T20:11:04,ACC00009846,Debit,926.34,-455824.16,EUR,Restaurant
TXN0000002342,2024-02-10T14:47:22,ACC00009882,ATM,1951.8,-457775.96,GBP,Online Store
TXN0000002343,2024-08-13T14:11:50,ACC00001905,Debit,845.35,-458621.31,USD,Restaurant
TXN0000002344,2024-09-02T16:55:17,ACC00001624,Transfer,366.64,-458254.67,JPY,Starbucks
TXN0000002345,2024-07-09T17:08:10,ACC00003528,Transfer,878.56,-457376.11,EUR,Shell
TXN0000002346,2024-12-28T12:35:35,ACC00003000,Transfer,940.38,-456435.73,USD,Target
TXN0000002347,2024-04-10T13:40:10,ACC00008173,Debit,1223.19,-457658.92,JPY,Grocery
TXN0000002348,2024-01-09T18:45:51,ACC00006712,Payment,1156.76,-458815.68,USD,Walmart
TXN0000002349,2024-03-13T11:58:36,ACC00003428,ATM,1391.24,-460206.92,EUR,Walmart
TXN0000002350,2024-10-01T16:14:15,ACC00007248,Credit,289.5,-459917.42,GBP,Amazon
TXN0000002351,2024-07-10T15:19:22,ACC00000907,Transfer,1736.01,-458181.41,USD,Grocery
TXN0000002352,2024-01-14T17:23:10,ACC00005782,Transfer,1975.91,-456205.5,EUR,Shell
TXN0000002353,2024-10-16T06:47:25,ACC00007754,ATM,880.62,-457086.12,EUR,Amazon
TXN0000002354,2024-06-04T23:28:56,ACC00001988,ATM,992.09,-458078.21,JPY,Grocery
TXN0000002355,2024-10-12T12:45:17,ACC00009443,ATM,115.46,-458193.67,JPY,Restaurant
TXN0000002356,2024-12-25T22:45:20,ACC00005836,Payment,1440.39,-459634.06,GBP,Walmart
TXN0000002357,2024-07-31T02:04:41,ACC00002218,Credit,589.3,-459044.76,GBP,Shell
TXN0000002358,2024-03-04T02:38:35,ACC00000611,Credit,172.01,-458872.75,EUR,Amazon
TXN0000002359,2024-10-04T19:32:26,ACC00006261,Credit,815.38,-458057.37,JPY,Walmart
TXN0000002360,2024-10-30T08:36:51,ACC00007418,Payment,367.05,-458424.42,EUR,Walmart
TXN0000002361,2024-03-29T20:47:29,ACC00006771,Credit,1352.03,-457072.39,USD,Grocery
TXN0000002362,2024-01-13T02:40:59,ACC00003478,Payment,1146.14,-458218.53,GBP,Amazon
TXN0000002363,2024-05-31T00:35:53,ACC00008271,Debit,71.23,-458289.76,JPY,Shell
TXN0000002364,2024-08-10T12:24:26,ACC00009653,Transfer,1281.73,-457008.03,EUR,Grocery
TXN0000002365,2024-09-26T22:38:09,ACC00003685,Debit,1166.53,-458174.56,GBP,Online Store
TXN0000002366,2024-06-27T03:38:11,ACC00000106,Payment,1040.99,-459215.55,JPY,Amazon
TXN0000002367,2024-12-24T08:03:05,ACC00007977,Payment,728.0,-459943.55,USD,Restaurant
TXN0000002368,2024-02-04T05:41:21,ACC00004232,ATM,270.05,-460213.6,JPY,Shell
TXN0000002369,2024-06-15T18:22:07,ACC00002087,Credit,1922.4,-458291.2,EUR,Amazon
TXN0000002370,2024-10-24T05:14:47,ACC00007781,Debit,708.68,-458999.88,USD,Amazon
TXN0000002371,2024-07-31T07:27:23,ACC00008291,Payment,752.75,-459752.63,EUR,Shell
TXN0000002372,2024-10-21T02:13:45,ACC00008930,ATM,426.31,-460178.94,GBP,Amazon
TXN0000002373,2024-10-05T07:23:08,ACC00005338,Credit,614.6,-459564.34,EUR,Walmart
TXN0000002374,2024-03-18T03:42:06,ACC00000052,Debit,1248.63,-460812.97,USD,Walmart
TXN0000002375,2024-09-13T10:35:36,ACC00003768,ATM,675.04,-461488.01,JPY,Walmart
TXN0000002376,2024-12-08T06:33:50,ACC00007639,Debit,833.6,-462321.61,JPY,Starbucks
TXN0000002377,2024-11-23T15:22:35,ACC00006784,Payment,1861.36,-464182.97,JPY,Walmart
TXN0000002378,2024-12-06T02:52:47,ACC00006383,Transfer,180.58,-464002.39,JPY,Target
TXN0000002379,2024-12-27T15:26:44,ACC00004150,Credit,1614.08,-462388.31,USD,Starbucks
TXN0000002380,2024-07-19T11:25:29,ACC00002344,Debit,1918.99,-464307.3,JPY,Shell
TXN0000002381,2024-07-30T05:06:16,ACC00002597,Debit,1201.1,-465508.4,JPY,Grocery
TXN0000002382,2024-11-12T21:42:35,ACC00008007,Payment,239.02,-465747.42,JPY,Target
TXN0000002383,2024-08-16T07:27:05,ACC00009787,ATM,1302.88,-467050.3,JPY,Shell
TXN0000002384,2024-06-05T08:34:49,ACC00005483,Payment,152.84,-467203.14,EUR,Online Store
TXN0000002385,2024-02-19T12:10:38,ACC00007707,ATM,768.8,-467971.94,EUR,Grocery
TXN0000002386,2024-06-30T14:21:40,ACC00003727,ATM,1433.78,-469405.72,JPY,Target
TXN0000002387,2024-04-13T17:35:24,ACC00002349,Payment,1044.98,-470450.7,GBP,Grocery
TXN0000002388,2024-10-03T20:12:05,ACC00000742,ATM,682.23,-471132.93,USD,Amazon
TXN0000002389,2024-03-22T12:37:07,ACC00000242,Payment,1863.35,-472996.28,USD,Amazon
TXN0000002390,2024-12-12T03:49:49,ACC00009159,ATM,1248.1,-474244.38,USD,Shell
TXN0000002391,2024-03-16T02:04:59,ACC00002714,Transfer,1979.26,-472265.12,EUR,Restaurant
TXN0000002392,2024-10-16T08:36:34,ACC00007932,ATM,1959.64,-474224.76,USD,Shell
TXN0000002393,2024-08-28T01:48:27,ACC00008845,Transfer,344.32,-473880.44,USD,Starbucks
TXN0000002394,2024-06-25T22:36:32,ACC00006554,Payment,15.37,-473895.81,EUR,Restaurant
TXN0000002395,2024-06-01T20:42:12,ACC00003731,Credit,813.88,-473081.93,EUR,Amazon
TXN0000002396,2024-04-28T21:51:07,ACC00006372,ATM,866.58,-473948.51,GBP,Grocery
TXN0000002397,2024-07-19T17:59:22,ACC00009010,Transfer,157.16,-473791.35,GBP,Shell
TXN0000002398,2024-12-20T06:00:40,ACC00002537,Credit,1958.35,-471833.0,USD,Target
TXN0000002399,2024-04-03T03:00:52,ACC00000750,ATM,352.86,-472185.86,USD,Shell
TXN0000002400,2024-04-03T17:48:09,ACC00002559,ATM,1704.1,-473889.96,EUR,Walmart
TXN0000002401,2024-02-20T01:38:10,ACC00006070,Credit,29.9,-473860.06,EUR,Shell
TXN0000002402,2024-04-13T13:41:04,ACC00007321,Credit,1310.58,-472549.48,USD,Target
TXN0000002403,2024-05-16T16:56:32,ACC00001702,Credit,823.18,-471726.3,JPY,Target
TXN0000002404,2024-05-14T20:50:57,ACC00007446,Transfer,1115.38,-470610.92,EUR,Starbucks
TXN0000002405,2024-08-10T08:16:48,ACC00001932,ATM,1176.04,-471786.96,JPY,Shell
TXN0000002406,2024-01-08T11:10:00,ACC00001215,Debit,544.8,-472331.76,GBP,Grocery
TXN0000002407,2024-10-01T15:12:37,ACC00006874,Transfer,1196.24,-471135.52,USD,Shell
TXN0000002408,2024-06-03T12:11:10,ACC00008556,Transfer,1683.62,-469451.9,GBP,Grocery
TXN0000002409,2024-03-17T15:45:05,ACC00004142,Payment,1214.64,-470666.54,EUR,Online Store
TXN0000002410,2024-08-13T04:44:24,ACC00000876,Payment,1266.53,-471933.07,JPY,Walmart
TXN0000002411,2024-12-20T21:35:50,ACC00002631,Debit,601.79,-472534.86,JPY,Target
TXN0000002412,2024-12-03T06:30:37,ACC00000282,Credit,791.8,-471743.06,EUR,Target
TXN0000002413,2024-09-02T14:10:31,ACC00007393,Transfer,1420.73,-470322.33,JPY,Online Store
TXN0000002414,2024-09-26T20:47:18,ACC00008846,Transfer,1874.14,-468448.19,JPY,Restaurant
TXN0000002415,2024-03-24T04:33:18,ACC00006687,Debit,1732.34,-470180.53,GBP,Online Store
TXN0000002416,2024-06-28T09:43:49,ACC00001401,Debit,1210.6,-471391.13,GBP,Starbucks
TXN0000002417,2024-08-13T19:22:21,ACC00005282,Payment,903.11,-472294.24,JPY,Target
TXN0000002418,2024-10-08T20:51:53,ACC00007789,Transfer,1057.9,-471236.34,GBP,Starbucks
TXN0000002419,2024-01-29T01:20:09,ACC00008020,Payment,532.73,-471769.07,USD,Starbucks
TXN0000002420,2024-01-30T05:43:11,ACC00008992,Payment,418.43,-472187.5,USD,Walmart
TXN0000002421,2024-04-09T17:45:33,ACC00003199,ATM,1614.97,-473802.47,GBP,Restaurant
TXN0000002422,2024-08-24T08:53:47,ACC00009770,Credit,1781.06,-472021.41,JPY,Walmart
TXN0000002423,2024-11-17T11:42:53,ACC00003026,ATM,298.71,-472320.12,USD,Grocery
TXN0000002424,2024-07-19T06:28:53,ACC00001281,Debit,1467.53,-473787.65,EUR,Walmart
TXN0000002425,2024-05-21T04:01:45,ACC00002344,Credit,91.81,-473695.84,EUR,Grocery
TXN0000002426,2024-10-17T14:27:52,ACC00006610,Payment,1379.52,-475075.36,GBP,Restaurant
TXN0000002427,2024-07-01T00:01:03,ACC00000790,Debit,777.27,-475852.63,USD,Walmart
TXN0000002428,2024-08-26T19:49:01,ACC00007552,ATM,402.15,-476254.78,GBP,Starbucks
TXN0000002429,2024-11-10T14:34:26,ACC00008274,ATM,696.61,-476951.39,EUR,Shell
TXN0000002430,2024-01-14T06:12:45,ACC00009030,Debit,1167.9,-478119.29,JPY,Target
TXN0000002431,2024-08-24T15:45:51,ACC00009461,Payment,1157.78,-479277.07,GBP,Grocery
TXN0000002432,2024-11-27T13:22:09,ACC00000809,Payment,1234.91,-480511.98,USD,Shell
TXN0000002433,2024-06-25T12:42:33,ACC00006785,Debit,1144.01,-481655.99,EUR,Restaurant
TXN0000002434,2024-07-19T20:37:35,ACC00000592,Debit,14.21,-481670.2,USD,Amazon
TXN0000002435,2024-06-21T21:19:32,ACC00002168,Credit,1476.0,-480194.2,EUR,Online Store
TXN0000002436,2024-07-20T16:38:34,ACC00005297,ATM,462.83,-480657.03,EUR,Walmart
TXN0000002437,2024-01-06T08:55:32,ACC00004520,ATM,1806.03,-482463.06,USD,Online Store
TXN0000002438,2024-08-13T17:41:58,ACC00004184,ATM,228.96,-482692.02,USD,Amazon
TXN0000002439,2024-11-06T15:35:45,ACC00000992,Payment,1169.29,-483861.31,GBP,Shell
TXN0000002440,2024-01-11T13:14:00,ACC00007770,Transfer,1614.71,-482246.6,USD,Target
TXN0000002441,2024-11-13T11:20:59,ACC00005989,Transfer,1092.65,-481153.95,USD,Starbucks
TXN0000002442,2024-06-12T19:08:09,ACC00004950,Debit,16.97,-481170.92,EUR,Amazon
TXN0000002443,2024-08-29T20:02:42,ACC00009356,Credit,1531.5,-479639.42,USD,Amazon
TXN0000002444,2024-06-08T02:10:43,ACC00003275,Debit,715.12,-480354.54,EUR,Shell
TXN0000002445,2024-08-31T08:17:21,ACC00008009,Transfer,863.83,-479490.71,GBP,Shell
TXN0000002446,2024-06-18T19:35:12,ACC00000746,ATM,1441.57,-480932.28,GBP,Amazon
TXN0000002447,2024-06-17T20:02:59,ACC00007153,Payment,1939.56,-482871.84,USD,Grocery
TXN0000002448,2024-12-08T04:33:51,ACC00002182,Debit,1566.68,-484438.52,GBP,Online Store
TXN0000002449,2024-01-27T09:02:20,ACC00007401,Transfer,1411.39,-483027.13,USD,Amazon
TXN0000002450,2024-07-28T13:30:59,ACC00008289,Credit,320.71,-482706.42,GBP,Walmart
TXN0000002451,2024-10-16T09:36:43,ACC00001568,Debit,1159.41,-483865.83,JPY,Walmart
TXN0000002452,2024-03-14T19:25:29,ACC00000406,Credit,1639.92,-482225.91,JPY,Amazon
TXN0000002453,2024-07-30T03:15:04,ACC00000041,Debit,863.6,-483089.51,GBP,Amazon
TXN0000002454,2024-11-21T08:24:11,ACC00009707,Credit,496.92,-482592.59,USD,Target
TXN0000002455,2024-03-16T09:57:09,ACC00007213,Credit,1995.64,-480596.95,EUR,Target
TXN0000002456,2024-11-08T01:08:09,ACC00006466,Payment,1226.17,-481823.12,JPY,Target
TXN0000002457,2024-01-03T16:26:28,ACC00000694,ATM,59.82,-481882.94,GBP,Target
TXN0000002458,2024-11-25T15:27:05,ACC00008954,Credit,1873.26,-480009.68,USD,Online Store
TXN0000002459,2024-04-01T12:32:45,ACC00006834,Transfer,1479.86,-478529.82,JPY,Online Store
TXN0000002460,2024-11-28T15:49:46,ACC00006358,Transfer,1331.75,-477198.07,USD,Starbucks
TXN0000002461,2024-02-12T02:27:29,ACC00003544,Payment,1581.3,-478779.37,USD,Amazon
TXN0000002462,2024-12-02T05:56:44,ACC00002383,Transfer,943.57,-477835.8,GBP,Grocery
TXN0000002463,2024-06-18T04:40:46,ACC00001459,Payment,1511.21,-479347.01,JPY,Amazon
TXN0000002464,2024-06-17T03:44:37,ACC00001303,Transfer,854.17,-478492.84,USD,Grocery
TXN0000002465,2024-04-02T12:12:45,ACC00004615,Payment,1085.45,-479578.29,GBP,Online Store
TXN0000002466,2024-10-05T07:00:44,ACC00002924,ATM,868.41,-480446.7,JPY,Restaurant
TXN0000002467,2024-10-02T22:08:44,ACC00002299,Payment,1585.63,-482032.33,GBP,Grocery
TXN0000002468,2024-05-26T06:07:35,ACC00001624,Credit,1330.06,-480702.27,EUR,Restaurant
TXN0000002469,2024-09-02T05:57:16,ACC00007370,Transfer,513.25,-480189.02,GBP,Grocery
TXN0000002470,2024-02-10T17:15:25,ACC00005372,ATM,871.83,-481060.85,USD,Online Store
TXN0000002471,2024-08-02T16:02:23,ACC00001426,Debit,1225.02,-482285.87,JPY,Grocery
TXN0000002472,2024-07-19T12:44:41,ACC00009151,ATM,982.53,-483268.4,JPY,Shell
TXN0000002473,2024-02-28T22:55:23,ACC00001944,ATM,436.64,-483705.04,JPY,Amazon
TXN0000002474,2024-06-04T00:58:07,ACC00002751,Credit,879.59,-482825.45,USD,Online Store
TXN0000002475,2024-11-26T17:07:55,ACC00006906,ATM,1165.62,-483991.07,JPY,Amazon
TXN0000002476,2024-12-15T10:45:44,ACC00006299,Transfer,1365.24,-482625.83,GBP,Amazon
TXN0000002477,2024-06-03T02:01:22,ACC00002746,Credit,709.06,-481916.77,GBP,Online Store
TXN0000002478,2024-03-08T13:54:53,ACC00009673,Debit,681.66,-482598.43,GBP,Shell
TXN0000002479,2024-02-11T22:43:37,ACC00001655,ATM,175.18,-482773.61,USD,Amazon
TXN0000002480,2024-09-30T14:21:53,ACC00005819,Debit,117.86,-482891.47,EUR,Starbucks
TXN0000002481,2024-03-02T01:51:17,ACC00004385,Transfer,1609.39,-481282.08,JPY,Starbucks
TXN0000002482,2024-10-10T00:23:57,ACC00005242,ATM,972.02,-482254.1,USD,Amazon
TXN0000002483,2024-06-07T05:32:07,ACC00005135,Payment,1696.67,-483950.77,EUR,Online Store
TXN0000002484,2024-02-02T16:13:36,ACC00008931,Transfer,1225.73,-482725.04,USD,Restaurant
TXN0000002485,2024-03-18T20:42:16,ACC00009671,Payment,135.34,-482860.38,EUR,Amazon
TXN0000002486,2024-11-18T01:54:54,ACC00005623,ATM,16.82,-482877.2,GBP,Amazon
TXN0000002487,2024-09-19T16:30:17,ACC00003124,ATM,499.99,-483377.19,GBP,Amazon
TXN0000002488,2024-02-03T05:25:59,ACC00003229,Debit,452.44,-483829.63,GBP,Shell
TXN0000002489,2024-04-17T16:52:46,ACC00003997,Payment,732.13,-484561.76,GBP,Online Store
TXN0000002490,2024-05-29T11:31:27,ACC00002947,Credit,632.68,-483929.08,JPY,Amazon
TXN0000002491,2024-01-24T19:31:43,ACC00004536,ATM,852.75,-484781.83,USD,Online Store
TXN0000002492,2024-08-26T00:28:07,ACC00007299,Credit,787.36,-483994.47,EUR,Starbucks
TXN0000002493,2024-09-17T15:09:28,ACC00009528,Transfer,667.44,-483327.03,EUR,Target
TXN0000002494,2024-03-19T13:59:56,ACC00008806,Transfer,923.06,-482403.97,EUR,Amazon
TXN0000002495,2024-05-04T00:29:37,ACC00000171,Debit,969.56,-483373.53,EUR,Shell
TXN0000002496,2024-07-21T05:57:05,ACC00002180,Debit,28.33,-483401.86,EUR,Shell
TXN0000002497,2024-07-13T19:16:27,ACC00008068,Credit,815.74,-482586.12,JPY,Restaurant
TXN0000002498,2024-10-03T11:41:54,ACC00006738,Credit,1733.84,-480852.28,JPY,Amazon
TXN0000002499,2024-04-21T06:04:55,ACC00005025,Transfer,1427.44,-479424.84,EUR,Walmart
TXN0000002500,2024-11-29T01:09:12,ACC00008823,Credit,1986.58,-477438.26,JPY,Starbucks
TXN0000002501,2024-10-08T06:12:22,ACC00006516,Payment,1335.49,-478773.75,JPY,Amazon
TXN0000002502,2024-09-05T23:33:31,ACC00002613,Transfer,1285.19,-477488.56,EUR,Online Store
TXN0000002503,2024-06-21T08:52:45,ACC00007729,Transfer,605.36,-476883.2,GBP,Online Store
TXN0000002504,2024-12-17T18:51:22,ACC00008822,Payment,601.84,-477485.04,USD,Walmart
TXN0000002505,2024-03-29T10:02:25,ACC00005167,Payment,1351.96,-478837.0,JPY,Walmart
TXN0000002506,2024-08-09T21:11:37,ACC00001423,Transfer,1446.58,-477390.42,EUR,Starbucks
TXN0000002507,2024-08-31T01:23:08,ACC00000799,Credit,225.07,-477165.35,JPY,Target
TXN0000002508,2024-12-11T12:32:30,ACC00000417,Payment,1597.54,-478762.89,USD,Walmart
TXN0000002509,2024-10-07T04:03:27,ACC00006710,Transfer,975.97,-477786.92,JPY,Amazon
TXN0000002510,2024-09-21T00:22:28,ACC00006437,ATM,1830.92,-479617.84,USD,Restaurant
TXN0000002511,2024-11-17T16:58:19,ACC00000158,ATM,143.49,-479761.33,JPY,Grocery
TXN0000002512,2024-03-19T16:22:41,ACC00003107,Debit,1500.57,-481261.9,GBP,Restaurant
TXN0000002513,2024-11-19T05:47:51,ACC00007617,Debit,261.54,-481523.44,USD,Starbucks
TXN0000002514,2024-02-21T15:25:01,ACC00001952,Credit,81.44,-481442.0,USD,Amazon
TXN0000002515,2024-10-21T03:31:11,ACC00000990,Debit,472.34,-481914.34,USD,Walmart
TXN0000002516,2024-07-02T02:00:26,ACC00008218,ATM,1682.53,-483596.87,USD,Online Store
TXN0000002517,2024-04-10T18:11:05,ACC00005634,Payment,1084.84,-484681.71,GBP,Restaurant
TXN0000002518,2024-05-30T07:01:21,ACC00004349,Transfer,455.79,-484225.92,USD,Online Store
TXN0000002519,2024-06-04T20:50:09,ACC00000669,Credit,256.85,-483969.07,JPY,Restaurant
TXN0000002520,2024-07-20T05:58:19,ACC00002638,Payment,384.55,-484353.62,JPY,Target
TXN0000002521,2024-01-28T09:59:00,ACC00004411,Credit,1820.66,-482532.96,GBP,Grocery
TXN0000002522,2024-01-20T23:08:43,ACC00002186,Credit,209.49,-482323.47,EUR,Shell
TXN0000002523,2024-08-12T13:48:34,ACC00008707,ATM,503.34,-482826.81,EUR,Walmart
TXN0000002524,2024-09-10T16:58:23,ACC00008219,Debit,405.44,-483232.25,EUR,Starbucks
TXN0000002525,2024-04-22T22:27:45,ACC00002076,Debit,535.84,-483768.09,EUR,Grocery
TXN0000002526,2024-01-23T22:08:14,ACC00006610,ATM,421.09,-484189.18,GBP,Starbucks
TXN0000002527,2024-03-21T16:32:37,ACC00004815,Debit,881.35,-485070.53,USD,Starbucks
TXN0000002528,2024-11-29T09:21:08,ACC00007756,ATM,807.48,-485878.01,USD,Shell
TXN0000002529,2024-07-09T17:58:24,ACC00001584,Credit,1631.21,-484246.8,JPY,Shell
TXN0000002530,2024-02-13T02:32:05,ACC00006975,Transfer,1176.72,-483070.08,GBP,Target
TXN0000002531,2024-05-25T01:44:30,ACC00000184,Transfer,164.53,-482905.55,GBP,Amazon
TXN0000002532,2024-01-22T22:43:21,ACC00004413,Transfer,512.29,-482393.26,USD,Amazon
TXN0000002533,2024-07-16T19:29:16,ACC00002490,Credit,1510.02,-480883.24,USD,Grocery
TXN0000002534,2024-08-18T15:07:00,ACC00009997,ATM,457.48,-481340.72,EUR,Shell
TXN0000002535,2024-06-26T13:18:15,ACC00002919,ATM,1579.93,-482920.65,JPY,Shell
TXN0000002536,2024-01-18T12:20:54,ACC00001731,Debit,718.14,-483638.79,GBP,Shell
TXN0000002537,2024-10-28T21:40:06,ACC00009536,Transfer,124.13,-483514.66,USD,Target
TXN0000002538,2024-05-05T08:27:52,ACC00001475,Credit,1560.76,-481953.9,EUR,Target
TXN0000002539,2024-11-27T11:00:51,ACC00007936,ATM,1596.58,-483550.48,EUR,Grocery
TXN0000002540,2024-08-28T19:42:27,ACC00007371,Transfer,593.53,-482956.95,USD,Restaurant
TXN0000002541,2024-07-05T06:27:54,ACC00005388,Debit,1236.34,-484193.29,JPY,Online Store
TXN0000002542,2024-03-27T07:51:36,ACC00003764,Debit,699.98,-484893.27,JPY,Starbucks
TXN0000002543,2024-01-24T13:07:19,ACC00000605,Payment,1006.17,-485899.44,EUR,Online Store
TXN0000002544,2024-04-06T04:14:30,ACC00005778,ATM,551.09,-486450.53,JPY,Walmart
TXN0000002545,2024-07-16T09:15:20,ACC00003015,Debit,1900.48,-488351.01,JPY,Amazon
TXN0000002546,2024-01-10T04:24:25,ACC00003502,Credit,778.72,-487572.29,USD,Restaurant
TXN0000002547,2024-05-28T10:58:11,ACC00004567,Transfer,1581.45,-485990.84,EUR,Restaurant
TXN0000002548,2024-02-07T07:13:00,ACC00002625,Credit,67.58,-485923.26,USD,Grocery
TXN0000002549,2024-07-14T08:03:49,ACC00009017,Debit,1139.48,-487062.74,EUR,Grocery
TXN0000002550,2024-04-29T11:28:46,ACC00009873,Payment,1931.13,-488993.87,JPY,Walmart
TXN0000002551,2024-05-23T21:18:28,ACC00002074,ATM,445.34,-489439.21,JPY,Amazon
TXN0000002552,2024-12-24T06:11:28,ACC00002993,Payment,1376.73,-490815.94,USD,Grocery
TXN0000002553,2024-02-14T05:41:44,ACC00001277,ATM,777.24,-491593.18,JPY,Starbucks
TXN0000002554,2024-03-03T13:14:29,ACC00008613,Payment,1275.53,-492868.71,GBP,Target
TXN0000002555,2024-01-23T01:49:34,ACC00007580,Payment,1347.74,-494216.45,GBP,Online Store
TXN0000002556,2024-04-03T09:27:44,ACC00009830,ATM,1019.05,-495235.5,GBP,Starbucks
TXN0000002557,2024-04-02T12:26:54,ACC00003376,Debit,893.2,-496128.7,JPY,Target
TXN0000002558,2024-10-28T15:34:42,ACC00003558,Credit,568.48,-495560.22,USD,Starbucks
TXN0000002559,2024-01-09T13:27:53,ACC00004430,Credit,962.63,-494597.59,JPY,Grocery
TXN0000002560,2024-05-27T23:51:33,ACC00002514,Credit,517.2,-494080.39,GBP,Shell
TXN0000002561,2024-11-28T23:10:58,ACC00003772,Debit,755.95,-494836.34,GBP,Starbucks
TXN0000002562,2024-12-28T16:31:46,ACC00004252,Transfer,1422.98,-493413.36,GBP,Walmart
TXN0000002563,2024-04-22T20:12:07,ACC00007578,Debit,349.36,-493762.72,GBP,Starbucks
TXN0000002564,2024-11-22T21:54:55,ACC00008399,Transfer,1969.28,-491793.44,USD,Walmart
TXN0000002565,2024-05-08T01:10:16,ACC00000337,Credit,1906.51,-489886.93,USD,Grocery
TXN0000002566,2024-04-13T19:08:08,ACC00003247,Payment,350.01,-490236.94,EUR,Grocery
TXN0000002567,2024-07-02T11:14:08,ACC00004380,Credit,1293.75,-488943.19,GBP,Restaurant
TXN0000002568,2024-02-19T17:27:59,ACC00003232,Payment,391.48,-489334.67,USD,Starbucks
TXN0000002569,2024-12-04T18:32:40,ACC00004881,Debit,467.77,-489802.44,JPY,Restaurant
TXN0000002570,2024-04-27T03:33:07,ACC00000943,Debit,936.87,-490739.31,USD,Shell
TXN0000002571,2024-05-13T16:36:51,ACC00006993,Transfer,54.99,-490684.32,USD,Walmart
TXN0000002572,2024-06-04T07:38:20,ACC00000524,Payment,931.75,-491616.07,JPY,Amazon
TXN0000002573,2024-02-19T15:18:07,ACC00005916,Debit,1182.83,-492798.9,USD,Amazon
TXN0000002574,2024-12-30T06:53:30,ACC00006067,Transfer,1116.63,-491682.27,JPY,Online Store
TXN0000002575,2024-07-25T02:19:25,ACC00006465,Payment,156.18,-491838.45,EUR,Shell
TXN0000002576,2024-10-18T12:59:43,ACC00006756,Transfer,1792.5,-490045.95,EUR,Starbucks
TXN0000002577,2024-09-25T14:55:31,ACC00007540,ATM,1628.91,-491674.86,USD,Grocery
TXN0000002578,2024-08-29T21:52:49,ACC00009717,Credit,391.77,-491283.09,GBP,Grocery
TXN0000002579,2024-03-15T00:26:03,ACC00005065,Debit,696.87,-491979.96,GBP,Online Store
TXN0000002580,2024-02-19T16:04:22,ACC00008483,Debit,120.84,-492100.8,EUR,Shell
TXN0000002581,2024-03-03T01:10:46,ACC00008120,Credit,1381.97,-490718.83,GBP,Online Store
TXN0000002582,2024-12-01T02:03:07,ACC00009662,Transfer,1151.07,-489567.76,GBP,Grocery
TXN0000002583,2024-05-12T15:02:06,ACC00007026,Transfer,1096.7,-488471.06,JPY,Starbucks
TXN0000002584,2024-02-19T18:30:11,ACC00002979,Debit,21.48,-488492.54,JPY,Restaurant
TXN0000002585,2024-06-23T18:48:55,ACC00004380,Debit,914.35,-489406.89,EUR,Online Store
TXN0000002586,2024-03-07T20:37:56,ACC00004945,ATM,941.34,-490348.23,USD,Amazon
TXN0000002587,2024-08-23T12:17:37,ACC00005175,Debit,1799.31,-492147.54,GBP,Shell
TXN0000002588,2024-04-17T04:10:17,ACC00006060,Debit,1912.07,-494059.61,EUR,Grocery
TXN0000002589,2024-11-10T18:36:14,ACC00000540,Payment,1087.09,-495146.7,EUR,Walmart
TXN0000002590,2024-01-10T03:51:07,ACC00002345,ATM,113.82,-495260.52,USD,Grocery
TXN0000002591,2024-03-23T04:23:20,ACC00001402,Credit,1010.33,-494250.19,USD,Amazon
TXN0000002592,2024-01-12T09:11:02,ACC00004268,Payment,348.11,-494598.3,GBP,Target
TXN0000002593,2024-02-19T15:33:09,ACC00005299,Debit,55.86,-494654.16,USD,Target
TXN0000002594,2024-09-08T05:40:56,ACC00008520,Transfer,1498.15,-493156.01,JPY,Restaurant
TXN0000002595,2024-08-11T17:04:48,ACC00005459,Credit,719.12,-492436.89,JPY,Shell
TXN0000002596,2024-05-13T16:03:08,ACC00006054,ATM,896.2,-493333.09,USD,Amazon
TXN0000002597,2024-09-03T04:10:32,ACC00006315,Payment,1440.42,-494773.51,EUR,Online Store
TXN0000002598,2024-07-22T02:36:29,ACC00008937,Transfer,434.68,-494338.83,GBP,Amazon
TXN0000002599,2024-10-25T10:55:09,ACC00000844,Debit,941.53,-495280.36,EUR,Shell
TXN0000002600,2024-06-13T04:37:18,ACC00005638,Debit,86.07,-495366.43,JPY,Amazon
TXN0000002601,2024-05-26T08:15:39,ACC00007232,Transfer,622.67,-494743.76,EUR,Shell
TXN0000002602,2024-06-25T12:30:49,ACC00008785,Debit,1740.24,-496484.0,USD,Grocery
TXN0000002603,2024-12-02T15:35:49,ACC00009825,ATM,527.74,-497011.74,EUR,Restaurant
TXN0000002604,2024-09-06T06:07:22,ACC00000139,ATM,1483.65,-498495.39,GBP,Starbucks
TXN0000002605,2024-12-13T18:53:04,ACC00009635,Debit,1585.34,-500080.73,GBP,Grocery
TXN0000002606,2024-11-27T17:47:15,ACC00009441,Credit,1431.31,-498649.42,USD,Restaurant
TXN0000002607,2024-10-10T08:53:18,ACC00005076,Debit,1395.44,-500044.86,EUR,Amazon
TXN0000002608,2024-11-24T17:05:50,ACC00001995,Transfer,314.93,-499729.93,GBP,Target
TXN0000002609,2024-09-19T22:12:51,ACC00006872,Payment,402.04,-500131.97,USD,Shell
TXN0000002610,2024-02-25T19:44:31,ACC00009742,Debit,1784.47,-501916.44,JPY,Amazon
TXN0000002611,2024-10-15T08:03:25,ACC00003308,ATM,1516.33,-503432.77,JPY,Online Store
TXN0000002612,2024-01-26T21:04:38,ACC00003658,Debit,951.21,-504383.98,EUR,Walmart
TXN0000002613,2024-08-01T12:14:39,ACC00005344,Payment,936.47,-505320.45,GBP,Target
TXN0000002614,2024-06-29T02:18:26,ACC00005935,Debit,1873.07,-507193.52,USD,Grocery
TXN0000002615,2024-11-27T01:15:14,ACC00008405,Payment,1369.7,-508563.22,USD,Amazon
TXN0000002616,2024-02-26T09:01:27,ACC00000213,Debit,849.08,-509412.3,JPY,Walmart
TXN0000002617,2024-01-22T23:03:08,ACC00005426,Credit,1414.93,-507997.37,JPY,Walmart
TXN0000002618,2024-04-25T13:35:54,ACC00004347,ATM,130.62,-508127.99,JPY,Target
TXN0000002619,2024-09-21T06:17:14,ACC00005705,Credit,1289.15,-506838.84,JPY,Amazon
TXN0000002620,2024-12-07T22:17:44,ACC00007492,Transfer,1085.92,-505752.92,GBP,Grocery
TXN0000002621,2024-07-19T14:56:13,ACC00001771,Credit,1688.37,-504064.55,JPY,Shell
TXN0000002622,2024-07-08T00:16:51,ACC00003823,Transfer,1879.24,-502185.31,GBP,Restaurant
TXN0000002623,2024-03-26T08:13:34,ACC00002064,Transfer,1163.22,-501022.09,EUR,Amazon
TXN0000002624,2024-04-29T08:10:14,ACC00004210,ATM,718.17,-501740.26,USD,Grocery
TXN0000002625,2024-03-16T08:55:23,ACC00008102,Credit,438.22,-501302.04,JPY,Restaurant
TXN0000002626,2024-06-24T17:15:02,ACC00008113,Credit,1315.91,-499986.13,EUR,Amazon
TXN0000002627,2024-11-27T18:15:53,ACC00008524,Credit,1573.82,-498412.31,USD,Starbucks
TXN0000002628,2024-04-27T12:26:49,ACC00007950,ATM,53.68,-498465.99,GBP,Online Store
TXN0000002629,2024-09-28T00:34:03,ACC00007518,ATM,885.7,-499351.69,JPY,Online Store
TXN0000002630,2024-12-06T21:43:52,ACC00005920,Transfer,1678.95,-497672.74,USD,Starbucks
TXN0000002631,2024-10-12T21:04:02,ACC00000445,Payment,446.79,-498119.53,USD,Shell
TXN0000002632,2024-03-20T03:45:07,ACC00003927,Credit,876.19,-497243.34,USD,Online Store
TXN0000002633,2024-02-26T07:59:01,ACC00008740,Payment,372.49,-497615.83,USD,Target
TXN0000002634,2024-07-30T00:37:14,ACC00005639,Payment,1006.54,-498622.37,EUR,Grocery
TXN0000002635,2024-09-15T03:42:26,ACC00006905,Credit,1258.23,-497364.14,JPY,Target
TXN0000002636,2024-09-01T18:11:44,ACC00000432,Credit,820.66,-496543.48,JPY,Walmart
TXN0000002637,2024-03-25T04:15:59,ACC00005803,Transfer,973.9,-495569.58,GBP,Online Store
TXN0000002638,2024-02-20T20:18:38,ACC00003893,Transfer,1027.26,-494542.32,USD,Online Store
TXN0000002639,2024-07-02T16:39:27,ACC00003735,Credit,1399.59,-493142.73,USD,Online Store
TXN0000002640,2024-04-23T11:50:40,ACC00005454,ATM,478.74,-493621.47,USD,Target
TXN0000002641,2024-12-21T08:09:48,ACC00007059,Transfer,878.16,-492743.31,USD,Amazon
TXN0000002642,2024-01-20T05:15:38,ACC00004357,Payment,603.47,-493346.78,JPY,Starbucks
TXN0000002643,2024-03-15T04:03:29,ACC00006640,Transfer,1052.25,-492294.53,USD,Target
TXN0000002644,2024-05-29T10:19:24,ACC00001371,Debit,683.56,-492978.09,JPY,Restaurant
TXN0000002645,2024-12-08T02:43:42,ACC00008588,Credit,1966.98,-491011.11,USD,Walmart
TXN0000002646,2024-12-30T00:14:03,ACC00009737,ATM,1565.6,-492576.71,JPY,Starbucks
TXN0000002647,2024-02-18T23:54:00,ACC00008019,Payment,713.16,-493289.87,JPY,Amazon
TXN0000002648,2024-02-17T01:45:09,ACC00005412,Debit,267.05,-493556.92,JPY,Shell
TXN0000002649,2024-11-28T04:49:35,ACC00007020,Transfer,873.52,-492683.4,USD,Walmart
TXN0000002650,2024-04-05T14:56:08,ACC00005475,Transfer,1223.15,-491460.25,GBP,Restaurant
TXN0000002651,2024-01-20T01:25:25,ACC00001075,Debit,1248.01,-492708.26,JPY,Online Store
TXN0000002652,2024-12-15T02:20:53,ACC00007827,ATM,614.07,-493322.33,JPY,Amazon
TXN0000002653,2024-08-06T06:28:03,ACC00008287,Payment,590.99,-493913.32,JPY,Target
TXN0000002654,2024-02-04T15:34:59,ACC00004063,Payment,1157.55,-495070.87,JPY,Restaurant
TXN0000002655,2024-03-29T18:16:20,ACC00005253,Credit,53.68,-495017.19,USD,Target
TXN0000002656,2024-11-30T07:12:17,ACC00001031,Transfer,1675.23,-493341.96,JPY,Starbucks
TXN0000002657,2024-09-30T12:40:17,ACC00000223,ATM,321.67,-493663.63,JPY,Restaurant
TXN0000002658,2024-03-17T10:05:38,ACC00003940,Transfer,1607.75,-492055.88,EUR,Walmart
TXN0000002659,2024-10-15T06:12:24,ACC00009695,ATM,327.86,-492383.74,GBP,Restaurant
TXN0000002660,2024-09-17T12:27:45,ACC00001628,Credit,410.7,-491973.04,JPY,Walmart
TXN0000002661,2024-04-03T18:44:40,ACC00005340,Transfer,764.51,-491208.53,EUR,Online Store
TXN0000002662,2024-01-03T03:56:05,ACC00001422,ATM,354.62,-491563.15,EUR,Target
TXN0000002663,2024-05-07T03:48:04,ACC00000490,Credit,254.56,-491308.59,GBP,Shell
TXN0000002664,2024-10-26T17:01:54,ACC00000087,Transfer,309.72,-490998.87,JPY,Restaurant
TXN0000002665,2024-06-14T09:03:02,ACC00003185,Debit,886.35,-491885.22,USD,Walmart
TXN0000002666,2024-05-04T01:44:48,ACC00004422,ATM,466.32,-492351.54,EUR,Shell
TXN0000002667,2024-02-07T05:57:17,ACC00007467,Payment,851.49,-493203.03,EUR,Grocery
TXN0000002668,2024-03-11T00:32:09,ACC00001531,Debit,1706.38,-494909.41,USD,Online Store
TXN0000002669,2024-02-24T05:25:50,ACC00002419,Payment,1666.59,-496576.0,JPY,Amazon
TXN0000002670,2024-04-28T00:45:41,ACC00004247,Payment,1860.36,-498436.36,EUR,Walmart
TXN0000002671,2024-02-02T17:10:12,ACC00009619,Debit,1273.04,-499709.4,JPY,Target
TXN0000002672,2024-06-24T05:29:51,ACC00008983,ATM,1136.02,-500845.42,GBP,Online Store
TXN0000002673,2024-07-21T11:17:07,ACC00002457,Debit,950.66,-501796.08,EUR,Starbucks
TXN0000002674,2024-06-25T18:08:48,ACC00004870,Payment,326.73,-502122.81,JPY,Walmart
TXN0000002675,2024-03-12T18:52:41,ACC00002980,ATM,237.07,-502359.88,GBP,Grocery
TXN0000002676,2024-04-23T00:37:20,ACC00000642,Transfer,1832.65,-500527.23,EUR,Shell
TXN0000002677,2024-12-25T00:42:32,ACC00008525,Credit,1776.38,-498750.85,JPY,Shell
TXN0000002678,2024-05-17T20:28:49,ACC00008212,Credit,1670.12,-497080.73,JPY,Online Store
TXN0000002679,2024-05-01T06:47:28,ACC00005436,Payment,1142.59,-498223.32,GBP,Walmart
TXN0000002680,2024-08-17T11:59:39,ACC00002267,Debit,1843.66,-500066.98,JPY,Walmart
TXN0000002681,2024-05-11T11:12:10,ACC00002119,Transfer,326.04,-499740.94,JPY,Online Store
TXN0000002682,2024-11-28T20:45:22,ACC00003048,Credit,1874.45,-497866.49,EUR,Amazon
TXN0000002683,2024-08-15T19:16:01,ACC00002917,Debit,1783.0,-499649.49,GBP,Restaurant
TXN0000002684,2024-04-25T13:25:18,ACC00009433,Debit,1722.1,-501371.59,EUR,Shell
TXN0000002685,2024-10-17T18:59:15,ACC00004315,ATM,1457.04,-502828.63,GBP,Grocery
TXN0000002686,2024-01-12T04:43:48,ACC00001868,Debit,409.52,-503238.15,JPY,Starbucks
TXN0000002687,2024-04-22T09:15:41,ACC00009560,Payment,1801.59,-505039.74,USD,Restaurant
TXN0000002688,2024-11-02T05:13:39,ACC00009637,Debit,496.08,-505535.82,USD,Restaurant
TXN0000002689,2024-05-12T23:51:27,ACC00002129,Payment,1699.07,-507234.89,GBP,Online Store
TXN0000002690,2024-02-24T18:23:17,ACC00007807,Credit,1268.25,-505966.64,JPY,Starbucks
TXN0000002691,2024-05-21T19:38:18,ACC00005962,Debit,1647.41,-507614.05,USD,Restaurant
TXN0000002692,2024-08-18T11:50:16,ACC00002500,ATM,773.74,-508387.79,GBP,Restaurant
TXN0000002693,2024-08-10T02:32:53,ACC00000947,Credit,1189.96,-507197.83,EUR,Shell
TXN0000002694,2024-01-05T23:23:47,ACC00007440,Transfer,1585.32,-505612.51,EUR,Starbucks
TXN0000002695,2024-08-19T13:41:00,ACC00004790,ATM,663.75,-506276.26,JPY,Amazon
TXN0000002696,2024-07-11T10:36:51,ACC00009996,Payment,543.32,-506819.58,GBP,Restaurant
TXN0000002697,2024-07-17T22:12:58,ACC00007392,Credit,1760.99,-505058.59,JPY,Target
TXN0000002698,2024-12-21T10:07:04,ACC00003892,Transfer,877.35,-504181.24,USD,Grocery
TXN0000002699,2024-03-16T20:48:19,ACC00008453,Transfer,1933.13,-502248.11,EUR,Grocery
TXN0000002700,2024-09-21T02:31:40,ACC00007756,ATM,322.58,-502570.69,GBP,Grocery
TXN0000002701,2024-08-13T22:04:56,ACC00009110,Payment,1558.29,-504128.98,JPY,Amazon
TXN0000002702,2024-07-30T17:59:58,ACC00008199,Credit,924.28,-503204.7,GBP,Grocery
TXN0000002703,2024-09-04T12:55:29,ACC00008915,Credit,1808.82,-501395.88,JPY,Target
TXN0000002704,2024-03-20T12:43:24,ACC00000383,Payment,1925.72,-503321.6,GBP,Starbucks
TXN0000002705,2024-01-15T09:15:57,ACC00001263,Debit,1197.95,-504519.55,JPY,Shell
TXN0000002706,2024-05-15T17:57:30,ACC00001332,Debit,1837.55,-506357.1,EUR,Amazon
TXN0000002707,2024-04-01T23:57:43,ACC00005951,Debit,713.99,-507071.09,USD,Shell
TXN0000002708,2024-02-26T13:11:03,ACC00004844,Debit,1065.09,-508136.18,GBP,Online Store
TXN0000002709,2024-12-09T15:21:13,ACC00001602,Transfer,1463.28,-506672.9,EUR,Shell
TXN0000002710,2024-09-23T21:17:43,ACC00003219,ATM,534.04,-507206.94,USD,Walmart
TXN0000002711,2024-04-14T01:08:45,ACC00007158,ATM,571.01,-507777.95,GBP,Walmart
TXN0000002712,2024-08-23T12:42:16,ACC00002159,Credit,833.67,-506944.28,EUR,Starbucks
TXN0000002713,2024-02-24T06:43:01,ACC00005351,Payment,1514.93,-508459.21,USD,Restaurant
TXN0000002714,2024-03-28T01:01:14,ACC00005081,Debit,1742.66,-510201.87,USD,Starbucks
TXN0000002715,2024-06-26T07:22:38,ACC00007728,Payment,244.76,-510446.63,GBP,Grocery
TXN0000002716,2024-07-05T20:46:42,ACC00001717,Debit,1921.23,-512367.86,GBP,Amazon
TXN0000002717,2024-05-20T01:59:14,ACC00006485,Transfer,1877.96,-510489.9,EUR,Starbucks
TXN0000002718,2024-04-22T18:02:21,ACC00005992,Payment,164.35,-510654.25,GBP,Restaurant
TXN0000002719,2024-11-03T00:32:16,ACC00008901,Debit,339.04,-510993.29,JPY,Starbucks
TXN0000002720,2024-05-20T20:02:51,ACC00002684,Payment,670.27,-511663.56,EUR,Shell
TXN0000002721,2024-04-04T19:45:45,ACC00005613,ATM,671.83,-512335.39,GBP,Amazon
TXN0000002722,2024-02-27T10:00:32,ACC00005923,Credit,1129.72,-511205.67,USD,Target
TXN0000002723,2024-10-27T08:57:57,ACC00007524,Credit,1317.51,-509888.16,USD,Online Store
TXN0000002724,2024-12-18T19:53:16,ACC00002704,Debit,1263.16,-511151.32,EUR,Amazon
TXN0000002725,2024-06-07T06:47:59,ACC00002144,Payment,1114.48,-512265.8,JPY,Shell
TXN0000002726,2024-02-11T02:23:50,ACC00009715,Transfer,1336.37,-510929.43,EUR,Walmart
TXN0000002727,2024-01-21T02:39:06,ACC00004146,Debit,1786.28,-512715.71,GBP,Amazon
TXN0000002728,2024-12-06T10:45:53,ACC00005086,ATM,892.59,-513608.3,EUR,Target
TXN0000002729,2024-12-07T17:57:32,ACC00002970,Payment,283.69,-513891.99,JPY,Shell
TXN0000002730,2024-10-09T21:04:46,ACC00008915,ATM,315.7,-514207.69,EUR,Walmart
TXN0000002731,2024-05-03T15:21:50,ACC00004846,Debit,510.02,-514717.71,USD,Restaurant
TXN0000002732,2024-11-24T11:22:22,ACC00003190,ATM,760.53,-515478.24,GBP,Amazon
TXN0000002733,2024-11-29T15:49:02,ACC00004114,Payment,1774.42,-517252.66,GBP,Grocery
TXN0000002734,2024-03-19T17:23:29,ACC00009766,Debit,1783.61,-519036.27,JPY,Starbucks
TXN0000002735,2024-01-27T21:19:01,ACC00003744,ATM,1944.0,-520980.27,USD,Amazon
TXN0000002736,2024-05-28T17:16:59,ACC00005842,Payment,1749.93,-522730.2,JPY,Walmart
TXN0000002737,2024-05-22T02:05:36,ACC00006627,ATM,1128.1,-523858.3,GBP,Restaurant
TXN0000002738,2024-09-19T15:11:45,ACC00006282,Transfer,1731.99,-522126.31,USD,Online Store
TXN0000002739,2024-03-22T09:00:12,ACC00000982,Debit,1226.9,-523353.21,GBP,Target
TXN0000002740,2024-03-26T06:22:20,ACC00003470,Debit,1429.91,-524783.12,EUR,Online Store
TXN0000002741,2024-11-01T21:29:14,ACC00004907,ATM,1073.09,-525856.21,EUR,Amazon
TXN0000002742,2024-10-19T15:45:22,ACC00002545,Payment,1613.38,-527469.59,JPY,Starbucks
TXN0000002743,2024-05-10T23:49:29,ACC00007486,Credit,38.83,-527430.76,GBP,Online Store
TXN0000002744,2024-11-11T14:20:24,ACC00000056,ATM,1132.31,-528563.07,EUR,Online Store
TXN0000002745,2024-07-27T01:57:54,ACC00004935,Transfer,220.19,-528342.88,GBP,Online Store
TXN0000002746,2024-11-09T19:01:45,ACC00006739,Transfer,942.88,-527400.0,GBP,Amazon
TXN0000002747,2024-08-20T03:28:36,ACC00004430,Payment,793.69,-528193.69,USD,Restaurant
TXN0000002748,2024-11-25T06:56:53,ACC00006894,Credit,108.07,-528085.62,EUR,Target
TXN0000002749,2024-09-11T06:37:03,ACC00008812,Debit,1820.1,-529905.72,EUR,Starbucks
TXN0000002750,2024-10-16T15:03:23,ACC00005375,Credit,887.05,-529018.67,JPY,Walmart
TXN0000002751,2024-08-06T04:22:01,ACC00009874,ATM,315.0,-529333.67,GBP,Shell
TXN0000002752,2024-08-06T17:56:48,ACC00002064,Transfer,1235.55,-528098.12,JPY,Walmart
TXN0000002753,2024-07-05T08:43:35,ACC00007739,Debit,1586.0,-529684.12,EUR,Starbucks
TXN0000002754,2024-10-28T20:24:27,ACC00007610,Credit,656.96,-529027.16,USD,Restaurant
TXN0000002755,2024-11-06T13:48:26,ACC00001566,Transfer,1582.07,-527445.09,JPY,Online Store
TXN0000002756,2024-09-09T08:27:18,ACC00009593,Debit,1334.72,-528779.81,USD,Starbucks
TXN0000002757,2024-06-03T12:35:49,ACC00005457,Debit,1957.15,-530736.96,GBP,Shell
TXN0000002758,2024-06-09T02:00:02,ACC00008440,Debit,115.84,-530852.8,JPY,Amazon
TXN0000002759,2024-01-22T01:45:41,ACC00003735,Credit,221.0,-530631.8,GBP,Starbucks
TXN0000002760,2024-11-03T05:13:05,ACC00005462,Payment,385.52,-531017.32,USD,Target
TXN0000002761,2024-04-18T09:04:08,ACC00005593,Payment,529.07,-531546.39,USD,Target
TXN0000002762,2024-06-10T18:57:07,ACC00003340,ATM,1852.23,-533398.62,USD,Walmart
TXN0000002763,2024-07-24T22:05:33,ACC00002645,Payment,1989.98,-535388.6,JPY,Restaurant
TXN0000002764,2024-08-15T10:17:03,ACC00002203,Transfer,1763.57,-533625.03,USD,Grocery
TXN0000002765,2024-09-20T03:25:55,ACC00008976,Credit,873.03,-532752.0,JPY,Amazon
TXN0000002766,2024-03-02T19:58:28,ACC00005409,Payment,1177.62,-533929.62,USD,Grocery
TXN0000002767,2024-07-24T10:34:09,ACC00000119,Transfer,139.35,-533790.27,GBP,Grocery
TXN0000002768,2024-04-09T13:20:52,ACC00001881,ATM,896.57,-534686.84,GBP,Starbucks
TXN0000002769,2024-10-20T06:40:05,ACC00008510,Payment,1149.61,-535836.45,EUR,Grocery
TXN0000002770,2024-06-08T11:31:26,ACC00001822,ATM,1716.75,-537553.2,GBP,Starbucks
TXN0000002771,2024-07-12T09:31:55,ACC00009558,Transfer,271.11,-537282.09,GBP,Amazon
TXN0000002772,2024-11-09T06:21:17,ACC00003734,Debit,82.52,-537364.61,GBP,Restaurant
TXN0000002773,2024-06-29T09:40:40,ACC00005909,Payment,754.0,-538118.61,USD,Shell
TXN0000002774,2024-01-14T00:35:25,ACC00002478,Transfer,877.43,-537241.18,JPY,Restaurant
TXN0000002775,2024-10-06T23:48:19,ACC00004004,Credit,577.53,-536663.65,JPY,Shell
TXN0000002776,2024-03-26T10:13:43,ACC00001569,Transfer,967.56,-535696.09,EUR,Online Store
TXN0000002777,2024-05-05T14:35:05,ACC00008394,ATM,1243.24,-536939.33,GBP,Target
TXN0000002778,2024-05-17T23:55:01,ACC00006766,Transfer,1320.57,-535618.76,USD,Restaurant
TXN0000002779,2024-06-08T18:17:56,ACC00009166,Debit,1645.33,-537264.09,EUR,Shell
TXN0000002780,2024-11-28T03:13:50,ACC00008888,ATM,1236.66,-538500.75,JPY,Amazon
TXN0000002781,2024-08-18T11:37:26,ACC00002888,Transfer,1706.23,-536794.52,JPY,Restaurant
TXN0000002782,2024-03-04T00:27:07,ACC00004190,Payment,697.41,-537491.93,USD,Shell
TXN0000002783,2024-11-23T05:26:34,ACC00006493,ATM,1561.07,-539053.0,JPY,Online Store
TXN0000002784,2024-12-24T06:21:43,ACC00006437,Payment,649.39,-539702.39,GBP,Target
TXN0000002785,2024-12-16T15:40:21,ACC00002710,Credit,1490.17,-538212.22,GBP,Grocery
TXN0000002786,2024-08-08T11:29:09,ACC00008176,Payment,1373.47,-539585.69,USD,Starbucks
TXN0000002787,2024-06-02T00:14:36,ACC00001821,Payment,1386.74,-540972.43,GBP,Starbucks
TXN0000002788,2024-06-13T12:45:38,ACC00000601,ATM,894.86,-541867.29,EUR,Walmart
TXN0000002789,2024-01-05T20:24:20,ACC00002708,Payment,513.95,-542381.24,GBP,Grocery
TXN0000002790,2024-07-04T04:55:34,ACC00004269,ATM,406.19,-542787.43,USD,Target
TXN0000002791,2024-07-29T01:01:58,ACC00003320,Credit,1771.57,-541015.86,USD,Shell
TXN0000002792,2024-08-14T20:26:09,ACC00000158,Payment,213.19,-541229.05,GBP,Walmart
TXN0000002793,2024-12-30T01:55:06,ACC00001040,ATM,429.14,-541658.19,EUR,Grocery
TXN0000002794,2024-08-20T17:32:42,ACC00005069,Debit,152.49,-541810.68,GBP,Amazon
TXN0000002795,2024-08-31T19:33:12,ACC00007946,Payment,1267.94,-543078.62,JPY,Shell
TXN0000002796,2024-02-09T15:03:58,ACC00005594,Payment,319.76,-543398.38,JPY,Grocery
TXN0000002797,2024-04-27T13:30:53,ACC00004791,ATM,226.27,-543624.65,JPY,Online Store
TXN0000002798,2024-12-23T13:25:58,ACC00006871,ATM,1543.51,-545168.16,GBP,Target
TXN0000002799,2024-03-20T02:02:41,ACC00007770,Credit,1112.03,-544056.13,JPY,Restaurant
TXN0000002800,2024-12-11T17:02:20,ACC00006328,Debit,924.57,-544980.7,JPY,Online Store
TXN0000002801,2024-06-12T22:18:26,ACC00003626,Credit,209.1,-544771.6,EUR,Target
TXN0000002802,2024-01-26T17:00:40,ACC00007275,Credit,364.14,-544407.46,JPY,Grocery
TXN0000002803,2024-11-11T14:04:38,ACC00003679,Transfer,1548.5,-542858.96,EUR,Online Store
TXN0000002804,2024-12-03T13:44:53,ACC00006041,Credit,1731.44,-541127.52,GBP,Walmart
TXN0000002805,2024-10-20T04:09:27,ACC00004019,ATM,1347.8,-542475.32,USD,Starbucks
TXN0000002806,2024-03-30T15:53:32,ACC00004863,Transfer,1029.66,-541445.66,JPY,Walmart
TXN0000002807,2024-03-26T13:58:56,ACC00008992,Transfer,718.9,-540726.76,JPY,Walmart
TXN0000002808,2024-10-08T10:19:16,ACC00006705,Transfer,979.84,-539746.92,USD,Starbucks
TXN0000002809,2024-10-27T16:00:32,ACC00002311,Credit,535.03,-539211.89,GBP,Starbucks
TXN0000002810,2024-09-16T15:01:28,ACC00005367,Credit,1841.81,-537370.08,JPY,Starbucks
TXN0000002811,2024-12-23T21:59:00,ACC00004706,Debit,392.02,-537762.1,USD,Online Store
TXN0000002812,2024-07-05T16:53:28,ACC00002168,ATM,85.94,-537848.04,GBP,Amazon
TXN0000002813,2024-04-15T20:12:57,ACC00004727,ATM,1441.86,-539289.9,JPY,Starbucks
TXN0000002814,2024-02-21T16:06:16,ACC00001272,Credit,1120.63,-538169.27,USD,Walmart
TXN0000002815,2024-11-19T16:10:27,ACC00006529,Payment,1493.91,-539663.18,GBP,Target
TXN0000002816,2024-01-23T12:13:50,ACC00007550,Debit,1605.69,-541268.87,JPY,Grocery
TXN0000002817,2024-09-01T17:18:36,ACC00000293,Credit,465.52,-540803.35,EUR,Amazon
TXN0000002818,2024-07-20T06:02:45,ACC00005608,Transfer,41.7,-540761.65,USD,Amazon
TXN0000002819,2024-03-19T17:05:33,ACC00005233,Payment,911.2,-541672.85,USD,Walmart
TXN0000002820,2024-09-19T07:08:19,ACC00008662,Transfer,138.99,-541533.86,USD,Restaurant
TXN0000002821,2024-05-27T22:49:17,ACC00008984,Transfer,1770.31,-539763.55,EUR,Amazon
TXN0000002822,2024-12-25T03:55:49,ACC00006873,Debit,103.31,-539866.86,JPY,Online Store
TXN0000002823,2024-09-15T02:00:25,ACC00009065,ATM,1823.12,-541689.98,GBP,Shell
TXN0000002824,2024-10-16T18:40:05,ACC00003543,Credit,441.59,-541248.39,GBP,Shell
TXN0000002825,2024-08-21T21:58:43,ACC00002893,Transfer,215.05,-541033.34,USD,Starbucks
TXN0000002826,2024-08-17T03:31:54,ACC00009731,Transfer,1769.19,-539264.15,JPY,Target
TXN0000002827,2024-01-28T13:45:50,ACC00001603,Credit,1980.46,-537283.69,GBP,Restaurant
TXN0000002828,2024-02-22T15:01:39,ACC00005348,Payment,1212.08,-538495.77,JPY,Online Store
TXN0000002829,2024-05-20T08:01:19,ACC00000646,Credit,1003.51,-537492.26,JPY,Grocery
TXN0000002830,2024-06-06T10:41:09,ACC00002862,Payment,1082.84,-538575.1,USD,Target
TXN0000002831,2024-07-03T08:05:06,ACC00000896,ATM,1496.22,-540071.32,EUR,Restaurant
TXN0000002832,2024-05-05T05:57:55,ACC00000152,Credit,635.49,-539435.83,JPY,Grocery
TXN0000002833,2024-01-04T07:18:18,ACC00007832,ATM,465.48,-539901.31,USD,Shell
TXN0000002834,2024-09-07T04:18:18,ACC00006598,Transfer,1686.3,-538215.01,EUR,Restaurant
TXN0000002835,2024-12-02T12:35:33,ACC00008345,Payment,790.36,-539005.37,EUR,Starbucks
TXN0000002836,2024-06-07T02:22:32,ACC00000240,Credit,1950.27,-537055.1,USD,Amazon
TXN0000002837,2024-11-30T13:53:08,ACC00009156,Transfer,471.04,-536584.06,EUR,Online Store
TXN0000002838,2024-03-27T20:39:53,ACC00006241,Payment,1136.08,-537720.14,EUR,Amazon
TXN0000002839,2024-09-06T05:14:49,ACC00008560,Credit,1576.74,-536143.4,USD,Restaurant
TXN0000002840,2024-10-18T18:02:28,ACC00009738,Debit,48.29,-536191.69,USD,Starbucks
TXN0000002841,2024-01-02T18:46:15,ACC00004613,Transfer,1399.11,-534792.58,EUR,Restaurant
TXN0000002842,2024-06-25T18:29:17,ACC00008769,Credit,111.22,-534681.36,EUR,Starbucks
TXN0000002843,2024-11-28T23:50:11,ACC00002782,Transfer,1188.16,-533493.2,GBP,Target
TXN0000002844,2024-01-31T17:33:10,ACC00009399,ATM,1823.94,-535317.14,USD,Restaurant
TXN0000002845,2024-05-01T11:59:28,ACC00008635,ATM,182.63,-535499.77,GBP,Restaurant
TXN0000002846,2024-12-03T00:37:21,ACC00000014,Transfer,400.71,-535099.06,GBP,Shell
TXN0000002847,2024-05-14T16:41:55,ACC00008144,Debit,1289.79,-536388.85,EUR,Walmart
TXN0000002848,2024-07-23T22:32:20,ACC00002505,Payment,999.36,-537388.21,USD,Amazon
TXN0000002849,2024-10-28T00:33:17,ACC00002469,Transfer,497.54,-536890.67,EUR,Amazon
TXN0000002850,2024-07-14T12:07:45,ACC00005427,Debit,124.32,-537014.99,JPY,Online Store
TXN0000002851,2024-03-13T20:38:54,ACC00000478,Transfer,1482.56,-535532.43,USD,Walmart
TXN0000002852,2024-03-26T20:04:35,ACC00007681,Credit,138.84,-535393.59,USD,Restaurant
TXN0000002853,2024-07-04T06:35:13,ACC00000464,Debit,1995.73,-537389.32,JPY,Amazon
TXN0000002854,2024-08-09T11:00:34,ACC00007248,Payment,1415.98,-538805.3,USD,Online Store
TXN0000002855,2024-03-22T10:52:59,ACC00009570,Transfer,1028.03,-537777.27,USD,Amazon
TXN0000002856,2024-02-02T18:49:23,ACC00008312,Credit,1226.74,-536550.53,JPY,Grocery
TXN0000002857,2024-03-19T21:04:43,ACC00008148,Transfer,102.28,-536448.25,USD,Walmart
TXN0000002858,2024-11-27T12:35:17,ACC00002358,Payment,980.59,-537428.84,USD,Walmart
TXN0000002859,2024-06-10T15:22:43,ACC00001001,Transfer,1836.29,-535592.55,GBP,Amazon
TXN0000002860,2024-11-07T00:07:06,ACC00008449,ATM,535.48,-536128.03,JPY,Online Store
TXN0000002861,2024-08-12T12:11:46,ACC00008025,Transfer,1337.33,-534790.7,EUR,Online Store
TXN0000002862,2024-02-13T09:27:57,ACC00001912,Credit,609.12,-534181.58,JPY,Restaurant
TXN0000002863,2024-09-11T14:33:06,ACC00003974,ATM,1192.18,-535373.76,EUR,Starbucks
TXN0000002864,2024-05-13T10:04:05,ACC00009641,Credit,1127.14,-534246.62,USD,Walmart
TXN0000002865,2024-06-16T05:05:10,ACC00009771,Transfer,1245.89,-533000.73,USD,Walmart
TXN0000002866,2024-01-20T04:54:38,ACC00001987,Credit,694.34,-532306.39,JPY,Restaurant
TXN0000002867,2024-03-11T01:47:55,ACC00005827,Debit,1044.56,-533350.95,GBP,Amazon
TXN0000002868,2024-05-12T01:29:52,ACC00006630,Transfer,1938.55,-531412.4,USD,Amazon
TXN0000002869,2024-12-29T04:08:53,ACC00003669,Credit,1090.48,-530321.92,USD,Amazon
TXN0000002870,2024-10-11T02:10:16,ACC00003447,ATM,471.67,-530793.59,USD,Shell
TXN0000002871,2024-05-27T19:51:36,ACC00005581,Payment,1272.75,-532066.34,JPY,Online Store
TXN0000002872,2024-04-26T08:11:21,ACC00007002,Payment,327.36,-532393.7,JPY,Walmart
TXN0000002873,2024-06-10T06:29:07,ACC00006289,ATM,1437.6,-533831.3,USD,Online Store
TXN0000002874,2024-03-28T05:52:39,ACC00008975,Debit,677.86,-534509.16,EUR,Walmart
TXN0000002875,2024-07-19T00:01:43,ACC00002268,Transfer,274.63,-534234.53,EUR,Target
TXN0000002876,2024-08-30T05:24:37,ACC00002232,Credit,1827.0,-532407.53,USD,Shell
TXN0000002877,2024-02-12T17:40:10,ACC00003711,Debit,610.91,-533018.44,USD,Online Store
TXN0000002878,2024-06-10T18:26:16,ACC00002709,ATM,339.99,-533358.43,GBP,Online Store
TXN0000002879,2024-02-21T18:52:55,ACC00003439,ATM,638.38,-533996.81,EUR,Grocery
TXN0000002880,2024-08-15T11:30:24,ACC00005353,Payment,1572.74,-535569.55,GBP,Amazon
TXN0000002881,2024-09-21T03:08:29,ACC00008490,ATM,327.65,-535897.2,USD,Starbucks
TXN0000002882,2024-05-28T13:09:33,ACC00003203,Credit,1751.01,-534146.19,EUR,Restaurant
TXN0000002883,2024-05-27T23:00:48,ACC00002664,ATM,1922.31,-536068.5,GBP,Online Store
TXN0000002884,2024-04-06T13:38:37,ACC00006151,Debit,482.33,-536550.83,GBP,Restaurant
TXN0000002885,2024-08-13T01:35:39,ACC00002829,Payment,1937.39,-538488.22,USD,Amazon
TXN0000002886,2024-07-31T05:24:38,ACC00004089,Payment,681.75,-539169.97,GBP,Grocery
TXN0000002887,2024-04-24T23:52:45,ACC00005571,Payment,1019.82,-540189.79,USD,Grocery
TXN0000002888,2024-03-18T16:59:56,ACC00000501,Debit,1994.17,-542183.96,JPY,Amazon
TXN0000002889,2024-12-08T19:14:09,ACC00007797,ATM,434.06,-542618.02,USD,Amazon
TXN0000002890,2024-03-02T00:20:16,ACC00002891,Credit,694.35,-541923.67,JPY,Target
TXN0000002891,2024-08-01T18:22:55,ACC00001195,Debit,438.45,-542362.12,JPY,Restaurant
TXN0000002892,2024-10-13T19:34:27,ACC00001834,Credit,716.12,-541646.0,EUR,Target
TXN0000002893,2024-11-25T04:34:38,ACC00002067,Transfer,1695.23,-539950.77,USD,Target
TXN0000002894,2024-11-20T01:56:11,ACC00004425,Payment,105.26,-540056.03,JPY,Starbucks
TXN0000002895,2024-10-16T09:44:47,ACC00000136,Credit,1236.43,-538819.6,GBP,Walmart
TXN0000002896,2024-10-17T09:46:06,ACC00008192,Payment,750.33,-539569.93,EUR,Grocery
TXN0000002897,2024-03-08T02:32:14,ACC00000066,Payment,588.65,-540158.58,GBP,Amazon
TXN0000002898,2024-07-15T10:30:54,ACC00008666,Transfer,1768.11,-538390.47,JPY,Walmart
TXN0000002899,2024-05-14T00:10:44,ACC00000692,Payment,1581.17,-539971.64,USD,Shell
TXN0000002900,2024-08-26T04:25:35,ACC00000791,Payment,656.62,-540628.26,JPY,Grocery
TXN0000002901,2024-02-16T01:08:40,ACC00001859,Credit,917.92,-539710.34,GBP,Walmart
TXN0000002902,2024-10-24T20:17:30,ACC00001393,ATM,167.76,-539878.1,EUR,Amazon
TXN0000002903,2024-12-29T02:31:03,ACC00002862,Credit,368.43,-539509.67,EUR,Walmart
TXN0000002904,2024-11-11T05:38:02,ACC00000054,Credit,800.44,-538709.23,JPY,Walmart
TXN0000002905,2024-11-07T16:32:55,ACC00008466,Debit,838.54,-539547.77,JPY,Target
TXN0000002906,2024-12-23T00:24:43,ACC00008992,Debit,789.73,-540337.5,USD,Amazon
TXN0000002907,2024-06-15T16:42:15,ACC00005033,ATM,713.29,-541050.79,GBP,Starbucks
TXN0000002908,2024-07-07T16:43:06,ACC00003102,Transfer,1041.62,-540009.17,USD,Grocery
TXN0000002909,2024-04-18T01:28:21,ACC00009772,ATM,284.08,-540293.25,USD,Starbucks
TXN0000002910,2024-07-05T05:33:37,ACC00001389,Payment,1436.6,-541729.85,USD,Online Store
TXN0000002911,2024-09-07T20:05:31,ACC00002626,Payment,315.12,-542044.97,EUR,Restaurant
TXN0000002912,2024-10-01T01:59:51,ACC00004838,Credit,1463.5,-540581.47,USD,Starbucks
TXN0000002913,2024-01-01T00:07:30,ACC00003207,Debit,155.18,-540736.65,JPY,Shell
TXN0000002914,2024-05-16T10:13:45,ACC00005117,Credit,1148.53,-539588.12,GBP,Target
TXN0000002915,2024-09-16T13:27:22,ACC00009823,ATM,1120.01,-540708.13,JPY,Shell
TXN0000002916,2024-11-03T11:16:14,ACC00002949,ATM,13.51,-540721.64,USD,Grocery
TXN0000002917,2024-03-28T23:41:40,ACC00002347,Payment,1901.18,-542622.82,JPY,Starbucks
TXN0000002918,2024-06-04T09:54:41,ACC00008180,Credit,1088.22,-541534.6,GBP,Online Store
TXN0000002919,2024-09-19T19:53:42,ACC00007190,Debit,1687.69,-543222.29,JPY,Starbucks
TXN0000002920,2024-09-04T09:54:23,ACC00004683,Credit,201.12,-543021.17,JPY,Grocery
TXN0000002921,2024-05-30T03:21:42,ACC00005915,Transfer,39.03,-542982.14,EUR,Restaurant
TXN0000002922,2024-04-03T09:12:56,ACC00000273,Credit,372.71,-542609.43,EUR,Shell
TXN0000002923,2024-09-27T04:25:59,ACC00005481,Credit,717.62,-541891.81,GBP,Online Store
TXN0000002924,2024-07-06T22:40:12,ACC00008740,Debit,1213.09,-543104.9,USD,Shell
TXN0000002925,2024-07-23T19:44:21,ACC00004055,Payment,113.43,-543218.33,GBP,Amazon
TXN0000002926,2024-08-09T00:21:03,ACC00001650,Transfer,476.33,-542742.0,EUR,Grocery
TXN0000002927,2024-10-10T14:46:12,ACC00000461,Payment,640.73,-543382.73,EUR,Amazon
TXN0000002928,2024-08-09T08:40:38,ACC00004523,Credit,1786.58,-541596.15,GBP,Starbucks
TXN0000002929,2024-06-01T01:30:51,ACC00009811,Payment,1643.12,-543239.27,GBP,Restaurant
TXN0000002930,2024-05-14T11:20:20,ACC00008828,Transfer,25.03,-543214.24,USD,Starbucks
TXN0000002931,2024-06-14T21:08:08,ACC00003252,Transfer,1687.67,-541526.57,EUR,Amazon
TXN0000002932,2024-07-17T14:46:20,ACC00002743,Debit,1137.79,-542664.36,JPY,Shell
TXN0000002933,2024-10-07T20:00:08,ACC00000753,Debit,1522.31,-544186.67,USD,Starbucks
TXN0000002934,2024-10-01T14:05:56,ACC00008709,Transfer,1575.57,-542611.1,USD,Restaurant
TXN0000002935,2024-03-07T05:43:25,ACC00001078,Debit,1459.89,-544070.99,USD,Shell
TXN0000002936,2024-04-02T15:56:52,ACC00006807,Credit,1553.07,-542517.92,USD,Online Store
TXN0000002937,2024-11-10T20:39:08,ACC00000361,Credit,1398.63,-541119.29,GBP,Grocery
TXN0000002938,2024-08-18T05:47:12,ACC00000613,ATM,952.94,-542072.23,JPY,Online Store
TXN0000002939,2024-07-14T05:06:26,ACC00006078,Debit,1896.78,-543969.01,GBP,Online Store
TXN0000002940,2024-11-30T12:18:37,ACC00000821,ATM,383.86,-544352.87,USD,Restaurant
TXN0000002941,2024-03-29T21:31:28,ACC00001758,Credit,145.96,-544206.91,JPY,Walmart
TXN0000002942,2024-12-12T06:46:56,ACC00008355,Payment,1326.91,-545533.82,EUR,Online Store
TXN0000002943,2024-10-13T15:02:59,ACC00008258,Debit,1683.68,-547217.5,EUR,Target
TXN0000002944,2024-09-10T22:25:25,ACC00000695,Transfer,1178.09,-546039.41,USD,Grocery
TXN0000002945,2024-06-14T04:05:13,ACC00001318,ATM,1574.8,-547614.21,GBP,Restaurant
TXN0000002946,2024-11-14T10:41:10,ACC00000136,Payment,260.66,-547874.87,GBP,Grocery
TXN0000002947,2024-01-21T14:46:28,ACC00008195,Payment,185.55,-548060.42,USD,Target
TXN0000002948,2024-04-08T13:51:24,ACC00002718,ATM,190.07,-548250.49,EUR,Restaurant
TXN0000002949,2024-06-07T13:00:16,ACC00007794,ATM,479.3,-548729.79,USD,Walmart
TXN0000002950,2024-01-01T23:33:14,ACC00005106,Debit,274.31,-549004.1,USD,Walmart
TXN0000002951,2024-06-02T16:55:50,ACC00001973,Transfer,936.33,-548067.77,EUR,Walmart
TXN0000002952,2024-07-24T16:35:28,ACC00007048,Payment,1409.96,-549477.73,EUR,Target
TXN0000002953,2024-12-15T11:52:05,ACC00008690,Transfer,934.54,-548543.19,USD,Restaurant
TXN0000002954,2024-10-26T18:32:40,ACC00000622,Payment,1699.24,-550242.43,USD,Restaurant
TXN0000002955,2024-10-15T02:08:48,ACC00003381,Credit,521.71,-549720.72,EUR,Amazon
TXN0000002956,2024-01-14T00:58:31,ACC00007261,Payment,657.65,-550378.37,USD,Target
TXN0000002957,2024-12-30T18:19:31,ACC00004520,Payment,1998.39,-552376.76,JPY,Amazon
TXN0000002958,2024-01-26T19:30:09,ACC00006946,ATM,240.61,-552617.37,EUR,Restaurant
TXN0000002959,2024-10-09T04:48:39,ACC00001897,Debit,338.59,-552955.96,JPY,Shell
TXN0000002960,2024-12-23T17:09:23,ACC00004198,Payment,1175.04,-554131.0,USD,Shell
TXN0000002961,2024-07-27T11:33:03,ACC00000660,Debit,1272.96,-555403.96,USD,Target
TXN0000002962,2024-09-25T21:01:48,ACC00000100,Debit,414.64,-555818.6,JPY,Amazon
TXN0000002963,2024-03-11T06:14:34,ACC00001405,ATM,1645.54,-557464.14,JPY,Shell
TXN0000002964,2024-11-07T20:12:05,ACC00009986,Transfer,646.1,-556818.04,GBP,Target
TXN0000002965,2024-09-25T08:35:38,ACC00001691,ATM,375.25,-557193.29,EUR,Online Store
TXN0000002966,2024-04-09T14:52:18,ACC00009340,Transfer,62.78,-557130.51,EUR,Shell
TXN0000002967,2024-01-17T01:48:55,ACC00009943,Payment,972.51,-558103.02,GBP,Target
TXN0000002968,2024-03-18T23:10:14,ACC00004130,Credit,1805.85,-556297.17,JPY,Online Store
TXN0000002969,2024-03-09T17:08:29,ACC00004175,ATM,1180.08,-557477.25,JPY,Amazon
TXN0000002970,2024-06-10T11:18:10,ACC00001991,Debit,1643.94,-559121.19,EUR,Restaurant
TXN0000002971,2024-08-18T04:43:44,ACC00001453,ATM,965.01,-560086.2,GBP,Target
TXN0000002972,2024-02-03T01:44:27,ACC00002894,Debit,848.41,-560934.61,EUR,Online Store
TXN0000002973,2024-04-23T02:34:02,ACC00003600,Credit,1945.02,-558989.59,JPY,Grocery
TXN0000002974,2024-11-09T02:40:39,ACC00003050,Credit,991.19,-557998.4,JPY,Starbucks
TXN0000002975,2024-12-20T05:13:53,ACC00006080,ATM,574.96,-558573.36,USD,Grocery
TXN0000002976,2024-11-13T12:08:07,ACC00009626,Payment,1703.94,-560277.3,EUR,Restaurant
TXN0000002977,2024-07-23T19:54:53,ACC00002194,Payment,213.76,-560491.06,USD,Restaurant
TXN0000002978,2024-07-24T05:11:05,ACC00006137,Payment,1941.76,-562432.82,EUR,Walmart
TXN0000002979,2024-08-13T12:32:29,ACC00003393,Debit,959.83,-563392.65,GBP,Online Store
TXN0000002980,2024-10-31T06:38:47,ACC00003219,Payment,363.65,-563756.3,EUR,Walmart
TXN0000002981,2024-04-21T22:05:49,ACC00006913,Credit,1698.03,-562058.27,EUR,Starbucks
TXN0000002982,2024-04-26T11:15:10,ACC00002709,Payment,1895.66,-563953.93,JPY,Shell
TXN0000002983,2024-01-07T22:25:52,ACC00006684,ATM,264.42,-564218.35,USD,Grocery
TXN0000002984,2024-05-08T04:53:45,ACC00003380,Credit,1032.77,-563185.58,JPY,Amazon
TXN0000002985,2024-02-12T15:28:58,ACC00004272,Debit,338.94,-563524.52,EUR,Shell
TXN0000002986,2024-01-13T00:49:44,ACC00001578,Credit,458.26,-563066.26,USD,Walmart
TXN0000002987,2024-02-08T01:09:08,ACC00002543,Credit,1073.74,-561992.52,USD,Walmart
TXN0000002988,2024-03-07T00:04:18,ACC00004303,Debit,1782.57,-563775.09,JPY,Amazon
TXN0000002989,2024-08-14T05:17:29,ACC00008299,Transfer,980.19,-562794.9,EUR,Grocery
TXN0000002990,2024-07-16T18:42:53,ACC00004763,Debit,631.16,-563426.06,JPY,Target
TXN0000002991,2024-11-23T14:12:05,ACC00008548,Transfer,1689.45,-561736.61,USD,Amazon
TXN0000002992,2024-05-12T11:21:42,ACC00009089,ATM,180.83,-561917.44,GBP,Online Store
TXN0000002993,2024-07-07T08:05:03,ACC00004436,Payment,206.1,-562123.54,EUR,Online Store
TXN0000002994,2024-10-02T21:16:05,ACC00004819,Debit,66.36,-562189.9,EUR,Shell
TXN0000002995,2024-08-14T15:44:12,ACC00003445,Debit,902.85,-563092.75,USD,Starbucks
TXN0000002996,2024-02-08T20:12:00,ACC00007851,Credit,144.09,-562948.66,JPY,Grocery
TXN0000002997,2024-08-21T20:52:21,ACC00006469,Credit,828.89,-562119.77,GBP,Target
TXN0000002998,2024-11-23T08:57:09,ACC00003265,Credit,1658.14,-560461.63,GBP,Starbucks
TXN0000002999,2024-06-17T12:36:15,ACC00002527,Payment,702.34,-561163.97,USD,Restaurant
TXN0000003000,2024-04-11T18:47:30,ACC00006468,Transfer,1187.86,-559976.11,JPY,Grocery
TXN0000003001,2024-02-16T16:09:38,ACC00009719,Transfer,1178.67,-558797.44,JPY,Shell
TXN0000003002,2024-12-21T04:25:51,ACC00007163,Transfer,634.05,-558163.39,USD,Target
TXN0000003003,2024-07-25T18:27:37,ACC00000137,Payment,816.19,-558979.58,USD,Amazon
TXN0000003004,2024-11-03T14:56:40,ACC00009355,Payment,593.14,-559572.72,GBP,Starbucks
TXN0000003005,2024-05-13T17:50:14,ACC00004221,Transfer,943.39,-558629.33,USD,Restaurant
TXN0000003006,2024-01-20T01:36:03,ACC00008075,ATM,1279.8,-559909.13,GBP,Online Store
TXN0000003007,2024-10-27T00:20:31,ACC00002528,Credit,61.01,-559848.12,GBP,Walmart
TXN0000003008,2024-01-13T14:27:40,ACC00004672,Transfer,1322.85,-558525.27,USD,Amazon
TXN0000003009,2024-11-20T18:04:39,ACC00003037,Transfer,1325.3,-557199.97,USD,Walmart
TXN0000003010,2024-11-03T03:39:29,ACC00005239,Payment,1690.29,-558890.26,EUR,Grocery
TXN0000003011,2024-03-19T03:41:22,ACC00001654,Credit,363.2,-558527.06,EUR,Online Store
TXN0000003012,2024-03-24T13:52:13,ACC00007188,Credit,911.47,-557615.59,EUR,Starbucks
TXN0000003013,2024-10-02T16:21:00,ACC00007406,Payment,106.5,-557722.09,USD,Target
TXN0000003014,2024-02-24T10:48:26,ACC00000788,Transfer,1778.34,-555943.75,JPY,Restaurant
TXN0000003015,2024-05-26T22:42:16,ACC00007925,ATM,174.11,-556117.86,JPY,Walmart
TXN0000003016,2024-11-10T23:05:46,ACC00008601,Payment,666.72,-556784.58,EUR,Starbucks
TXN0000003017,2024-06-08T16:22:44,ACC00009758,Payment,1018.7,-557803.28,JPY,Shell
TXN0000003018,2024-03-07T23:08:55,ACC00004115,Debit,880.71,-558683.99,GBP,Target
TXN0000003019,2024-08-05T22:41:46,ACC00005730,Transfer,564.1,-558119.89,GBP,Amazon
TXN0000003020,2024-09-17T21:30:10,ACC00002518,Transfer,1972.71,-556147.18,USD,Target
TXN0000003021,2024-03-07T16:21:54,ACC00005102,Payment,1422.64,-557569.82,USD,Target
TXN0000003022,2024-10-20T04:17:05,ACC00008951,Debit,1547.66,-559117.48,USD,Walmart
TXN0000003023,2024-06-29T17:19:29,ACC00006462,Transfer,712.46,-558405.02,USD,Shell
TXN0000003024,2024-12-04T19:24:57,ACC00000935,Debit,1553.31,-559958.33,JPY,Walmart
TXN0000003025,2024-09-19T17:18:40,ACC00005169,Transfer,688.43,-559269.9,JPY,Walmart
TXN0000003026,2024-06-21T04:40:04,ACC00006690,Credit,1156.4,-558113.5,JPY,Online Store
TXN0000003027,2024-02-23T05:16:35,ACC00004283,Credit,1520.86,-556592.64,EUR,Starbucks
TXN0000003028,2024-11-14T06:39:31,ACC00001806,Credit,132.45,-556460.19,EUR,Online Store
TXN0000003029,2024-05-04T21:28:14,ACC00007920,Credit,352.17,-556108.02,USD,Shell
TXN0000003030,2024-03-18T12:10:57,ACC00003064,ATM,887.97,-556995.99,EUR,Target
TXN0000003031,2024-09-21T16:12:38,ACC00002570,Debit,875.83,-557871.82,GBP,Starbucks
TXN0000003032,2024-03-03T12:41:39,ACC00005527,Credit,393.36,-557478.46,EUR,Shell
TXN0000003033,2024-11-30T21:11:17,ACC00009691,Credit,1915.19,-555563.27,EUR,Grocery
TXN0000003034,2024-01-09T08:50:33,ACC00000760,Transfer,1869.09,-553694.18,GBP,Target
TXN0000003035,2024-09-13T07:52:51,ACC00004872,ATM,1934.74,-555628.92,EUR,Target
TXN0000003036,2024-06-27T21:07:06,ACC00001982,Transfer,433.51,-555195.41,GBP,Shell
TXN0000003037,2024-05-22T13:10:47,ACC00005582,Debit,1718.06,-556913.47,JPY,Shell
TXN0000003038,2024-05-04T23:58:26,ACC00009962,Debit,827.32,-557740.79,EUR,Restaurant
TXN0000003039,2024-12-25T00:48:42,ACC00007622,Credit,596.02,-557144.77,EUR,Restaurant
TXN0000003040,2024-07-01T02:47:03,ACC00007487,Payment,1708.83,-558853.6,JPY,Online Store
TXN0000003041,2024-04-09T20:36:11,ACC00005315,ATM,1855.32,-560708.92,JPY,Amazon
TXN0000003042,2024-06-24T06:16:13,ACC00002763,ATM,1427.39,-562136.31,USD,Starbucks
TXN0000003043,2024-02-08T10:14:16,ACC00009386,Debit,1193.9,-563330.21,USD,Restaurant
TXN0000003044,2024-06-02T01:35:43,ACC00007333,ATM,580.59,-563910.8,JPY,Amazon
TXN0000003045,2024-05-04T00:24:01,ACC00002500,Payment,1811.17,-565721.97,EUR,Shell
TXN0000003046,2024-10-14T13:26:13,ACC00001837,Payment,366.01,-566087.98,GBP,Online Store
TXN0000003047,2024-07-15T23:45:29,ACC00009762,Credit,1900.68,-564187.3,JPY,Target
TXN0000003048,2024-01-30T07:39:30,ACC00001616,ATM,1166.81,-565354.11,JPY,Restaurant
TXN0000003049,2024-07-20T23:14:26,ACC00009144,ATM,97.5,-565451.61,GBP,Target
TXN0000003050,2024-04-25T03:06:09,ACC00007737,Debit,993.88,-566445.49,EUR,Amazon
TXN0000003051,2024-04-21T07:20:35,ACC00007896,Debit,270.22,-566715.71,USD,Starbucks
TXN0000003052,2024-09-05T05:11:52,ACC00003473,Credit,416.12,-566299.59,GBP,Walmart
TXN0000003053,2024-05-08T10:52:40,ACC00000703,ATM,1067.13,-567366.72,JPY,Online Store
TXN0000003054,2024-01-17T00:56:27,ACC00004980,Payment,1294.62,-568661.34,EUR,Walmart
TXN0000003055,2024-04-23T20:49:39,ACC00009893,Transfer,893.25,-567768.09,EUR,Starbucks
TXN0000003056,2024-06-12T15:31:12,ACC00004092,Credit,23.56,-567744.53,GBP,Online Store
TXN0000003057,2024-07-13T14:07:35,ACC00007558,Debit,1859.71,-569604.24,GBP,Target
TXN0000003058,2024-08-08T19:05:16,ACC00000440,Transfer,578.71,-569025.53,JPY,Grocery
TXN0000003059,2024-09-12T06:30:35,ACC00005248,Payment,1781.22,-570806.75,EUR,Walmart
TXN0000003060,2024-02-07T10:07:39,ACC00003251,Credit,268.17,-570538.58,GBP,Online Store
TXN0000003061,2024-05-09T01:43:55,ACC00001449,Credit,1567.13,-568971.45,USD,Restaurant
TXN0000003062,2024-01-21T05:45:50,ACC00001300,Payment,745.69,-569717.14,EUR,Restaurant
TXN0000003063,2024-07-23T12:36:17,ACC00005946,Payment,1506.61,-571223.75,USD,Target
TXN0000003064,2024-08-19T03:09:05,ACC00003892,Credit,89.42,-571134.33,JPY,Starbucks
TXN0000003065,2024-07-19T18:59:19,ACC00006521,ATM,1454.53,-572588.86,JPY,Target
TXN0000003066,2024-01-21T08:19:40,ACC00004090,Transfer,1261.58,-571327.28,USD,Walmart
TXN0000003067,2024-10-09T22:01:00,ACC00008038,Debit,1638.75,-572966.03,EUR,Walmart
TXN0000003068,2024-09-17T21:43:27,ACC00004452,ATM,1337.86,-574303.89,USD,Shell
TXN0000003069,2024-09-21T01:06:54,ACC00006718,Credit,1159.13,-573144.76,JPY,Starbucks
TXN0000003070,2024-08-05T07:52:05,ACC00003742,Credit,1406.17,-571738.59,JPY,Restaurant
TXN0000003071,2024-04-09T22:39:15,ACC00009859,Credit,791.91,-570946.68,USD,Amazon
TXN0000003072,2024-10-30T12:17:57,ACC00002794,ATM,1495.46,-572442.14,USD,Online Store
TXN0000003073,2024-07-12T06:51:50,ACC00007111,Debit,1019.46,-573461.6,EUR,Target
TXN0000003074,2024-03-13T08:56:43,ACC00002122,Credit,463.28,-572998.32,JPY,Walmart
TXN0000003075,2024-12-21T09:22:15,ACC00006604,Transfer,182.14,-572816.18,JPY,Online Store
TXN0000003076,2024-06-30T04:03:31,ACC00006236,Credit,1234.08,-571582.1,JPY,Walmart
TXN0000003077,2024-02-11T05:13:25,ACC00008216,Transfer,520.82,-571061.28,USD,Amazon
TXN0000003078,2024-08-28T11:38:19,ACC00000336,Payment,393.15,-571454.43,GBP,Shell
TXN0000003079,2024-08-30T10:47:30,ACC00005570,Payment,1930.51,-573384.94,USD,Target
TXN0000003080,2024-11-13T05:24:38,ACC00001365,Payment,1130.12,-574515.06,EUR,Grocery
TXN0000003081,2024-12-24T03:58:35,ACC00001967,ATM,175.55,-574690.61,EUR,Grocery
TXN0000003082,2024-04-27T06:06:51,ACC00009312,Debit,1083.1,-575773.71,EUR,Online Store
TXN0000003083,2024-05-25T03:31:15,ACC00000515,Transfer,895.76,-574877.95,EUR,Starbucks
TXN0000003084,2024-12-06T17:37:21,ACC00000877,Debit,789.78,-575667.73,EUR,Grocery
TXN0000003085,2024-11-19T18:57:37,ACC00002626,Transfer,119.13,-575548.6,EUR,Amazon
TXN0000003086,2024-11-15T06:11:09,ACC00006944,Transfer,1974.45,-573574.15,GBP,Amazon
TXN0000003087,2024-01-09T11:56:00,ACC00004074,Transfer,1216.62,-572357.53,EUR,Online Store
TXN0000003088,2024-09-21T01:18:51,ACC00003991,Payment,1619.74,-573977.27,USD,Amazon
TXN0000003089,2024-12-17T18:45:27,ACC00006799,Debit,1664.64,-575641.91,GBP,Grocery
TXN0000003090,2024-10-07T02:31:42,ACC00006315,ATM,965.14,-576607.05,JPY,Amazon
TXN0000003091,2024-03-14T05:11:42,ACC00006060,Payment,251.17,-576858.22,USD,Starbucks
TXN0000003092,2024-05-14T10:26:34,ACC00004265,Transfer,1076.08,-575782.14,EUR,Grocery
TXN0000003093,2024-01-07T14:44:42,ACC00009944,ATM,1374.44,-577156.58,GBP,Restaurant
TXN0000003094,2024-03-05T18:15:29,ACC00003459,ATM,870.41,-578026.99,USD,Amazon
TXN0000003095,2024-04-24T14:48:50,ACC00005011,Credit,1880.98,-576146.01,GBP,Walmart
TXN0000003096,2024-08-14T22:45:38,ACC00007526,Credit,211.04,-575934.97,EUR,Amazon
TXN0000003097,2024-01-27T05:00:30,ACC00004931,Payment,281.49,-576216.46,EUR,Target
TXN0000003098,2024-02-26T09:15:35,ACC00007424,Credit,1933.59,-574282.87,USD,Amazon
TXN0000003099,2024-07-04T20:34:06,ACC00004514,Credit,1916.31,-572366.56,JPY,Starbucks
TXN0000003100,2024-10-31T14:42:59,ACC00007514,ATM,864.2,-573230.76,GBP,Starbucks
TXN0000003101,2024-08-30T17:02:34,ACC00005134,Payment,512.23,-573742.99,USD,Grocery
TXN0000003102,2024-11-04T03:21:51,ACC00000891,Credit,1776.72,-571966.27,JPY,Online Store
TXN0000003103,2024-07-31T06:01:42,ACC00007977,Payment,1332.63,-573298.9,USD,Walmart
TXN0000003104,2024-06-18T13:09:55,ACC00003400,Credit,1555.66,-571743.24,GBP,Grocery
TXN0000003105,2024-06-04T02:45:42,ACC00000107,Credit,218.38,-571524.86,JPY,Grocery
TXN0000003106,2024-09-19T15:57:08,ACC00001939,Transfer,322.42,-571202.44,USD,Amazon
TXN0000003107,2024-04-25T03:21:15,ACC00004729,ATM,826.11,-572028.55,JPY,Online Store
TXN0000003108,2024-12-24T09:20:07,ACC00004095,Debit,928.15,-572956.7,JPY,Walmart
TXN0000003109,2024-12-09T11:36:15,ACC00006570,Transfer,466.67,-572490.03,GBP,Online Store
TXN0000003110,2024-11-05T11:16:23,ACC00002148,Debit,1035.37,-573525.4,EUR,Shell
TXN0000003111,2024-07-05T23:27:00,ACC00000948,ATM,627.86,-574153.26,GBP,Online Store
TXN0000003112,2024-07-02T15:42:48,ACC00008724,Debit,1545.84,-575699.1,GBP,Amazon
TXN0000003113,2024-11-10T03:33:51,ACC00008186,Transfer,227.6,-575471.5,EUR,Amazon
TXN0000003114,2024-12-14T04:41:17,ACC00000110,ATM,1265.85,-576737.35,EUR,Grocery
TXN0000003115,2024-10-12T20:29:28,ACC00002783,Credit,1185.11,-575552.24,JPY,Online Store
TXN0000003116,2024-05-16T16:04:55,ACC00006952,Transfer,369.9,-575182.34,USD,Target
TXN0000003117,2024-02-01T23:22:38,ACC00000553,Credit,427.26,-574755.08,GBP,Target
TXN0000003118,2024-07-19T05:50:19,ACC00000433,Debit,1608.86,-576363.94,JPY,Shell
TXN0000003119,2024-04-13T08:05:20,ACC00008993,Payment,150.1,-576514.04,GBP,Starbucks
TXN0000003120,2024-09-24T03:50:41,ACC00000164,Transfer,86.98,-576427.06,GBP,Grocery
TXN0000003121,2024-12-06T09:17:33,ACC00000001,Payment,1474.52,-577901.58,GBP,Target
TXN0000003122,2024-05-18T22:45:41,ACC00001021,Debit,144.91,-578046.49,EUR,Grocery
TXN0000003123,2024-06-14T01:28:19,ACC00005598,Credit,983.38,-577063.11,EUR,Online Store
TXN0000003124,2024-02-16T12:23:40,ACC00007251,Credit,1334.42,-575728.69,JPY,Amazon
TXN0000003125,2024-01-26T15:45:55,ACC00002471,Payment,197.25,-575925.94,USD,Restaurant
TXN0000003126,2024-11-19T01:42:33,ACC00005713,Debit,1381.49,-577307.43,EUR,Walmart
TXN0000003127,2024-07-08T23:25:44,ACC00008652,Credit,805.67,-576501.76,EUR,Target
TXN0000003128,2024-09-09T03:11:39,ACC00008575,ATM,1122.85,-577624.61,GBP,Starbucks
TXN0000003129,2024-03-10T08:20:46,ACC00003197,Credit,714.71,-576909.9,USD,Grocery
TXN0000003130,2024-12-25T23:01:29,ACC00003339,Debit,1995.81,-578905.71,EUR,Amazon
TXN0000003131,2024-03-21T10:29:41,ACC00003329,ATM,349.52,-579255.23,EUR,Starbucks
TXN0000003132,2024-01-14T07:38:35,ACC00001485,Payment,1932.49,-581187.72,EUR,Target
TXN0000003133,2024-07-21T18:26:40,ACC00009593,Transfer,1266.73,-579920.99,JPY,Online Store
TXN0000003134,2024-07-01T11:17:44,ACC00002492,Transfer,425.72,-579495.27,JPY,Shell
TXN0000003135,2024-07-10T13:32:12,ACC00007383,Credit,599.7,-578895.57,USD,Shell
TXN0000003136,2024-03-25T06:37:08,ACC00001571,Transfer,580.01,-578315.56,JPY,Walmart
TXN0000003137,2024-01-02T01:27:40,ACC00001814,Payment,1502.5,-579818.06,JPY,Online Store
TXN0000003138,2024-07-03T12:44:24,ACC00001007,ATM,1524.79,-581342.85,JPY,Target
TXN0000003139,2024-03-28T09:17:58,ACC00009375,Credit,1086.9,-580255.95,JPY,Starbucks
TXN0000003140,2024-05-09T09:20:38,ACC00005954,Payment,929.6,-581185.55,EUR,Online Store
TXN0000003141,2024-05-16T17:00:12,ACC00004153,Transfer,1558.0,-579627.55,EUR,Target
TXN0000003142,2024-09-25T08:06:43,ACC00002344,Credit,832.42,-578795.13,EUR,Grocery
TXN0000003143,2024-10-22T01:32:55,ACC00000932,Payment,1481.55,-580276.68,JPY,Online Store
TXN0000003144,2024-10-02T07:04:16,ACC00009122,Debit,507.32,-580784.0,EUR,Restaurant
TXN0000003145,2024-02-21T16:20:15,ACC00009568,Payment,50.89,-580834.89,JPY,Amazon
TXN0000003146,2024-08-13T03:07:16,ACC00005234,ATM,943.82,-581778.71,USD,Amazon
TXN0000003147,2024-07-26T01:11:12,ACC00009940,Debit,1403.2,-583181.91,USD,Shell
TXN0000003148,2024-08-13T18:08:07,ACC00008891,Credit,1539.34,-581642.57,JPY,Restaurant
TXN0000003149,2024-08-07T08:04:06,ACC00008073,Payment,986.33,-582628.9,USD,Starbucks
TXN0000003150,2024-07-13T06:40:41,ACC00007011,Transfer,1151.0,-581477.9,EUR,Grocery
TXN0000003151,2024-04-27T20:41:41,ACC00008380,Credit,433.84,-581044.06,JPY,Online Store
TXN0000003152,2024-05-10T23:31:48,ACC00009294,ATM,177.68,-581221.74,GBP,Grocery
TXN0000003153,2024-07-06T03:56:17,ACC00009436,Payment,149.27,-581371.01,USD,Amazon
TXN0000003154,2024-03-07T21:25:33,ACC00007852,Debit,205.08,-581576.09,GBP,Walmart
TXN0000003155,2024-09-29T14:52:16,ACC00008384,ATM,348.05,-581924.14,GBP,Starbucks
TXN0000003156,2024-07-11T19:29:12,ACC00008475,Credit,1737.04,-580187.1,GBP,Shell
TXN0000003157,2024-02-08T08:07:40,ACC00009442,Debit,1146.58,-581333.68,JPY,Grocery
TXN0000003158,2024-07-20T13:06:17,ACC00004604,Debit,1275.82,-582609.5,USD,Amazon
TXN0000003159,2024-12-03T05:24:45,ACC00005731,ATM,674.81,-583284.31,JPY,Grocery
TXN0000003160,2024-08-11T23:41:26,ACC00002025,Transfer,469.73,-582814.58,EUR,Starbucks
TXN0000003161,2024-07-31T20:20:23,ACC00000188,Transfer,769.11,-582045.47,GBP,Shell
TXN0000003162,2024-06-22T14:53:12,ACC00009458,Transfer,1040.7,-581004.77,JPY,Amazon
TXN0000003163,2024-07-02T11:30:48,ACC00001382,ATM,1929.25,-582934.02,GBP,Grocery
TXN0000003164,2024-07-11T22:32:10,ACC00002150,Credit,527.74,-582406.28,USD,Target
TXN0000003165,2024-12-08T17:02:06,ACC00003455,Credit,1088.47,-581317.81,EUR,Amazon
TXN0000003166,2024-06-14T03:08:17,ACC00000769,ATM,783.69,-582101.5,JPY,Restaurant
TXN0000003167,2024-08-19T14:28:44,ACC00001452,Transfer,910.29,-581191.21,USD,Walmart
TXN0000003168,2024-09-21T06:40:23,ACC00003238,Credit,44.0,-581147.21,GBP,Starbucks
TXN0000003169,2024-08-14T00:33:43,ACC00008211,Transfer,344.51,-580802.7,USD,Grocery
TXN0000003170,2024-01-31T03:43:24,ACC00005604,Payment,1376.55,-582179.25,EUR,Shell
TXN0000003171,2024-09-13T16:56:57,ACC00001634,Transfer,717.89,-581461.36,EUR,Shell
TXN0000003172,2024-08-31T21:35:30,ACC00004960,Credit,396.61,-581064.75,EUR,Target
TXN0000003173,2024-03-13T23:42:39,ACC00002106,Payment,1966.06,-583030.81,EUR,Restaurant
TXN0000003174,2024-08-24T04:47:01,ACC00006131,Credit,1891.69,-581139.12,GBP,Grocery
TXN0000003175,2024-04-18T01:22:20,ACC00004184,Transfer,1153.48,-579985.64,USD,Shell
TXN0000003176,2024-03-23T16:32:17,ACC00000199,Credit,1642.9,-578342.74,GBP,Amazon
TXN0000003177,2024-02-20T02:50:58,ACC00005697,Debit,1166.97,-579509.71,EUR,Online Store
TXN0000003178,2024-09-06T13:30:12,ACC00001789,ATM,617.46,-580127.17,JPY,Shell
TXN0000003179,2024-09-28T04:45:55,ACC00003696,Payment,352.2,-580479.37,GBP,Starbucks
TXN0000003180,2024-01-17T21:39:36,ACC00003534,Credit,755.11,-579724.26,USD,Target
TXN0000003181,2024-11-24T23:10:19,ACC00008459,Debit,73.47,-579797.73,EUR,Walmart
TXN0000003182,2024-07-10T03:55:59,ACC00004619,ATM,1768.1,-581565.83,JPY,Grocery
TXN0000003183,2024-03-28T13:54:09,ACC00004135,Transfer,1021.07,-580544.76,EUR,Online Store
TXN0000003184,2024-12-24T04:21:54,ACC00006545,Credit,59.26,-580485.5,JPY,Shell
TXN0000003185,2024-06-14T04:26:52,ACC00002287,Credit,1884.61,-578600.89,USD,Grocery
TXN0000003186,2024-06-14T15:58:41,ACC00008662,Payment,651.18,-579252.07,EUR,Grocery
TXN0000003187,2024-04-14T16:34:10,ACC00000386,Payment,191.73,-579443.8,GBP,Online Store
TXN0000003188,2024-04-11T18:38:00,ACC00009108,Debit,1952.12,-581395.92,USD,Shell
TXN0000003189,2024-11-26T13:52:00,ACC00009463,Credit,997.49,-580398.43,JPY,Walmart
TXN0000003190,2024-05-03T12:33:37,ACC00003640,ATM,498.09,-580896.52,GBP,Shell
TXN0000003191,2024-05-29T20:45:41,ACC00006332,Debit,378.04,-581274.56,GBP,Online Store
TXN0000003192,2024-08-13T08:13:26,ACC00001701,Transfer,1215.65,-580058.91,JPY,Starbucks
TXN0000003193,2024-04-04T17:47:14,ACC00007152,ATM,1867.17,-581926.08,GBP,Shell
TXN0000003194,2024-03-30T03:04:30,ACC00001447,Transfer,677.63,-581248.45,USD,Amazon
TXN0000003195,2024-06-05T13:32:03,ACC00004957,Debit,1721.86,-582970.31,JPY,Target
TXN0000003196,2024-10-20T11:34:41,ACC00008522,ATM,287.98,-583258.29,JPY,Grocery
TXN0000003197,2024-06-03T17:35:42,ACC00003675,Transfer,1475.06,-581783.23,GBP,Shell
TXN0000003198,2024-06-02T11:18:40,ACC00004227,Payment,1924.24,-583707.47,JPY,Shell
TXN0000003199,2024-10-25T22:30:48,ACC00001760,ATM,1683.07,-585390.54,USD,Restaurant
TXN0000003200,2024-09-05T14:27:07,ACC00008293,ATM,20.27,-585410.81,EUR,Online Store
TXN0000003201,2024-12-28T04:08:07,ACC00004066,Transfer,1612.21,-583798.6,GBP,Restaurant
TXN0000003202,2024-01-01T15:22:04,ACC00002762,Debit,1788.07,-585586.67,EUR,Walmart
TXN0000003203,2024-08-01T19:32:59,ACC00002668,Credit,1887.12,-583699.55,JPY,Online Store
TXN0000003204,2024-08-18T09:27:18,ACC00003138,Debit,532.8,-584232.35,JPY,Amazon
TXN0000003205,2024-08-19T18:22:53,ACC00009833,Credit,1299.19,-582933.16,JPY,Starbucks
TXN0000003206,2024-03-06T05:38:27,ACC00000381,Transfer,889.54,-582043.62,EUR,Target
TXN0000003207,2024-03-13T19:31:08,ACC00006044,Payment,1383.53,-583427.15,USD,Online Store
TXN0000003208,2024-10-07T03:57:35,ACC00003547,Debit,108.93,-583536.08,GBP,Amazon
TXN0000003209,2024-12-16T06:58:25,ACC00006550,ATM,1706.08,-585242.16,JPY,Starbucks
TXN0000003210,2024-04-26T22:47:25,ACC00006929,Credit,448.45,-584793.71,GBP,Online Store
TXN0000003211,2024-11-12T18:09:30,ACC00003910,ATM,1867.98,-586661.69,JPY,Restaurant
TXN0000003212,2024-11-17T07:16:36,ACC00006050,Debit,357.45,-587019.14,GBP,Grocery
TXN0000003213,2024-03-10T10:50:28,ACC00003227,Payment,640.06,-587659.2,EUR,Starbucks
TXN0000003214,2024-12-03T01:06:59,ACC00000989,Transfer,251.19,-587408.01,GBP,Amazon
TXN0000003215,2024-12-16T20:32:22,ACC00004127,Transfer,1232.27,-586175.74,EUR,Grocery
TXN0000003216,2024-12-29T21:09:38,ACC00001122,Debit,978.06,-587153.8,EUR,Online Store
TXN0000003217,2024-02-16T05:40:47,ACC00002968,Credit,1259.87,-585893.93,GBP,Walmart
TXN0000003218,2024-03-19T19:10:41,ACC00001183,Debit,991.52,-586885.45,JPY,Restaurant
TXN0000003219,2024-11-21T19:56:56,ACC00002510,ATM,284.69,-587170.14,USD,Amazon
TXN0000003220,2024-04-19T05:31:54,ACC00009945,Credit,1614.8,-585555.34,JPY,Grocery
TXN0000003221,2024-06-21T11:52:45,ACC00000776,ATM,153.06,-585708.4,GBP,Grocery
TXN0000003222,2024-12-23T14:01:51,ACC00005113,Payment,704.18,-586412.58,EUR,Amazon
TXN0000003223,2024-01-26T19:29:15,ACC00008870,Transfer,1095.51,-585317.07,EUR,Starbucks
TXN0000003224,2024-04-16T09:58:22,ACC00008693,Debit,1583.08,-586900.15,JPY,Online Store
TXN0000003225,2024-06-22T03:32:50,ACC00000428,ATM,466.74,-587366.89,GBP,Walmart
TXN0000003226,2024-03-11T03:48:37,ACC00002172,Payment,237.3,-587604.19,USD,Online Store
TXN0000003227,2024-06-27T05:45:43,ACC00005260,Transfer,291.58,-587312.61,EUR,Walmart
TXN0000003228,2024-08-26T06:25:01,ACC00006770,Credit,265.04,-587047.57,USD,Grocery
TXN0000003229,2024-12-05T08:00:53,ACC00006628,Credit,318.71,-586728.86,GBP,Starbucks
TXN0000003230,2024-08-11T01:22:07,ACC00001642,Payment,1879.12,-588607.98,USD,Starbucks
TXN0000003231,2024-03-09T08:28:50,ACC00002444,Debit,694.71,-589302.69,USD,Restaurant
TXN0000003232,2024-10-30T09:32:54,ACC00001336,Debit,245.99,-589548.68,GBP,Amazon
TXN0000003233,2024-10-27T21:53:20,ACC00001119,ATM,1295.3,-590843.98,GBP,Target
TXN0000003234,2024-06-27T11:13:51,ACC00006442,ATM,680.18,-591524.16,GBP,Shell
TXN0000003235,2024-02-04T17:39:21,ACC00001122,Credit,708.85,-590815.31,EUR,Walmart
TXN0000003236,2024-10-12T16:12:45,ACC00007445,ATM,1526.17,-592341.48,EUR,Walmart
TXN0000003237,2024-11-27T23:22:33,ACC00001655,Debit,1768.93,-594110.41,JPY,Online Store
TXN0000003238,2024-05-19T00:42:16,ACC00006190,Credit,356.84,-593753.57,USD,Restaurant
TXN0000003239,2024-06-16T20:02:57,ACC00004376,Transfer,252.28,-593501.29,GBP,Amazon
TXN0000003240,2024-07-25T11:00:59,ACC00004912,Payment,501.67,-594002.96,GBP,Grocery
TXN0000003241,2024-03-01T01:10:21,ACC00006375,Debit,1492.32,-595495.28,EUR,Grocery
TXN0000003242,2024-02-21T14:37:58,ACC00000926,Transfer,1866.16,-593629.12,EUR,Shell
TXN0000003243,2024-06-04T16:54:33,ACC00007351,Transfer,148.84,-593480.28,JPY,Restaurant
TXN0000003244,2024-10-17T08:03:05,ACC00009624,Debit,1811.67,-595291.95,GBP,Walmart
TXN0000003245,2024-12-06T23:39:24,ACC00005173,Transfer,397.6,-594894.35,GBP,Amazon
TXN0000003246,2024-07-21T11:42:31,ACC00006831,Debit,1892.59,-596786.94,EUR,Shell
TXN0000003247,2024-02-20T05:01:19,ACC00001908,Credit,741.13,-596045.81,GBP,Starbucks
TXN0000003248,2024-07-23T14:44:18,ACC00008941,ATM,1753.43,-597799.24,JPY,Amazon
TXN0000003249,2024-04-21T09:29:41,ACC00004145,Payment,1791.81,-599591.05,GBP,Walmart
TXN0000003250,2024-01-20T22:49:18,ACC00003096,Payment,55.54,-599646.59,JPY,Online Store
TXN0000003251,2024-10-27T16:12:47,ACC00003542,Credit,484.96,-599161.63,USD,Grocery
TXN0000003252,2024-06-26T19:28:09,ACC00005588,Transfer,342.55,-598819.08,JPY,Restaurant
TXN0000003253,2024-05-29T18:49:07,ACC00001399,Payment,1744.77,-600563.85,USD,Target
TXN0000003254,2024-10-12T06:38:35,ACC00007612,Debit,1755.65,-602319.5,JPY,Restaurant
TXN0000003255,2024-11-30T23:46:03,ACC00006633,Payment,957.06,-603276.56,GBP,Restaurant
TXN0000003256,2024-03-21T00:10:39,ACC00000630,Debit,332.14,-603608.7,EUR,Walmart
TXN0000003257,2024-09-16T02:31:01,ACC00003920,Transfer,388.17,-603220.53,GBP,Starbucks
TXN0000003258,2024-03-07T17:28:41,ACC00000120,Debit,1130.83,-604351.36,JPY,Grocery
TXN0000003259,2024-09-16T16:17:27,ACC00000790,Transfer,1477.42,-602873.94,GBP,Online Store
TXN0000003260,2024-11-15T00:59:51,ACC00006897,Credit,1129.77,-601744.17,JPY,Walmart
TXN0000003261,2024-02-28T07:51:51,ACC00006112,Transfer,1741.22,-600002.95,GBP,Amazon
TXN0000003262,2024-12-10T14:11:57,ACC00009446,ATM,514.23,-600517.18,USD,Target
TXN0000003263,2024-02-20T12:32:47,ACC00000261,ATM,1945.94,-602463.12,USD,Amazon
TXN0000003264,2024-01-16T07:09:11,ACC00009487,Credit,1968.69,-600494.43,USD,Amazon
TXN0000003265,2024-11-20T00:35:03,ACC00007970,ATM,619.3,-601113.73,GBP,Target
TXN0000003266,2024-08-30T23:46:37,ACC00007793,Credit,1248.82,-599864.91,JPY,Walmart
TXN0000003267,2024-07-13T00:19:34,ACC00007895,ATM,58.94,-599923.85,EUR,Shell
TXN0000003268,2024-03-27T00:50:37,ACC00008448,ATM,1835.26,-601759.11,EUR,Grocery
TXN0000003269,2024-06-11T19:59:21,ACC00000759,Credit,529.18,-601229.93,JPY,Grocery
TXN0000003270,2024-09-26T12:02:18,ACC00009682,ATM,40.67,-601270.6,JPY,Starbucks
TXN0000003271,2024-02-01T15:05:46,ACC00006248,Credit,371.78,-600898.82,JPY,Starbucks
TXN0000003272,2024-12-12T11:07:47,ACC00006113,Credit,218.37,-600680.45,GBP,Grocery
TXN0000003273,2024-08-13T10:13:55,ACC00004911,Payment,1010.16,-601690.61,EUR,Online Store
TXN0000003274,2024-07-22T21:33:22,ACC00004570,Credit,1382.03,-600308.58,EUR,Amazon
TXN0000003275,2024-06-01T03:24:54,ACC00006495,Payment,694.77,-601003.35,JPY,Walmart
TXN0000003276,2024-11-07T14:47:13,ACC00000790,Transfer,1134.32,-599869.03,EUR,Shell
TXN0000003277,2024-06-17T10:32:32,ACC00006184,Payment,1748.3,-601617.33,USD,Restaurant
TXN0000003278,2024-12-16T01:49:13,ACC00008649,Debit,12.24,-601629.57,USD,Target
TXN0000003279,2024-12-13T15:01:16,ACC00004318,Debit,1586.32,-603215.89,USD,Online Store
TXN0000003280,2024-03-03T05:06:10,ACC00004789,Debit,1461.11,-604677.0,JPY,Restaurant
TXN0000003281,2024-06-15T09:08:52,ACC00009792,Credit,1864.33,-602812.67,JPY,Walmart
TXN0000003282,2024-06-04T10:37:37,ACC00008296,Debit,386.43,-603199.1,JPY,Grocery
TXN0000003283,2024-01-01T06:10:35,ACC00004061,Debit,21.44,-603220.54,EUR,Restaurant
TXN0000003284,2024-04-16T21:10:44,ACC00007966,Credit,622.76,-602597.78,GBP,Starbucks
TXN0000003285,2024-03-07T06:54:38,ACC00006999,Credit,248.57,-602349.21,USD,Shell
TXN0000003286,2024-12-06T01:30:21,ACC00004140,ATM,1846.12,-604195.33,EUR,Restaurant
TXN0000003287,2024-09-23T09:46:19,ACC00008503,Payment,887.96,-605083.29,EUR,Starbucks
TXN0000003288,2024-01-12T06:34:33,ACC00008448,Credit,1458.8,-603624.49,EUR,Shell
TXN0000003289,2024-07-06T11:05:01,ACC00000946,Credit,1457.63,-602166.86,GBP,Target
TXN0000003290,2024-08-21T16:54:09,ACC00004804,Credit,135.15,-602031.71,EUR,Shell
TXN0000003291,2024-03-28T04:18:09,ACC00004206,Payment,484.09,-602515.8,USD,Grocery
TXN0000003292,2024-08-22T12:47:25,ACC00007120,Transfer,304.63,-602211.17,GBP,Walmart
TXN0000003293,2024-10-05T13:55:27,ACC00007853,ATM,22.42,-602233.59,GBP,Grocery
TXN0000003294,2024-12-14T11:14:13,ACC00003106,ATM,1629.23,-603862.82,USD,Target
TXN0000003295,2024-08-16T21:19:22,ACC00009260,Transfer,1439.52,-602423.3,EUR,Grocery
TXN0000003296,2024-10-29T04:23:39,ACC00004474,Transfer,1997.07,-600426.23,GBP,Amazon
TXN0000003297,2024-07-08T10:52:34,ACC00007549,Credit,1273.39,-599152.84,EUR,Starbucks
TXN0000003298,2024-02-05T03:21:01,ACC00009812,Transfer,435.75,-598717.09,JPY,Online Store
TXN0000003299,2024-10-20T22:40:50,ACC00001551,Payment,1267.92,-599985.01,USD,Starbucks
TXN0000003300,2024-02-05T17:42:18,ACC00001522,Payment,741.1,-600726.11,JPY,Online Store
TXN0000003301,2024-12-05T12:59:40,ACC00004368,Credit,85.39,-600640.72,GBP,Grocery
TXN0000003302,2024-08-29T20:55:02,ACC00002133,ATM,263.78,-600904.5,GBP,Restaurant
TXN0000003303,2024-07-07T21:19:02,ACC00003308,Transfer,1106.34,-599798.16,EUR,Starbucks
TXN0000003304,2024-10-15T01:59:30,ACC00009698,ATM,1983.92,-601782.08,GBP,Target
TXN0000003305,2024-12-26T11:16:23,ACC00002327,ATM,406.19,-602188.27,USD,Walmart
TXN0000003306,2024-08-31T19:40:25,ACC00007257,Credit,1932.65,-600255.62,JPY,Online Store
TXN0000003307,2024-08-02T08:45:13,ACC00007116,Transfer,739.94,-599515.68,USD,Walmart
TXN0000003308,2024-05-10T07:19:28,ACC00003458,Transfer,480.76,-599034.92,GBP,Restaurant
TXN0000003309,2024-05-25T17:56:51,ACC00009543,Debit,1066.69,-600101.61,EUR,Starbucks
TXN0000003310,2024-12-13T11:46:37,ACC00008185,Payment,261.48,-600363.09,EUR,Walmart
TXN0000003311,2024-06-05T06:22:21,ACC00001482,ATM,1997.34,-602360.43,JPY,Walmart
TXN0000003312,2024-02-02T18:24:44,ACC00004511,ATM,135.84,-602496.27,GBP,Walmart
TXN0000003313,2024-07-19T17:38:23,ACC00002639,Payment,1677.13,-604173.4,JPY,Restaurant
TXN0000003314,2024-11-25T17:14:11,ACC00006058,Credit,1577.86,-602595.54,EUR,Target
TXN0000003315,2024-11-02T04:07:58,ACC00006067,Debit,1243.98,-603839.52,GBP,Starbucks
TXN0000003316,2024-12-26T06:43:43,ACC00003526,Transfer,1017.14,-602822.38,JPY,Online Store
TXN0000003317,2024-01-09T09:09:21,ACC00001389,Credit,236.96,-602585.42,JPY,Online Store
TXN0000003318,2024-12-07T03:49:30,ACC00003540,Debit,538.64,-603124.06,JPY,Shell
TXN0000003319,2024-05-07T13:57:32,ACC00005598,Transfer,1748.14,-601375.92,JPY,Walmart
TXN0000003320,2024-11-20T01:39:16,ACC00007921,Credit,397.81,-600978.11,GBP,Walmart
TXN0000003321,2024-05-06T20:33:30,ACC00000652,Payment,433.38,-601411.49,GBP,Grocery
TXN0000003322,2024-09-17T03:37:10,ACC00001753,ATM,14.75,-601426.24,EUR,Amazon
TXN0000003323,2024-12-08T04:08:14,ACC00000710,Payment,364.42,-601790.66,USD,Starbucks
TXN0000003324,2024-09-27T21:18:32,ACC00002541,Credit,1596.03,-600194.63,USD,Grocery
TXN0000003325,2024-04-05T00:39:27,ACC00002677,Debit,960.22,-601154.85,GBP,Grocery
TXN0000003326,2024-08-25T21:03:38,ACC00000534,Transfer,719.58,-600435.27,GBP,Online Store
TXN0000003327,2024-08-02T22:01:10,ACC00005326,ATM,625.41,-601060.68,USD,Amazon
TXN0000003328,2024-11-25T12:57:02,ACC00009895,ATM,795.25,-601855.93,GBP,Amazon
TXN0000003329,2024-02-01T06:20:04,ACC00001690,Payment,1627.38,-603483.31,JPY,Grocery
TXN0000003330,2024-07-14T11:52:01,ACC00003914,Transfer,1440.77,-602042.54,USD,Starbucks
TXN0000003331,2024-05-08T16:44:57,ACC00005249,Transfer,347.63,-601694.91,EUR,Shell
TXN0000003332,2024-09-13T09:33:15,ACC00004919,Transfer,1337.25,-600357.66,EUR,Online Store
TXN0000003333,2024-01-06T22:52:23,ACC00008192,Credit,94.87,-600262.79,JPY,Shell
TXN0000003334,2024-07-20T19:09:50,ACC00005170,Transfer,549.39,-599713.4,USD,Restaurant
TXN0000003335,2024-07-28T14:24:09,ACC00008331,Payment,929.24,-600642.64,EUR,Grocery
TXN0000003336,2024-10-03T10:21:25,ACC00004112,Credit,978.55,-599664.09,JPY,Amazon
TXN0000003337,2024-08-21T02:27:52,ACC00001788,Payment,738.63,-600402.72,EUR,Walmart
TXN0000003338,2024-04-19T19:14:17,ACC00000127,ATM,1435.77,-601838.49,GBP,Amazon
TXN0000003339,2024-10-19T01:16:03,ACC00008913,Credit,1615.82,-600222.67,JPY,Walmart
TXN0000003340,2024-06-01T21:17:11,ACC00008188,Credit,695.09,-599527.58,JPY,Amazon
TXN0000003341,2024-11-01T16:58:46,ACC00005834,Credit,1047.87,-598479.71,USD,Grocery
TXN0000003342,2024-01-23T13:58:13,ACC00009494,Credit,13.42,-598466.29,JPY,Online Store
TXN0000003343,2024-06-20T19:47:55,ACC00008063,Transfer,1331.64,-597134.65,EUR,Starbucks
TXN0000003344,2024-06-02T11:15:13,ACC00000764,ATM,578.52,-597713.17,USD,Starbucks
TXN0000003345,2024-09-12T00:37:42,ACC00000382,ATM,1069.82,-598782.99,USD,Walmart
TXN0000003346,2024-12-08T13:50:35,ACC00007789,ATM,276.62,-599059.61,USD,Starbucks
TXN0000003347,2024-10-24T09:52:01,ACC00006925,Credit,1877.87,-597181.74,USD,Amazon
TXN0000003348,2024-11-16T20:56:11,ACC00004840,Payment,1887.88,-599069.62,JPY,Starbucks
TXN0000003349,2024-11-30T14:45:08,ACC00004955,Payment,1444.69,-600514.31,USD,Grocery
TXN0000003350,2024-10-15T14:07:23,ACC00008717,Payment,1184.5,-601698.81,EUR,Online Store
TXN0000003351,2024-01-16T18:14:32,ACC00000752,ATM,960.01,-602658.82,GBP,Online Store
TXN0000003352,2024-02-21T10:28:46,ACC00009446,Credit,1161.29,-601497.53,JPY,Walmart
TXN0000003353,2024-05-25T01:54:45,ACC00008857,Debit,910.94,-602408.47,EUR,Target
TXN0000003354,2024-03-04T07:26:14,ACC00007667,Credit,1873.04,-600535.43,GBP,Grocery
TXN0000003355,2024-06-20T12:26:19,ACC00008683,Debit,1913.35,-602448.78,EUR,Target
TXN0000003356,2024-08-29T09:59:09,ACC00006258,ATM,1775.02,-604223.8,GBP,Grocery
TXN0000003357,2024-08-07T03:01:32,ACC00004621,Debit,1660.37,-605884.17,USD,Target
TXN0000003358,2024-04-05T01:50:42,ACC00003663,Debit,360.43,-606244.6,USD,Online Store
TXN0000003359,2024-12-21T09:08:30,ACC00009855,Transfer,1807.51,-604437.09,EUR,Starbucks
TXN0000003360,2024-04-06T21:01:51,ACC00006590,Payment,1345.01,-605782.1,EUR,Amazon
TXN0000003361,2024-07-16T04:59:41,ACC00006713,Debit,10.24,-605792.34,USD,Walmart
TXN0000003362,2024-08-14T12:21:27,ACC00001078,Transfer,915.08,-604877.26,EUR,Online Store
TXN0000003363,2024-02-08T18:50:19,ACC00009770,Transfer,1908.46,-602968.8,GBP,Shell
TXN0000003364,2024-10-20T07:11:06,ACC00005103,ATM,528.61,-603497.41,JPY,Walmart
TXN0000003365,2024-11-16T23:15:07,ACC00002839,ATM,1756.85,-605254.26,GBP,Shell
TXN0000003366,2024-02-23T10:28:24,ACC00002604,ATM,267.64,-605521.9,USD,Starbucks
TXN0000003367,2024-09-30T17:40:13,ACC00001464,Credit,1935.58,-603586.32,GBP,Online Store
TXN0000003368,2024-12-27T18:45:37,ACC00007583,Credit,1924.49,-601661.83,GBP,Shell
TXN0000003369,2024-01-14T09:06:29,ACC00003143,Credit,1355.04,-600306.79,EUR,Starbucks
TXN0000003370,2024-02-06T05:37:51,ACC00006883,Transfer,1697.29,-598609.5,USD,Starbucks
TXN0000003371,2024-06-02T10:19:28,ACC00001298,Payment,615.35,-599224.85,USD,Restaurant
TXN0000003372,2024-02-25T15:01:38,ACC00004468,Debit,1284.62,-600509.47,EUR,Walmart
TXN0000003373,2024-11-12T08:33:29,ACC00002854,Payment,1278.04,-601787.51,GBP,Target
TXN0000003374,2024-04-03T10:47:26,ACC00009416,Payment,1417.43,-603204.94,GBP,Amazon
TXN0000003375,2024-07-05T14:01:57,ACC00001049,Transfer,1066.06,-602138.88,EUR,Shell
TXN0000003376,2024-11-07T04:19:08,ACC00001562,Credit,1310.52,-600828.36,EUR,Walmart
TXN0000003377,2024-08-27T17:40:09,ACC00007508,Payment,1155.84,-601984.2,USD,Starbucks
TXN0000003378,2024-06-05T07:12:50,ACC00000844,ATM,1312.85,-603297.05,JPY,Amazon
TXN0000003379,2024-11-08T07:19:56,ACC00001598,Credit,1668.49,-601628.56,GBP,Grocery
TXN0000003380,2024-08-24T22:02:46,ACC00000182,Transfer,758.99,-600869.57,JPY,Restaurant
TXN0000003381,2024-10-27T09:12:48,ACC00004062,Transfer,485.48,-600384.09,GBP,Walmart
TXN0000003382,2024-08-07T18:59:08,ACC00008995,Payment,467.24,-600851.33,GBP,Shell
TXN0000003383,2024-02-15T02:49:24,ACC00000333,Transfer,1001.05,-599850.28,GBP,Target
TXN0000003384,2024-11-27T06:04:00,ACC00005964,Debit,1839.34,-601689.62,JPY,Online Store
TXN0000003385,2024-11-21T21:06:37,ACC00009905,Debit,68.82,-601758.44,EUR,Target
TXN0000003386,2024-05-28T07:35:37,ACC00005176,Credit,1060.95,-600697.49,USD,Online Store
TXN0000003387,2024-05-22T12:10:17,ACC00008212,Debit,1162.94,-601860.43,USD,Walmart
TXN0000003388,2024-02-02T12:30:52,ACC00009670,Credit,1486.93,-600373.5,USD,Amazon
TXN0000003389,2024-01-22T20:15:57,ACC00004899,Payment,401.86,-600775.36,USD,Grocery
TXN0000003390,2024-07-12T00:55:55,ACC00007313,Payment,1000.56,-601775.92,JPY,Online Store
TXN0000003391,2024-07-20T22:39:10,ACC00004687,Transfer,1406.5,-600369.42,USD,Online Store
TXN0000003392,2024-05-02T13:20:39,ACC00009325,Payment,1852.71,-602222.13,EUR,Amazon
TXN0000003393,2024-06-20T02:42:43,ACC00004380,Credit,1665.58,-600556.55,USD,Target
TXN0000003394,2024-06-30T11:55:22,ACC00005572,Payment,457.48,-601014.03,USD,Online Store
TXN0000003395,2024-01-16T12:06:30,ACC00006526,Transfer,1350.96,-599663.07,EUR,Walmart
TXN0000003396,2024-08-19T11:30:22,ACC00001440,ATM,1583.35,-601246.42,EUR,Amazon
TXN0000003397,2024-03-15T03:50:44,ACC00002215,Transfer,346.88,-600899.54,EUR,Target
TXN0000003398,2024-01-25T02:01:30,ACC00002728,Payment,807.19,-601706.73,EUR,Restaurant
TXN0000003399,2024-01-07T04:53:18,ACC00004874,Credit,276.33,-601430.4,JPY,Grocery
TXN0000003400,2024-05-26T11:53:43,ACC00005226,Payment,1167.63,-602598.03,JPY,Online Store
TXN0000003401,2024-05-20T11:50:49,ACC00000317,ATM,1923.18,-604521.21,USD,Grocery
TXN0000003402,2024-03-29T06:32:09,ACC00001378,Payment,1349.1,-605870.31,EUR,Amazon
TXN0000003403,2024-02-21T01:35:02,ACC00005015,Debit,1607.33,-607477.64,JPY,Shell
TXN0000003404,2024-01-01T21:06:54,ACC00001724,Payment,736.93,-608214.57,EUR,Online Store
TXN0000003405,2024-02-01T00:05:07,ACC00002795,Payment,1016.43,-609231.0,JPY,Amazon
TXN0000003406,2024-04-02T07:54:53,ACC00007209,Transfer,1244.55,-607986.45,JPY,Grocery
TXN0000003407,2024-01-31T09:49:51,ACC00008110,Credit,110.01,-607876.44,GBP,Online Store
TXN0000003408,2024-03-28T13:40:17,ACC00009987,Transfer,1054.82,-606821.62,GBP,Restaurant
TXN0000003409,2024-08-29T23:22:24,ACC00003452,Debit,850.63,-607672.25,EUR,Grocery
TXN0000003410,2024-05-22T20:55:22,ACC00002822,Payment,1203.11,-608875.36,USD,Restaurant
TXN0000003411,2024-01-26T16:42:33,ACC00008244,Credit,1698.86,-607176.5,USD,Walmart
TXN0000003412,2024-02-01T19:15:18,ACC00003606,ATM,873.89,-608050.39,JPY,Restaurant
TXN0000003413,2024-03-19T08:58:13,ACC00003581,Credit,246.39,-607804.0,EUR,Grocery
TXN0000003414,2024-01-08T07:13:06,ACC00006363,Transfer,187.01,-607616.99,GBP,Walmart
TXN0000003415,2024-10-20T01:43:37,ACC00000503,Payment,332.58,-607949.57,GBP,Target
TXN0000003416,2024-08-15T21:18:50,ACC00000343,Transfer,650.45,-607299.12,EUR,Amazon
TXN0000003417,2024-04-22T14:35:06,ACC00000525,Debit,1286.06,-608585.18,JPY,Amazon
TXN0000003418,2024-01-05T10:49:46,ACC00002057,Credit,19.53,-608565.65,GBP,Restaurant
TXN0000003419,2024-12-05T08:49:02,ACC00001310,Transfer,465.34,-608100.31,JPY,Target
TXN0000003420,2024-07-13T09:25:19,ACC00006988,Payment,519.65,-608619.96,USD,Online Store
TXN0000003421,2024-05-06T06:52:27,ACC00005729,Payment,605.88,-609225.84,JPY,Online Store
TXN0000003422,2024-02-27T08:47:58,ACC00006840,Debit,1777.47,-611003.31,EUR,Grocery
TXN0000003423,2024-10-13T00:55:11,ACC00001404,Payment,953.41,-611956.72,GBP,Online Store
TXN0000003424,2024-01-30T03:33:25,ACC00003533,ATM,1137.04,-613093.76,GBP,Restaurant
TXN0000003425,2024-05-29T12:55:33,ACC00000354,ATM,1334.46,-614428.22,JPY,Online Store
TXN0000003426,2024-11-05T21:00:04,ACC00007910,Credit,1024.12,-613404.1,USD,Shell
TXN0000003427,2024-03-26T13:15:39,ACC00007342,ATM,164.57,-613568.67,JPY,Shell
TXN0000003428,2024-05-31T14:03:18,ACC00002384,Transfer,172.43,-613396.24,JPY,Target
TXN0000003429,2024-01-26T14:35:30,ACC00004902,Credit,133.31,-613262.93,GBP,Amazon
TXN0000003430,2024-03-11T06:51:22,ACC00000353,Credit,1968.32,-611294.61,GBP,Grocery
TXN0000003431,2024-02-23T06:10:43,ACC00007081,Payment,1188.01,-612482.62,EUR,Amazon
TXN0000003432,2024-01-22T13:34:50,ACC00008749,Payment,1430.28,-613912.9,JPY,Walmart
TXN0000003433,2024-08-20T15:00:26,ACC00004524,Debit,1302.21,-615215.11,EUR,Restaurant
TXN0000003434,2024-05-14T10:25:27,ACC00002227,Debit,301.03,-615516.14,EUR,Amazon
TXN0000003435,2024-09-03T11:50:17,ACC00005372,Transfer,696.38,-614819.76,EUR,Grocery
TXN0000003436,2024-09-30T09:49:18,ACC00009324,Credit,959.94,-613859.82,GBP,Walmart
TXN0000003437,2024-10-23T13:23:04,ACC00000682,Debit,1424.11,-615283.93,GBP,Shell
TXN0000003438,2024-01-22T15:22:16,ACC00007429,Transfer,1362.26,-613921.67,GBP,Amazon
TXN0000003439,2024-05-23T07:54:27,ACC00009651,Payment,1101.24,-615022.91,GBP,Starbucks
TXN0000003440,2024-10-30T19:06:03,ACC00002061,Payment,1860.97,-616883.88,USD,Starbucks
TXN0000003441,2024-05-27T19:06:50,ACC00000549,Credit,439.85,-616444.03,USD,Restaurant
TXN0000003442,2024-07-16T14:41:06,ACC00003583,ATM,1673.25,-618117.28,USD,Online Store
TXN0000003443,2024-11-13T14:17:28,ACC00001643,Transfer,1480.98,-616636.3,USD,Restaurant
TXN0000003444,2024-05-19T14:53:17,ACC00005748,Transfer,671.28,-615965.02,GBP,Walmart
TXN0000003445,2024-07-17T12:16:51,ACC00005481,Credit,1467.41,-614497.61,EUR,Starbucks
TXN0000003446,2024-05-02T20:18:35,ACC00008234,ATM,1242.08,-615739.69,JPY,Target
TXN0000003447,2024-02-21T11:13:02,ACC00003138,Transfer,1709.07,-614030.62,EUR,Target
TXN0000003448,2024-10-22T05:10:16,ACC00007090,Debit,728.94,-614759.56,EUR,Walmart
TXN0000003449,2024-09-07T07:12:08,ACC00008795,Payment,1308.69,-616068.25,JPY,Target
TXN0000003450,2024-06-10T08:53:10,ACC00008968,Credit,515.69,-615552.56,USD,Walmart
TXN0000003451,2024-06-24T09:13:44,ACC00008648,Transfer,1530.13,-614022.43,GBP,Starbucks
TXN0000003452,2024-05-09T03:39:30,ACC00002392,Transfer,1406.21,-612616.22,USD,Restaurant
TXN0000003453,2024-08-11T11:00:30,ACC00003554,Credit,1284.91,-611331.31,EUR,Walmart
TXN0000003454,2024-04-04T04:13:01,ACC00008506,Payment,267.25,-611598.56,GBP,Amazon
TXN0000003455,2024-02-20T22:04:26,ACC00005868,Debit,1970.35,-613568.91,JPY,Online Store
TXN0000003456,2024-02-13T09:51:10,ACC00009104,Debit,1421.48,-614990.39,JPY,Shell
TXN0000003457,2024-05-05T15:48:48,ACC00000988,Payment,1814.13,-616804.52,EUR,Walmart
TXN0000003458,2024-12-03T12:53:22,ACC00002326,Credit,1903.3,-614901.22,JPY,Walmart
TXN0000003459,2024-02-24T05:40:08,ACC00007086,Credit,1324.3,-613576.92,JPY,Starbucks
TXN0000003460,2024-08-06T11:24:31,ACC00002394,ATM,1445.63,-615022.55,JPY,Walmart
TXN0000003461,2024-02-28T20:08:43,ACC00006176,Transfer,745.16,-614277.39,JPY,Target
TXN0000003462,2024-03-16T01:27:37,ACC00003756,Transfer,1372.8,-612904.59,USD,Shell
TXN0000003463,2024-04-02T14:52:39,ACC00005463,Payment,83.95,-612988.54,EUR,Online Store
TXN0000003464,2024-02-13T18:23:00,ACC00008709,Transfer,1740.41,-611248.13,EUR,Grocery
TXN0000003465,2024-08-17T23:33:18,ACC00001110,ATM,473.01,-611721.14,EUR,Target
TXN0000003466,2024-10-12T04:18:24,ACC00007659,Payment,670.47,-612391.61,EUR,Grocery
TXN0000003467,2024-02-27T08:54:56,ACC00005528,Transfer,1042.34,-611349.27,GBP,Starbucks
TXN0000003468,2024-10-24T10:56:53,ACC00009053,Credit,577.39,-610771.88,USD,Restaurant
TXN0000003469,2024-01-30T15:02:18,ACC00001289,Transfer,884.43,-609887.45,JPY,Shell
TXN0000003470,2024-07-22T08:15:36,ACC00002876,ATM,779.09,-610666.54,GBP,Starbucks
TXN0000003471,2024-02-14T17:08:33,ACC00004007,Debit,787.78,-611454.32,GBP,Grocery
TXN0000003472,2024-08-08T02:40:01,ACC00002004,Credit,221.96,-611232.36,JPY,Shell
TXN0000003473,2024-02-23T11:37:13,ACC00001641,Debit,835.46,-612067.82,USD,Target
TXN0000003474,2024-07-11T12:35:43,ACC00002626,ATM,410.22,-612478.04,GBP,Amazon
TXN0000003475,2024-02-07T17:09:25,ACC00005112,ATM,1896.97,-614375.01,EUR,Grocery
TXN0000003476,2024-06-25T05:15:49,ACC00000561,Debit,1016.23,-615391.24,EUR,Walmart
TXN0000003477,2024-01-13T22:29:23,ACC00002050,Credit,1720.36,-613670.88,EUR,Amazon
TXN0000003478,2024-08-27T17:07:31,ACC00009716,Transfer,1836.63,-611834.25,EUR,Shell
TXN0000003479,2024-06-07T20:53:41,ACC00009757,Payment,1723.48,-613557.73,GBP,Target
TXN0000003480,2024-03-30T14:06:09,ACC00003492,Transfer,468.46,-613089.27,EUR,Online Store
TXN0000003481,2024-06-24T10:33:55,ACC00000189,Debit,535.48,-613624.75,GBP,Walmart
TXN0000003482,2024-08-06T14:05:03,ACC00003773,Payment,1530.67,-615155.42,JPY,Target
TXN0000003483,2024-02-06T22:06:21,ACC00004917,Debit,207.95,-615363.37,GBP,Shell
TXN0000003484,2024-09-01T07:53:36,ACC00001415,Debit,625.73,-615989.1,JPY,Starbucks
TXN0000003485,2024-01-31T17:35:22,ACC00001603,Transfer,411.63,-615577.47,EUR,Online Store
TXN0000003486,2024-03-25T04:21:18,ACC00007661,Payment,1126.81,-616704.28,JPY,Amazon
TXN0000003487,2024-08-17T15:43:31,ACC00001755,Transfer,1143.25,-615561.03,GBP,Target
TXN0000003488,2024-10-27T13:38:54,ACC00001493,ATM,1225.86,-616786.89,USD,Starbucks
TXN0000003489,2024-07-19T04:06:30,ACC00002811,Payment,412.81,-617199.7,EUR,Walmart
TXN0000003490,2024-06-11T00:26:54,ACC00006257,ATM,1776.75,-618976.45,JPY,Starbucks
TXN0000003491,2024-06-09T11:00:16,ACC00003019,Credit,1588.07,-617388.38,USD,Walmart
TXN0000003492,2024-03-21T18:30:20,ACC00009237,ATM,646.45,-618034.83,JPY,Online Store
TXN0000003493,2024-01-09T00:37:23,ACC00004657,Transfer,918.27,-617116.56,JPY,Shell
TXN0000003494,2024-10-13T19:48:21,ACC00004209,Transfer,1121.52,-615995.04,JPY,Restaurant
TXN0000003495,2024-07-27T06:46:28,ACC00005573,ATM,1847.46,-617842.5,USD,Restaurant
TXN0000003496,2024-02-14T10:58:15,ACC00009869,Payment,1515.7,-619358.2,EUR,Target
TXN0000003497,2024-07-04T18:36:35,ACC00009441,Credit,1387.87,-617970.33,USD,Online Store
TXN0000003498,2024-10-24T04:48:53,ACC00002477,Transfer,1670.74,-616299.59,GBP,Walmart
TXN0000003499,2024-09-17T08:25:37,ACC00003185,Credit,671.25,-615628.34,USD,Restaurant
TXN0000003500,2024-01-03T10:19:22,ACC00003906,Credit,1357.0,-614271.34,JPY,Shell
TXN0000003501,2024-01-12T08:40:40,ACC00009888,ATM,226.22,-614497.56,EUR,Walmart
TXN0000003502,2024-01-28T06:57:02,ACC00001895,ATM,106.45,-614604.01,GBP,Grocery
TXN0000003503,2024-06-14T23:04:27,ACC00001692,ATM,1641.94,-616245.95,JPY,Walmart
TXN0000003504,2024-12-05T11:52:01,ACC00008177,Payment,459.94,-616705.89,JPY,Target
TXN0000003505,2024-01-06T13:21:19,ACC00001594,Credit,57.41,-616648.48,USD,Online Store
TXN0000003506,2024-06-09T10:20:46,ACC00000989,Credit,1076.32,-615572.16,USD,Amazon
TXN0000003507,2024-04-02T18:36:05,ACC00003858,Payment,785.52,-616357.68,USD,Shell
TXN0000003508,2024-11-22T19:40:11,ACC00005154,Debit,352.99,-616710.67,USD,Restaurant
TXN0000003509,2024-02-29T22:30:25,ACC00002527,Transfer,1119.99,-615590.68,USD,Shell
TXN0000003510,2024-08-29T04:36:09,ACC00009230,Debit,905.21,-616495.89,JPY,Restaurant
TXN0000003511,2024-05-03T13:35:28,ACC00008043,Debit,1175.95,-617671.84,EUR,Walmart
TXN0000003512,2024-07-06T09:26:00,ACC00001708,Credit,608.01,-617063.83,EUR,Online Store
TXN0000003513,2024-08-04T19:03:19,ACC00004461,Payment,326.12,-617389.95,JPY,Shell
TXN0000003514,2024-10-21T00:54:44,ACC00002168,Transfer,1972.71,-615417.24,EUR,Starbucks
TXN0000003515,2024-08-18T12:16:26,ACC00008671,Transfer,1849.5,-613567.74,JPY,Shell
TXN0000003516,2024-02-02T11:25:55,ACC00006761,ATM,1542.51,-615110.25,JPY,Grocery
TXN0000003517,2024-02-28T20:46:04,ACC00000941,ATM,1436.74,-616546.99,EUR,Grocery
TXN0000003518,2024-02-11T18:40:19,ACC00006166,Debit,1529.73,-618076.72,USD,Starbucks
TXN0000003519,2024-11-15T22:44:36,ACC00008497,Debit,226.12,-618302.84,JPY,Shell
TXN0000003520,2024-01-06T10:29:00,ACC00008734,Transfer,1980.77,-616322.07,GBP,Starbucks
TXN0000003521,2024-08-01T03:37:44,ACC00000353,Credit,456.89,-615865.18,GBP,Walmart
TXN0000003522,2024-03-20T03:07:20,ACC00002342,Transfer,573.9,-615291.28,EUR,Walmart
TXN0000003523,2024-08-04T10:28:48,ACC00000476,Debit,1198.8,-616490.08,JPY,Starbucks
TXN0000003524,2024-07-23T11:53:36,ACC00008357,Transfer,1573.6,-614916.48,GBP,Amazon
TXN0000003525,2024-03-10T09:13:42,ACC00001227,Credit,633.78,-614282.7,JPY,Amazon
TXN0000003526,2024-02-20T03:41:30,ACC00003552,Credit,1929.0,-612353.7,USD,Grocery
TXN0000003527,2024-10-11T06:52:05,ACC00008966,Debit,1878.91,-614232.61,USD,Starbucks
TXN0000003528,2024-06-22T22:48:08,ACC00000257,Debit,1975.04,-616207.65,EUR,Grocery
TXN0000003529,2024-05-30T03:55:29,ACC00000394,Debit,535.7,-616743.35,GBP,Grocery
TXN0000003530,2024-02-05T20:21:48,ACC00001648,Debit,296.62,-617039.97,USD,Restaurant
TXN0000003531,2024-07-30T05:54:45,ACC00001391,ATM,466.59,-617506.56,GBP,Starbucks
TXN0000003532,2024-04-18T17:41:32,ACC00004855,Payment,1384.0,-618890.56,EUR,Amazon
TXN0000003533,2024-12-03T16:32:34,ACC00006415,ATM,1135.15,-620025.71,JPY,Target
TXN0000003534,2024-09-24T07:45:31,ACC00009481,Credit,182.1,-619843.61,JPY,Target
TXN0000003535,2024-07-21T14:47:40,ACC00008026,Payment,685.63,-620529.24,GBP,Starbucks
TXN0000003536,2024-12-04T17:59:36,ACC00008655,Payment,1639.98,-622169.22,GBP,Shell
TXN0000003537,2024-02-26T15:20:42,ACC00001529,Credit,751.5,-621417.72,USD,Walmart
TXN0000003538,2024-08-15T06:28:31,ACC00005837,Payment,1832.92,-623250.64,EUR,Amazon
TXN0000003539,2024-01-21T22:00:59,ACC00005230,Transfer,630.92,-622619.72,USD,Target
TXN0000003540,2024-01-11T21:32:02,ACC00004580,Debit,1616.53,-624236.25,EUR,Target
TXN0000003541,2024-03-19T00:53:25,ACC00005996,Payment,1726.83,-625963.08,USD,Restaurant
TXN0000003542,2024-03-27T23:09:32,ACC00007061,Transfer,912.46,-625050.62,JPY,Restaurant
TXN0000003543,2024-10-11T10:59:11,ACC00003551,Credit,1596.61,-623454.01,USD,Grocery
TXN0000003544,2024-05-22T12:07:12,ACC00002793,ATM,471.78,-623925.79,EUR,Target
TXN0000003545,2024-07-22T03:00:03,ACC00009243,ATM,883.81,-624809.6,USD,Amazon
TXN0000003546,2024-02-28T01:44:40,ACC00001642,Payment,350.06,-625159.66,EUR,Restaurant
TXN0000003547,2024-02-03T02:47:27,ACC00007565,Payment,844.31,-626003.97,GBP,Online Store
TXN0000003548,2024-12-04T17:51:23,ACC00008921,Payment,1405.43,-627409.4,GBP,Restaurant
TXN0000003549,2024-07-05T07:01:01,ACC00000937,Credit,703.24,-626706.16,GBP,Restaurant
TXN0000003550,2024-07-08T03:42:22,ACC00006662,Debit,465.42,-627171.58,JPY,Walmart
TXN0000003551,2024-11-14T03:16:25,ACC00002501,Payment,873.36,-628044.94,EUR,Walmart
TXN0000003552,2024-07-13T23:58:49,ACC00004554,Transfer,1182.21,-626862.73,EUR,Shell
TXN0000003553,2024-05-25T13:06:36,ACC00002216,Payment,1151.65,-628014.38,EUR,Grocery
TXN0000003554,2024-12-16T07:54:47,ACC00008126,Payment,1088.01,-629102.39,JPY,Starbucks
TXN0000003555,2024-05-07T08:17:44,ACC00004277,Transfer,732.87,-628369.52,GBP,Restaurant
TXN0000003556,2024-04-16T09:10:13,ACC00001739,Credit,1460.04,-626909.48,GBP,Walmart
TXN0000003557,2024-07-28T17:32:38,ACC00009323,Credit,619.97,-626289.51,GBP,Walmart
TXN0000003558,2024-08-19T09:51:58,ACC00006034,Debit,562.05,-626851.56,JPY,Shell
TXN0000003559,2024-05-07T11:56:19,ACC00009583,Debit,1842.85,-628694.41,EUR,Walmart
TXN0000003560,2024-05-12T00:52:08,ACC00000121,Payment,1585.71,-630280.12,GBP,Amazon
TXN0000003561,2024-04-06T05:31:37,ACC00000576,ATM,1090.32,-631370.44,JPY,Walmart
TXN0000003562,2024-11-05T00:50:33,ACC00001422,ATM,1193.2,-632563.64,GBP,Starbucks
TXN0000003563,2024-01-24T16:09:41,ACC00004448,Transfer,1509.76,-631053.88,JPY,Shell
TXN0000003564,2024-11-02T09:11:08,ACC00000158,Payment,230.69,-631284.57,JPY,Online Store
TXN0000003565,2024-07-25T16:44:43,ACC00002684,Transfer,350.34,-630934.23,USD,Target
TXN0000003566,2024-06-13T22:56:35,ACC00008683,Credit,880.77,-630053.46,JPY,Target
TXN0000003567,2024-06-12T02:38:52,ACC00004621,Debit,112.48,-630165.94,JPY,Online Store
TXN0000003568,2024-12-24T01:41:07,ACC00007598,Credit,776.3,-629389.64,USD,Starbucks
TXN0000003569,2024-06-26T15:22:26,ACC00008717,Credit,272.62,-629117.02,GBP,Restaurant
TXN0000003570,2024-03-12T12:22:41,ACC00007343,ATM,164.69,-629281.71,USD,Walmart
TXN0000003571,2024-11-18T10:57:20,ACC00003067,Credit,698.83,-628582.88,JPY,Shell
TXN0000003572,2024-06-23T22:36:25,ACC00000086,Transfer,1286.9,-627295.98,USD,Grocery
TXN0000003573,2024-09-22T04:19:19,ACC00009297,Debit,678.73,-627974.71,EUR,Target
TXN0000003574,2024-01-01T19:51:36,ACC00001214,Debit,349.79,-628324.5,GBP,Shell
TXN0000003575,2024-05-06T15:30:00,ACC00005095,Payment,446.53,-628771.03,USD,Restaurant
TXN0000003576,2024-01-13T22:19:29,ACC00003511,Debit,121.98,-628893.01,USD,Amazon
TXN0000003577,2024-02-25T03:32:18,ACC00002406,ATM,1598.93,-630491.94,USD,Target
TXN0000003578,2024-07-10T06:13:40,ACC00003311,Debit,1826.13,-632318.07,USD,Target
TXN0000003579,2024-02-03T11:05:06,ACC00007432,Payment,928.27,-633246.34,JPY,Online Store
TXN0000003580,2024-05-04T14:03:11,ACC00008336,ATM,345.52,-633591.86,EUR,Restaurant
TXN0000003581,2024-09-17T19:16:43,ACC00002145,Transfer,188.56,-633403.3,EUR,Amazon
TXN0000003582,2024-12-04T12:14:26,ACC00005016,Credit,1671.62,-631731.68,GBP,Walmart
TXN0000003583,2024-11-22T01:55:47,ACC00009326,ATM,1562.05,-633293.73,JPY,Grocery
TXN0000003584,2024-01-27T11:10:10,ACC00002999,Credit,1913.95,-631379.78,GBP,Amazon
TXN0000003585,2024-09-08T13:44:44,ACC00009076,Debit,1061.62,-632441.4,USD,Walmart
TXN0000003586,2024-06-25T08:06:20,ACC00002705,Debit,819.69,-633261.09,USD,Target
TXN0000003587,2024-05-01T09:59:32,ACC00000528,Payment,250.2,-633511.29,JPY,Starbucks
TXN0000003588,2024-08-12T11:47:26,ACC00004044,Debit,908.85,-634420.14,EUR,Online Store
TXN0000003589,2024-08-19T09:12:58,ACC00005463,Debit,55.03,-634475.17,USD,Restaurant
TXN0000003590,2024-02-13T15:42:04,ACC00002549,ATM,1798.21,-636273.38,JPY,Walmart
TXN0000003591,2024-04-11T23:14:22,ACC00005297,Payment,687.4,-636960.78,GBP,Shell
TXN0000003592,2024-09-03T15:45:07,ACC00009496,Transfer,724.2,-636236.58,EUR,Grocery
TXN0000003593,2024-05-17T20:13:48,ACC00007021,ATM,1398.39,-637634.97,USD,Grocery
TXN0000003594,2024-08-20T01:43:43,ACC00007597,Transfer,1337.12,-636297.85,USD,Starbucks
TXN0000003595,2024-10-12T20:58:29,ACC00005592,ATM,1832.18,-638130.03,USD,Starbucks
TXN0000003596,2024-11-22T08:25:23,ACC00009652,Transfer,1895.74,-636234.29,EUR,Starbucks
TXN0000003597,2024-11-23T08:47:35,ACC00006673,Payment,1841.6,-638075.89,GBP,Target
TXN0000003598,2024-04-15T10:12:44,ACC00000871,Payment,988.26,-639064.15,EUR,Online Store
TXN0000003599,2024-09-12T05:06:11,ACC00003368,Payment,1078.84,-640142.99,EUR,Grocery
TXN0000003600,2024-05-26T02:47:58,ACC00004122,ATM,772.81,-640915.8,EUR,Shell
TXN0000003601,2024-05-23T20:29:33,ACC00002585,Credit,667.22,-640248.58,GBP,Target
TXN0000003602,2024-09-22T19:58:09,ACC00002109,Transfer,1630.13,-638618.45,EUR,Grocery
TXN0000003603,2024-02-16T21:48:35,ACC00006300,Transfer,977.94,-637640.51,USD,Target
TXN0000003604,2024-05-16T19:39:54,ACC00007489,Credit,1839.37,-635801.14,USD,Online Store
TXN0000003605,2024-05-22T20:00:22,ACC00004027,ATM,84.3,-635885.44,JPY,Restaurant
TXN0000003606,2024-03-22T01:33:24,ACC00004818,Debit,589.62,-636475.06,GBP,Walmart
TXN0000003607,2024-01-20T00:45:15,ACC00000649,Credit,1917.02,-634558.04,EUR,Shell
TXN0000003608,2024-09-17T11:58:46,ACC00009045,Payment,1033.44,-635591.48,USD,Shell
TXN0000003609,2024-09-15T19:19:34,ACC00007476,Debit,1455.39,-637046.87,USD,Walmart
TXN0000003610,2024-08-30T22:54:11,ACC00001128,ATM,1660.45,-638707.32,USD,Grocery
TXN0000003611,2024-10-11T01:03:20,ACC00006494,ATM,1902.05,-640609.37,USD,Restaurant
TXN0000003612,2024-03-24T20:08:44,ACC00008209,Debit,600.61,-641209.98,JPY,Starbucks
TXN0000003613,2024-08-11T16:28:28,ACC00000329,Debit,914.28,-642124.26,GBP,Restaurant
TXN0000003614,2024-12-23T04:47:29,ACC00005368,ATM,131.42,-642255.68,GBP,Target
TXN0000003615,2024-02-25T08:02:40,ACC00004398,Debit,443.17,-642698.85,EUR,Restaurant
TXN0000003616,2024-04-11T20:26:02,ACC00007560,Payment,392.54,-643091.39,JPY,Online Store
TXN0000003617,2024-07-19T18:38:03,ACC00009254,Debit,1885.54,-644976.93,EUR,Shell
TXN0000003618,2024-05-22T02:13:33,ACC00003376,Transfer,1811.93,-643165.0,USD,Grocery
TXN0000003619,2024-12-12T23:49:58,ACC00009321,Credit,1981.71,-641183.29,GBP,Restaurant
TXN0000003620,2024-12-19T01:19:38,ACC00005791,Transfer,1851.7,-639331.59,GBP,Amazon
TXN0000003621,2024-09-18T07:24:06,ACC00002620,Debit,456.19,-639787.78,USD,Restaurant
TXN0000003622,2024-06-02T10:03:08,ACC00004721,Debit,295.64,-640083.42,JPY,Amazon
TXN0000003623,2024-09-08T23:40:22,ACC00003794,Credit,212.2,-639871.22,JPY,Grocery
TXN0000003624,2024-03-27T08:57:50,ACC00004372,Debit,1953.88,-641825.1,USD,Walmart
TXN0000003625,2024-06-27T21:30:19,ACC00007282,Payment,304.08,-642129.18,GBP,Walmart
TXN0000003626,2024-12-04T03:28:09,ACC00003082,Payment,234.15,-642363.33,USD,Amazon
TXN0000003627,2024-03-17T14:12:28,ACC00000453,Transfer,935.44,-641427.89,GBP,Grocery
TXN0000003628,2024-09-23T19:10:13,ACC00003193,Payment,16.71,-641444.6,EUR,Online Store
TXN0000003629,2024-10-22T20:06:59,ACC00002210,ATM,722.2,-642166.8,GBP,Online Store
TXN0000003630,2024-05-14T08:11:59,ACC00003520,Debit,1982.32,-644149.12,GBP,Shell
TXN0000003631,2024-03-27T02:36:59,ACC00009643,Debit,1545.0,-645694.12,USD,Amazon
TXN0000003632,2024-07-30T17:38:47,ACC00005781,Payment,1216.14,-646910.26,EUR,Amazon
TXN0000003633,2024-09-07T07:31:03,ACC00003217,Credit,1430.81,-645479.45,EUR,Amazon
TXN0000003634,2024-03-22T21:57:52,ACC00001270,Debit,822.17,-646301.62,JPY,Online Store
TXN0000003635,2024-01-20T07:48:25,ACC00005167,Debit,1282.55,-647584.17,USD,Grocery
TXN0000003636,2024-10-22T22:20:28,ACC00000195,Transfer,1508.82,-646075.35,EUR,Grocery
TXN0000003637,2024-04-13T19:47:14,ACC00009988,Payment,448.96,-646524.31,USD,Shell
TXN0000003638,2024-05-23T21:13:18,ACC00005462,Debit,1170.81,-647695.12,USD,Grocery
TXN0000003639,2024-02-14T23:07:20,ACC00009404,Debit,752.05,-648447.17,JPY,Restaurant
TXN0000003640,2024-03-30T11:50:48,ACC00001014,Payment,1355.88,-649803.05,EUR,Grocery
TXN0000003641,2024-03-01T23:08:33,ACC00000044,Transfer,271.7,-649531.35,GBP,Online Store
TXN0000003642,2024-05-27T08:37:08,ACC00007148,Transfer,929.1,-648602.25,JPY,Shell
TXN0000003643,2024-08-01T00:59:57,ACC00004546,ATM,197.16,-648799.41,USD,Grocery
TXN0000003644,2024-07-25T09:32:42,ACC00007683,Debit,869.35,-649668.76,JPY,Online Store
TXN0000003645,2024-06-18T23:35:47,ACC00003037,ATM,201.53,-649870.29,GBP,Shell
TXN0000003646,2024-09-07T01:16:19,ACC00005790,ATM,694.57,-650564.86,JPY,Target
TXN0000003647,2024-10-18T20:51:04,ACC00000899,ATM,1304.6,-651869.46,USD,Amazon
TXN0000003648,2024-04-18T21:43:45,ACC00003608,Debit,1175.03,-653044.49,USD,Shell
TXN0000003649,2024-08-24T23:55:02,ACC00001777,Transfer,1447.84,-651596.65,USD,Target
TXN0000003650,2024-01-11T22:55:20,ACC00006485,Credit,642.88,-650953.77,EUR,Walmart
TXN0000003651,2024-10-12T11:39:12,ACC00006398,Payment,1681.4,-652635.17,GBP,Shell
TXN0000003652,2024-10-07T19:22:30,ACC00002573,Transfer,459.14,-652176.03,EUR,Starbucks
TXN0000003653,2024-04-10T22:38:22,ACC00006707,Credit,593.22,-651582.81,EUR,Target
TXN0000003654,2024-07-19T14:43:00,ACC00004212,Payment,1541.62,-653124.43,GBP,Target
TXN0000003655,2024-11-16T06:52:43,ACC00009238,Debit,1288.44,-654412.87,EUR,Grocery
TXN0000003656,2024-07-16T14:16:07,ACC00005329,Transfer,532.79,-653880.08,USD,Shell
TXN0000003657,2024-09-01T15:49:16,ACC00009918,Debit,824.18,-654704.26,JPY,Restaurant
TXN0000003658,2024-06-13T16:17:20,ACC00000360,Payment,891.89,-655596.15,GBP,Restaurant
TXN0000003659,2024-07-26T01:16:01,ACC00002200,ATM,746.52,-656342.67,GBP,Online Store
TXN0000003660,2024-01-12T03:16:27,ACC00002858,Transfer,1531.5,-654811.17,JPY,Restaurant
TXN0000003661,2024-09-11T10:34:11,ACC00000798,Transfer,1834.99,-652976.18,GBP,Target
TXN0000003662,2024-05-27T01:34:34,ACC00008894,Payment,1184.94,-654161.12,USD,Grocery
TXN0000003663,2024-10-21T08:06:36,ACC00009101,Payment,733.86,-654894.98,USD,Starbucks
TXN0000003664,2024-08-30T15:17:49,ACC00000266,ATM,1126.14,-656021.12,JPY,Amazon
TXN0000003665,2024-03-24T16:34:04,ACC00005231,Payment,289.64,-656310.76,USD,Shell
TXN0000003666,2024-11-24T09:15:22,ACC00002703,Transfer,1164.26,-655146.5,EUR,Grocery
TXN0000003667,2024-09-19T12:12:32,ACC00003858,ATM,417.47,-655563.97,GBP,Shell
TXN0000003668,2024-08-04T18:01:55,ACC00008797,Credit,535.54,-655028.43,GBP,Walmart
TXN0000003669,2024-04-05T18:41:15,ACC00002070,Credit,1435.49,-653592.94,EUR,Shell
TXN0000003670,2024-02-06T23:29:05,ACC00004001,Credit,1791.2,-651801.74,JPY,Target
TXN0000003671,2024-06-14T01:42:35,ACC00003203,Payment,683.54,-652485.28,JPY,Online Store
TXN0000003672,2024-04-06T12:18:48,ACC00005794,Transfer,1245.89,-651239.39,EUR,Shell
TXN0000003673,2024-02-23T12:42:17,ACC00006899,Payment,1451.46,-652690.85,JPY,Shell
TXN0000003674,2024-11-18T21:32:55,ACC00000720,ATM,785.86,-653476.71,GBP,Restaurant
TXN0000003675,2024-07-11T12:37:24,ACC00004266,Debit,1605.31,-655082.02,GBP,Shell
TXN0000003676,2024-11-04T08:28:03,ACC00004154,ATM,1583.2,-656665.22,EUR,Grocery
TXN0000003677,2024-06-27T10:05:33,ACC00002626,Payment,459.38,-657124.6,USD,Shell
TXN0000003678,2024-01-26T02:09:28,ACC00004875,Transfer,412.14,-656712.46,EUR,Grocery
TXN0000003679,2024-02-12T04:33:14,ACC00004552,Transfer,703.29,-656009.17,USD,Restaurant
TXN0000003680,2024-12-18T23:12:52,ACC00004524,Payment,995.13,-657004.3,EUR,Grocery
TXN0000003681,2024-02-10T04:02:40,ACC00009228,Credit,1770.37,-655233.93,GBP,Online Store
TXN0000003682,2024-03-15T21:39:35,ACC00007455,ATM,115.72,-655349.65,EUR,Starbucks
TXN0000003683,2024-12-13T13:34:03,ACC00003542,Credit,838.32,-654511.33,JPY,Online Store
TXN0000003684,2024-07-16T04:16:25,ACC00007482,Transfer,1208.9,-653302.43,JPY,Amazon
TXN0000003685,2024-09-04T01:50:26,ACC00008200,Payment,1553.66,-654856.09,USD,Online Store
TXN0000003686,2024-06-28T20:35:33,ACC00008494,Transfer,229.15,-654626.94,EUR,Starbucks
TXN0000003687,2024-09-19T21:41:00,ACC00004333,Transfer,1804.55,-652822.39,EUR,Online Store
TXN0000003688,2024-02-12T03:23:33,ACC00008402,Credit,1278.3,-651544.09,EUR,Starbucks
TXN0000003689,2024-09-11T08:39:30,ACC00001183,Credit,1371.5,-650172.59,JPY,Restaurant
TXN0000003690,2024-08-31T00:01:26,ACC00009162,Transfer,1048.97,-649123.62,EUR,Grocery
TXN0000003691,2024-03-08T02:29:50,ACC00007428,Payment,1552.01,-650675.63,JPY,Starbucks
TXN0000003692,2024-12-02T06:13:07,ACC00003362,Transfer,943.61,-649732.02,USD,Grocery
TXN0000003693,2024-10-09T14:20:43,ACC00003064,Transfer,563.69,-649168.33,USD,Target
TXN0000003694,2024-09-17T11:38:07,ACC00009445,Debit,1718.5,-650886.83,JPY,Online Store
TXN0000003695,2024-01-17T07:19:52,ACC00005528,Credit,843.98,-650042.85,EUR,Grocery
TXN0000003696,2024-08-30T00:15:27,ACC00000376,Debit,1641.25,-651684.1,EUR,Restaurant
TXN0000003697,2024-08-11T18:47:56,ACC00009009,Payment,1838.85,-653522.95,EUR,Walmart
TXN0000003698,2024-12-28T17:34:08,ACC00007938,Credit,628.53,-652894.42,GBP,Shell
TXN0000003699,2024-07-29T04:01:01,ACC00001389,Credit,1985.64,-650908.78,GBP,Shell
TXN0000003700,2024-07-25T20:22:31,ACC00003610,Payment,288.8,-651197.58,EUR,Amazon
TXN0000003701,2024-03-01T23:21:00,ACC00007845,Payment,1765.87,-652963.45,GBP,Starbucks
TXN0000003702,2024-02-01T19:41:02,ACC00005455,ATM,340.04,-653303.49,GBP,Target
TXN0000003703,2024-02-19T10:28:07,ACC00005340,ATM,291.05,-653594.54,JPY,Restaurant
TXN0000003704,2024-05-02T17:16:30,ACC00004221,Payment,1943.08,-655537.62,JPY,Target
TXN0000003705,2024-01-02T08:18:16,ACC00001521,Credit,513.13,-655024.49,GBP,Restaurant
TXN0000003706,2024-11-25T18:27:24,ACC00007011,Payment,254.59,-655279.08,USD,Amazon
TXN0000003707,2024-01-27T01:07:47,ACC00007032,Credit,1670.21,-653608.87,GBP,Online Store
TXN0000003708,2024-02-03T07:13:02,ACC00008323,Debit,621.54,-654230.41,GBP,Grocery
TXN0000003709,2024-07-09T11:17:21,ACC00001603,ATM,58.93,-654289.34,GBP,Target
TXN0000003710,2024-01-31T10:49:21,ACC00006137,Payment,1600.38,-655889.72,GBP,Restaurant
TXN0000003711,2024-01-01T10:48:18,ACC00007033,Debit,1931.74,-657821.46,GBP,Target
TXN0000003712,2024-01-14T05:40:58,ACC00007667,Payment,1465.96,-659287.42,EUR,Amazon
TXN0000003713,2024-06-05T21:13:44,ACC00002075,Transfer,1427.69,-657859.73,EUR,Starbucks
TXN0000003714,2024-07-19T01:04:14,ACC00000209,ATM,1574.22,-659433.95,USD,Starbucks
TXN0000003715,2024-09-18T07:22:35,ACC00007917,Transfer,573.92,-658860.03,JPY,Target
TXN0000003716,2024-12-20T18:23:42,ACC00006075,ATM,1991.79,-660851.82,GBP,Shell
TXN0000003717,2024-01-24T21:33:24,ACC00004813,Debit,1788.62,-662640.44,GBP,Amazon
TXN0000003718,2024-08-10T00:36:05,ACC00001612,Transfer,987.26,-661653.18,JPY,Shell
TXN0000003719,2024-10-28T22:12:27,ACC00002721,Debit,1020.89,-662674.07,JPY,Walmart
TXN0000003720,2024-08-15T12:04:51,ACC00009478,ATM,686.54,-663360.61,USD,Shell
TXN0000003721,2024-03-01T02:12:41,ACC00006418,Transfer,953.5,-662407.11,USD,Amazon
TXN0000003722,2024-02-27T22:54:52,ACC00009984,Debit,498.01,-662905.12,JPY,Amazon
TXN0000003723,2024-08-27T13:54:03,ACC00009516,Transfer,374.27,-662530.85,GBP,Shell
TXN0000003724,2024-05-20T03:35:30,ACC00009312,Debit,978.3,-663509.15,EUR,Shell
TXN0000003725,2024-02-03T07:43:15,ACC00004608,Payment,301.8,-663810.95,GBP,Amazon
TXN0000003726,2024-12-09T07:44:13,ACC00007328,Transfer,350.27,-663460.68,USD,Grocery
TXN0000003727,2024-12-13T10:07:30,ACC00004992,Credit,94.69,-663365.99,GBP,Amazon
TXN0000003728,2024-08-31T20:38:07,ACC00007119,Credit,935.37,-662430.62,USD,Restaurant
TXN0000003729,2024-11-03T04:09:15,ACC00008616,Credit,627.99,-661802.63,GBP,Grocery
TXN0000003730,2024-01-17T05:55:33,ACC00008512,Credit,1507.3,-660295.33,USD,Target
TXN0000003731,2024-11-08T18:42:56,ACC00002107,Credit,1220.76,-659074.57,EUR,Grocery
TXN0000003732,2024-05-27T22:13:56,ACC00008570,ATM,1342.03,-660416.6,GBP,Walmart
TXN0000003733,2024-10-21T14:15:29,ACC00000816,ATM,1562.59,-661979.19,USD,Walmart
TXN0000003734,2024-01-21T11:39:44,ACC00001773,Transfer,1757.57,-660221.62,USD,Walmart
TXN0000003735,2024-09-22T04:44:33,ACC00006700,Payment,259.68,-660481.3,USD,Amazon
TXN0000003736,2024-05-07T14:34:22,ACC00009214,ATM,1580.79,-662062.09,EUR,Online Store
TXN0000003737,2024-06-22T15:52:02,ACC00006791,Credit,953.79,-661108.3,GBP,Starbucks
TXN0000003738,2024-03-28T13:19:35,ACC00008201,Transfer,112.85,-660995.45,GBP,Target
TXN0000003739,2024-09-10T22:46:16,ACC00008219,Credit,628.11,-660367.34,GBP,Restaurant
TXN0000003740,2024-11-01T21:40:20,ACC00005842,Payment,1507.94,-661875.28,JPY,Amazon
TXN0000003741,2024-06-20T21:39:26,ACC00008598,Debit,1000.43,-662875.71,GBP,Target
TXN0000003742,2024-09-06T14:00:05,ACC00008258,ATM,408.44,-663284.15,USD,Starbucks
TXN0000003743,2024-03-25T08:22:20,ACC00001982,Payment,806.33,-664090.48,JPY,Restaurant
TXN0000003744,2024-11-19T16:16:44,ACC00003497,Transfer,235.27,-663855.21,GBP,Target
TXN0000003745,2024-01-07T18:43:35,ACC00002678,ATM,1467.0,-665322.21,EUR,Target
TXN0000003746,2024-01-08T09:09:10,ACC00007309,Payment,1813.73,-667135.94,EUR,Grocery
TXN0000003747,2024-03-28T18:47:48,ACC00000147,Debit,477.61,-667613.55,GBP,Shell
TXN0000003748,2024-09-26T11:24:22,ACC00004123,Debit,877.7,-668491.25,USD,Online Store
TXN0000003749,2024-04-21T17:56:11,ACC00000666,Credit,961.53,-667529.72,USD,Shell
TXN0000003750,2024-04-19T15:26:00,ACC00001175,Payment,719.43,-668249.15,JPY,Walmart
TXN0000003751,2024-01-22T19:54:29,ACC00002423,Payment,1544.71,-669793.86,GBP,Starbucks
TXN0000003752,2024-11-02T13:37:24,ACC00001965,Debit,1026.93,-670820.79,JPY,Grocery
TXN0000003753,2024-12-17T17:42:12,ACC00008723,Credit,1662.56,-669158.23,USD,Amazon
TXN0000003754,2024-11-04T15:20:38,ACC00008888,Debit,1375.58,-670533.81,JPY,Shell
TXN0000003755,2024-02-14T16:49:56,ACC00001162,Debit,88.01,-670621.82,EUR,Starbucks
TXN0000003756,2024-08-24T18:15:26,ACC00007833,ATM,281.4,-670903.22,JPY,Grocery
TXN0000003757,2024-06-28T09:45:03,ACC00007519,Payment,1830.66,-672733.88,USD,Starbucks
TXN0000003758,2024-12-07T12:11:24,ACC00009840,Transfer,173.79,-672560.09,JPY,Walmart
TXN0000003759,2024-03-14T06:43:09,ACC00006306,ATM,196.76,-672756.85,GBP,Target
TXN0000003760,2024-12-12T11:59:39,ACC00006655,Payment,913.9,-673670.75,EUR,Restaurant
TXN0000003761,2024-05-12T06:27:50,ACC00006564,Transfer,664.33,-673006.42,EUR,Amazon
TXN0000003762,2024-11-07T12:44:39,ACC00004003,ATM,1810.51,-674816.93,USD,Walmart
TXN0000003763,2024-05-29T18:27:59,ACC00009130,Transfer,121.17,-674695.76,EUR,Starbucks
TXN0000003764,2024-04-10T11:11:23,ACC00006650,Payment,239.61,-674935.37,JPY,Grocery
TXN0000003765,2024-08-03T02:16:40,ACC00008225,ATM,754.22,-675689.59,JPY,Walmart
TXN0000003766,2024-12-18T12:58:11,ACC00004309,Credit,406.9,-675282.69,JPY,Grocery
TXN0000003767,2024-09-15T16:25:57,ACC00008638,Credit,1807.11,-673475.58,JPY,Amazon
TXN0000003768,2024-01-02T08:43:52,ACC00006255,ATM,1068.9,-674544.48,GBP,Shell
TXN0000003769,2024-01-18T23:40:11,ACC00003850,Credit,1099.89,-673444.59,JPY,Amazon
TXN0000003770,2024-10-25T04:42:15,ACC00000236,Credit,1505.46,-671939.13,JPY,Online Store
TXN0000003771,2024-06-07T23:00:32,ACC00006350,Debit,1712.47,-673651.6,JPY,Shell
TXN0000003772,2024-02-21T09:14:13,ACC00002384,Debit,1159.56,-674811.16,GBP,Grocery
TXN0000003773,2024-11-18T02:02:18,ACC00009676,Transfer,465.53,-674345.63,JPY,Amazon
TXN0000003774,2024-05-14T08:10:16,ACC00001293,Debit,61.08,-674406.71,JPY,Target
TXN0000003775,2024-02-09T06:53:47,ACC00008051,Credit,525.08,-673881.63,JPY,Restaurant
TXN0000003776,2024-07-28T23:51:31,ACC00002664,Credit,1229.99,-672651.64,USD,Starbucks
TXN0000003777,2024-05-31T04:30:11,ACC00003482,Payment,1328.41,-673980.05,EUR,Shell
TXN0000003778,2024-12-16T08:02:14,ACC00001462,Payment,1084.96,-675065.01,JPY,Online Store
TXN0000003779,2024-03-14T00:12:33,ACC00008909,Transfer,1726.95,-673338.06,JPY,Target
TXN0000003780,2024-09-20T08:28:03,ACC00005103,Payment,1000.42,-674338.48,USD,Amazon
TXN0000003781,2024-12-06T09:02:06,ACC00008050,Transfer,288.52,-674049.96,GBP,Restaurant
TXN0000003782,2024-08-26T18:20:45,ACC00000584,Payment,1664.78,-675714.74,JPY,Restaurant
TXN0000003783,2024-01-30T19:12:14,ACC00007472,Payment,416.97,-676131.71,JPY,Grocery
TXN0000003784,2024-04-24T07:00:04,ACC00002064,Transfer,1535.27,-674596.44,EUR,Shell
TXN0000003785,2024-08-26T12:15:19,ACC00002409,Transfer,1824.76,-672771.68,GBP,Walmart
TXN0000003786,2024-08-29T06:46:49,ACC00000501,ATM,721.25,-673492.93,USD,Restaurant
TXN0000003787,2024-01-09T01:33:21,ACC00005119,Payment,598.46,-674091.39,USD,Amazon
TXN0000003788,2024-03-15T19:32:10,ACC00001657,Payment,694.89,-674786.28,GBP,Restaurant
TXN0000003789,2024-07-16T05:40:40,ACC00000997,Payment,1116.9,-675903.18,GBP,Grocery
TXN0000003790,2024-03-03T08:38:54,ACC00008412,Payment,1673.26,-677576.44,EUR,Starbucks
TXN0000003791,2024-07-13T02:52:25,ACC00005191,Transfer,853.23,-676723.21,JPY,Grocery
TXN0000003792,2024-10-28T00:53:57,ACC00002045,Debit,1355.47,-678078.68,EUR,Amazon
TXN0000003793,2024-10-15T18:09:37,ACC00008655,Debit,857.54,-678936.22,EUR,Online Store
TXN0000003794,2024-04-08T09:00:07,ACC00009936,Debit,1265.71,-680201.93,GBP,Restaurant
TXN0000003795,2024-04-03T01:24:37,ACC00008452,Payment,1479.34,-681681.27,GBP,Starbucks
TXN0000003796,2024-10-25T04:16:12,ACC00000579,ATM,1675.76,-683357.03,JPY,Target
TXN0000003797,2024-01-25T17:47:24,ACC00009814,Transfer,1379.75,-681977.28,USD,Amazon
TXN0000003798,2024-07-07T04:15:39,ACC00008956,Payment,1719.23,-683696.51,GBP,Amazon
TXN0000003799,2024-07-14T11:08:16,ACC00001990,Transfer,702.66,-682993.85,USD,Restaurant
TXN0000003800,2024-04-08T20:26:36,ACC00008341,ATM,1695.87,-684689.72,GBP,Walmart
TXN0000003801,2024-07-19T06:48:56,ACC00009396,Transfer,594.62,-684095.1,JPY,Amazon
TXN0000003802,2024-08-30T12:31:45,ACC00004285,ATM,1729.61,-685824.71,GBP,Grocery
TXN0000003803,2024-01-18T00:00:20,ACC00007214,Transfer,1058.73,-684765.98,EUR,Starbucks
TXN0000003804,2024-06-04T09:44:49,ACC00001744,Payment,1155.2,-685921.18,USD,Restaurant
TXN0000003805,2024-01-04T10:50:29,ACC00006391,Payment,1742.67,-687663.85,GBP,Amazon
TXN0000003806,2024-05-01T12:59:45,ACC00006181,Payment,1883.62,-689547.47,JPY,Shell
TXN0000003807,2024-08-11T19:28:51,ACC00003690,ATM,938.36,-690485.83,JPY,Restaurant
TXN0000003808,2024-01-05T17:23:13,ACC00005524,Debit,867.74,-691353.57,EUR,Amazon
TXN0000003809,2024-10-10T01:28:14,ACC00001480,Credit,1240.06,-690113.51,EUR,Online Store
TXN0000003810,2024-08-08T20:09:03,ACC00003198,Transfer,643.02,-689470.49,USD,Amazon
TXN0000003811,2024-10-25T03:35:52,ACC00003340,Transfer,1496.24,-687974.25,USD,Target
TXN0000003812,2024-02-18T07:52:29,ACC00002026,ATM,1968.45,-689942.7,EUR,Grocery
TXN0000003813,2024-04-21T10:03:29,ACC00006482,ATM,290.06,-690232.76,USD,Amazon
TXN0000003814,2024-07-21T00:15:53,ACC00000575,Debit,1898.22,-692130.98,EUR,Starbucks
TXN0000003815,2024-12-08T12:14:59,ACC00004151,Transfer,12.97,-692118.01,GBP,Target
TXN0000003816,2024-09-17T09:39:58,ACC00004573,Credit,896.37,-691221.64,JPY,Online Store
TXN0000003817,2024-04-04T21:24:30,ACC00008016,Credit,908.99,-690312.65,EUR,Walmart
TXN0000003818,2024-04-11T15:10:14,ACC00006893,Transfer,1280.83,-689031.82,GBP,Online Store
TXN0000003819,2024-10-01T20:42:47,ACC00005100,Credit,1252.52,-687779.3,USD,Online Store
TXN0000003820,2024-01-07T16:05:21,ACC00001762,Payment,1313.34,-689092.64,JPY,Grocery
TXN0000003821,2024-12-18T20:01:01,ACC00000378,Debit,1620.32,-690712.96,USD,Walmart
TXN0000003822,2024-11-19T15:24:04,ACC00002951,Payment,948.28,-691661.24,GBP,Online Store
TXN0000003823,2024-10-09T16:26:16,ACC00008512,Transfer,1456.95,-690204.29,EUR,Restaurant
TXN0000003824,2024-03-26T17:22:34,ACC00006059,Debit,1273.17,-691477.46,GBP,Walmart
TXN0000003825,2024-12-20T17:31:39,ACC00005383,Payment,188.82,-691666.28,GBP,Starbucks
TXN0000003826,2024-07-02T06:23:06,ACC00003845,Transfer,1582.07,-690084.21,GBP,Walmart
TXN0000003827,2024-12-07T13:44:26,ACC00007596,Transfer,1100.17,-688984.04,JPY,Shell
TXN0000003828,2024-01-28T21:42:53,ACC00007537,Debit,257.05,-689241.09,JPY,Grocery
TXN0000003829,2024-07-24T05:54:22,ACC00009352,Payment,1605.12,-690846.21,USD,Target
TXN0000003830,2024-04-16T08:05:52,ACC00006327,Credit,1785.94,-689060.27,USD,Starbucks
TXN0000003831,2024-10-08T22:54:46,ACC00001627,ATM,1194.59,-690254.86,USD,Restaurant
TXN0000003832,2024-11-15T12:59:00,ACC00007464,Debit,1579.62,-691834.48,GBP,Grocery
TXN0000003833,2024-06-12T07:59:33,ACC00001556,Debit,1951.36,-693785.84,GBP,Online Store
TXN0000003834,2024-07-25T22:11:31,ACC00009866,Debit,1649.51,-695435.35,GBP,Starbucks
TXN0000003835,2024-09-17T12:58:05,ACC00009170,Credit,774.12,-694661.23,EUR,Walmart
TXN0000003836,2024-12-08T06:05:43,ACC00000852,ATM,338.17,-694999.4,EUR,Restaurant
TXN0000003837,2024-05-13T21:53:59,ACC00000394,Transfer,20.76,-694978.64,USD,Target
TXN0000003838,2024-08-16T01:49:20,ACC00000571,Credit,402.27,-694576.37,GBP,Shell
TXN0000003839,2024-08-07T15:08:37,ACC00002949,ATM,1275.43,-695851.8,USD,Starbucks
TXN0000003840,2024-03-17T20:06:04,ACC00001822,Payment,1440.59,-697292.39,EUR,Grocery
TXN0000003841,2024-12-06T11:00:31,ACC00000669,Credit,1413.23,-695879.16,JPY,Amazon
TXN0000003842,2024-10-18T12:25:58,ACC00001044,Payment,147.03,-696026.19,EUR,Target
TXN0000003843,2024-11-08T14:58:00,ACC00004467,Credit,1941.03,-694085.16,GBP,Target
TXN0000003844,2024-12-11T12:02:45,ACC00009808,Payment,1616.49,-695701.65,USD,Grocery
TXN0000003845,2024-06-28T20:03:52,ACC00000719,Credit,449.17,-695252.48,JPY,Starbucks
TXN0000003846,2024-04-23T22:07:01,ACC00009282,Payment,1247.9,-696500.38,EUR,Target
TXN0000003847,2024-04-30T07:46:14,ACC00005364,ATM,1844.35,-698344.73,GBP,Grocery
TXN0000003848,2024-03-07T08:04:48,ACC00009209,Transfer,1332.76,-697011.97,EUR,Target
TXN0000003849,2024-08-26T14:01:53,ACC00009247,ATM,132.49,-697144.46,EUR,Target
TXN0000003850,2024-12-19T10:42:19,ACC00005087,Debit,194.81,-697339.27,USD,Shell
TXN0000003851,2024-02-22T09:10:50,ACC00002818,Payment,984.4,-698323.67,EUR,Grocery
TXN0000003852,2024-08-15T02:07:29,ACC00004365,Payment,1492.74,-699816.41,GBP,Grocery
TXN0000003853,2024-08-06T00:00:03,ACC00009841,Payment,1530.85,-701347.26,JPY,Amazon
TXN0000003854,2024-08-21T12:56:32,ACC00004878,Credit,1620.14,-699727.12,JPY,Starbucks
TXN0000003855,2024-04-16T11:14:35,ACC00000573,Credit,1619.8,-698107.32,EUR,Shell
TXN0000003856,2024-02-14T16:11:23,ACC00006317,Debit,538.33,-698645.65,USD,Amazon
TXN0000003857,2024-01-06T19:25:13,ACC00005034,Transfer,645.34,-698000.31,JPY,Amazon
TXN0000003858,2024-09-14T22:13:33,ACC00008911,Transfer,536.84,-697463.47,USD,Amazon
TXN0000003859,2024-09-13T10:40:54,ACC00007068,Payment,866.49,-698329.96,EUR,Walmart
TXN0000003860,2024-10-17T13:51:07,ACC00006747,Payment,1035.06,-699365.02,JPY,Shell
TXN0000003861,2024-03-26T00:26:29,ACC00009532,ATM,734.06,-700099.08,USD,Amazon
TXN0000003862,2024-04-03T15:27:31,ACC00007523,Payment,1191.3,-701290.38,USD,Starbucks
TXN0000003863,2024-01-14T02:16:13,ACC00003967,ATM,958.32,-702248.7,GBP,Target
TXN0000003864,2024-06-22T01:54:32,ACC00008714,Credit,1340.33,-700908.37,EUR,Starbucks
TXN0000003865,2024-08-29T07:18:48,ACC00000061,Transfer,1134.45,-699773.92,JPY,Online Store
TXN0000003866,2024-04-19T12:28:30,ACC00007324,Credit,1670.07,-698103.85,EUR,Shell
TXN0000003867,2024-02-04T09:09:08,ACC00002748,Credit,1200.0,-696903.85,EUR,Grocery
TXN0000003868,2024-09-03T23:49:08,ACC00006025,Debit,1556.48,-698460.33,EUR,Walmart
TXN0000003869,2024-10-11T09:23:07,ACC00001452,Payment,1182.95,-699643.28,GBP,Grocery
TXN0000003870,2024-03-04T05:46:29,ACC00007884,Transfer,1748.87,-697894.41,EUR,Target
TXN0000003871,2024-03-30T06:50:18,ACC00005120,Debit,1394.53,-699288.94,GBP,Amazon
TXN0000003872,2024-10-04T16:34:09,ACC00001531,ATM,1191.4,-700480.34,EUR,Starbucks
TXN0000003873,2024-07-20T17:57:21,ACC00004717,ATM,1900.63,-702380.97,USD,Grocery
TXN0000003874,2024-06-11T19:55:35,ACC00005037,Credit,597.83,-701783.14,EUR,Shell
TXN0000003875,2024-01-27T00:44:33,ACC00009978,Credit,1355.98,-700427.16,JPY,Restaurant
TXN0000003876,2024-12-23T05:26:16,ACC00007646,Transfer,883.61,-699543.55,JPY,Grocery
TXN0000003877,2024-08-09T19:56:10,ACC00009281,Payment,749.78,-700293.33,EUR,Restaurant
TXN0000003878,2024-11-18T12:22:35,ACC00007674,Debit,1848.91,-702142.24,JPY,Walmart
TXN0000003879,2024-07-12T15:23:47,ACC00004582,Payment,941.78,-703084.02,JPY,Starbucks
TXN0000003880,2024-11-03T19:26:32,ACC00002835,Payment,261.32,-703345.34,GBP,Restaurant
TXN0000003881,2024-09-24T18:02:35,ACC00000112,Credit,1773.6,-701571.74,JPY,Online Store
TXN0000003882,2024-07-02T10:39:38,ACC00001200,Credit,1577.92,-699993.82,EUR,Online Store
TXN0000003883,2024-08-10T23:09:38,ACC00006291,Credit,468.17,-699525.65,EUR,Starbucks
TXN0000003884,2024-10-07T07:16:03,ACC00003730,Payment,1766.82,-701292.47,GBP,Shell
TXN0000003885,2024-05-22T00:08:47,ACC00004033,ATM,973.92,-702266.39,JPY,Shell
TXN0000003886,2024-03-22T03:31:34,ACC00006199,Payment,1519.26,-703785.65,GBP,Grocery
TXN0000003887,2024-06-11T22:36:01,ACC00009542,Debit,1633.75,-705419.4,USD,Shell
TXN0000003888,2024-05-09T04:06:56,ACC00009160,Transfer,1309.31,-704110.09,EUR,Walmart
TXN0000003889,2024-05-04T22:30:20,ACC00002324,Debit,1711.37,-705821.46,GBP,Restaurant
TXN0000003890,2024-07-15T14:17:39,ACC00000090,ATM,1137.85,-706959.31,GBP,Starbucks
TXN0000003891,2024-06-04T18:45:14,ACC00007699,Transfer,1828.41,-705130.9,USD,Target
TXN0000003892,2024-12-28T02:43:16,ACC00003077,ATM,946.47,-706077.37,GBP,Restaurant
TXN0000003893,2024-01-25T18:37:07,ACC00000498,Debit,1039.55,-707116.92,EUR,Starbucks
TXN0000003894,2024-07-03T18:03:57,ACC00004411,Payment,617.38,-707734.3,JPY,Amazon
TXN0000003895,2024-04-18T08:23:27,ACC00002546,Debit,437.82,-708172.12,EUR,Online Store
TXN0000003896,2024-03-20T09:21:15,ACC00000868,ATM,129.27,-708301.39,JPY,Walmart
TXN0000003897,2024-02-29T05:31:05,ACC00008700,Transfer,846.7,-707454.69,GBP,Restaurant
TXN0000003898,2024-10-04T14:21:23,ACC00008327,ATM,1821.84,-709276.53,USD,Amazon
TXN0000003899,2024-03-07T08:29:34,ACC00008846,Credit,1495.04,-707781.49,USD,Restaurant
TXN0000003900,2024-11-03T00:27:40,ACC00006386,ATM,1459.98,-709241.47,GBP,Restaurant
TXN0000003901,2024-01-10T00:02:35,ACC00000916,Debit,1630.68,-710872.15,JPY,Walmart
TXN0000003902,2024-03-19T09:52:57,ACC00002561,Transfer,517.15,-710355.0,JPY,Grocery
TXN0000003903,2024-03-21T00:44:56,ACC00006760,Credit,80.51,-710274.49,USD,Online Store
TXN0000003904,2024-10-02T17:40:16,ACC00000999,ATM,1784.6,-712059.09,JPY,Amazon
TXN0000003905,2024-01-28T12:42:51,ACC00000221,Transfer,1012.12,-711046.97,EUR,Starbucks
TXN0000003906,2024-01-31T03:53:23,ACC00005281,Transfer,724.38,-710322.59,GBP,Grocery
TXN0000003907,2024-03-17T15:23:48,ACC00003153,Transfer,1416.95,-708905.64,JPY,Walmart
TXN0000003908,2024-12-16T23:24:56,ACC00003572,Credit,1481.9,-707423.74,USD,Target
TXN0000003909,2024-09-21T08:13:16,ACC00003637,Debit,1514.45,-708938.19,JPY,Online Store
TXN0000003910,2024-02-12T21:00:54,ACC00004772,Credit,421.65,-708516.54,EUR,Shell
TXN0000003911,2024-01-08T05:47:33,ACC00009777,ATM,1698.2,-710214.74,GBP,Target
TXN0000003912,2024-03-24T23:28:10,ACC00007622,Debit,416.11,-710630.85,USD,Target
TXN0000003913,2024-06-09T16:44:28,ACC00004085,ATM,515.08,-711145.93,USD,Online Store
TXN0000003914,2024-04-22T16:20:37,ACC00003217,Transfer,137.23,-711008.7,GBP,Walmart
TXN0000003915,2024-02-27T11:43:08,ACC00002934,Payment,1048.05,-712056.75,GBP,Walmart
TXN0000003916,2024-02-04T16:36:42,ACC00007681,Transfer,560.29,-711496.46,GBP,Target
TXN0000003917,2024-09-15T10:18:23,ACC00006927,ATM,552.57,-712049.03,USD,Grocery
TXN0000003918,2024-01-20T04:24:19,ACC00006952,Credit,836.96,-711212.07,GBP,Online Store
TXN0000003919,2024-05-15T03:36:07,ACC00000739,Credit,422.9,-710789.17,JPY,Walmart
TXN0000003920,2024-03-02T08:48:02,ACC00005393,Payment,1076.64,-711865.81,EUR,Shell
TXN0000003921,2024-07-01T04:53:51,ACC00000219,ATM,877.5,-712743.31,EUR,Amazon
TXN0000003922,2024-12-28T17:25:53,ACC00003685,Debit,1314.37,-714057.68,JPY,Walmart
TXN0000003923,2024-03-16T08:01:55,ACC00009491,Transfer,952.53,-713105.15,GBP,Walmart
TXN0000003924,2024-09-23T12:29:58,ACC00007310,Payment,1007.19,-714112.34,USD,Grocery
TXN0000003925,2024-12-23T08:16:23,ACC00008907,Payment,1303.91,-715416.25,JPY,Amazon
TXN0000003926,2024-03-07T10:09:43,ACC00002622,Credit,214.99,-715201.26,GBP,Starbucks
TXN0000003927,2024-04-03T09:20:02,ACC00009599,Payment,1543.83,-716745.09,GBP,Shell
TXN0000003928,2024-03-31T15:26:09,ACC00008330,ATM,182.12,-716927.21,EUR,Starbucks
TXN0000003929,2024-08-25T06:36:53,ACC00004959,Transfer,734.93,-716192.28,USD,Amazon
TXN0000003930,2024-07-04T19:30:21,ACC00005201,Payment,1601.81,-717794.09,EUR,Shell
TXN0000003931,2024-08-21T09:05:52,ACC00004673,Payment,689.0,-718483.09,EUR,Online Store
TXN0000003932,2024-08-13T09:30:56,ACC00001776,Debit,385.91,-718869.0,USD,Grocery
TXN0000003933,2024-12-05T13:10:16,ACC00007107,Transfer,621.5,-718247.5,GBP,Target
TXN0000003934,2024-07-22T09:20:06,ACC00003514,Credit,493.86,-717753.64,JPY,Amazon
TXN0000003935,2024-04-30T18:34:17,ACC00007146,Credit,567.25,-717186.39,USD,Restaurant
TXN0000003936,2024-06-11T12:10:25,ACC00004071,Credit,842.73,-716343.66,GBP,Amazon
TXN0000003937,2024-03-10T17:16:29,ACC00000504,Payment,851.68,-717195.34,USD,Shell
TXN0000003938,2024-05-01T16:17:29,ACC00009996,ATM,1655.59,-718850.93,GBP,Starbucks
TXN0000003939,2024-09-13T06:23:13,ACC00003232,ATM,1443.24,-720294.17,EUR,Online Store
TXN0000003940,2024-07-05T07:43:11,ACC00000901,Transfer,512.54,-719781.63,USD,Restaurant
TXN0000003941,2024-12-08T09:04:54,ACC00006621,ATM,249.73,-720031.36,USD,Grocery
TXN0000003942,2024-09-01T19:19:31,ACC00007720,Credit,1048.78,-718982.58,EUR,Shell
TXN0000003943,2024-07-08T05:03:37,ACC00005749,Debit,908.08,-719890.66,EUR,Target
TXN0000003944,2024-12-12T20:00:04,ACC00002624,Transfer,59.45,-719831.21,GBP,Starbucks
TXN0000003945,2024-06-03T17:18:03,ACC00009818,Debit,596.68,-720427.89,EUR,Online Store
TXN0000003946,2024-06-06T19:13:48,ACC00006555,Credit,1248.19,-719179.7,GBP,Restaurant
TXN0000003947,2024-04-05T15:30:32,ACC00005021,ATM,411.82,-719591.52,JPY,Restaurant
TXN0000003948,2024-08-14T13:44:51,ACC00004845,Payment,1823.91,-721415.43,GBP,Walmart
TXN0000003949,2024-03-17T10:51:32,ACC00005146,ATM,307.51,-721722.94,USD,Starbucks
TXN0000003950,2024-06-15T09:37:40,ACC00007652,Credit,1418.27,-720304.67,EUR,Grocery
TXN0000003951,2024-06-10T01:51:14,ACC00002664,Transfer,458.67,-719846.0,USD,Target
TXN0000003952,2024-05-12T15:48:41,ACC00005090,Debit,1427.32,-721273.32,JPY,Starbucks
TXN0000003953,2024-02-03T15:36:41,ACC00008001,Payment,1200.69,-722474.01,EUR,Restaurant
TXN0000003954,2024-01-22T13:34:43,ACC00003673,Payment,1131.83,-723605.84,GBP,Online Store
TXN0000003955,2024-02-29T12:40:04,ACC00003000,Credit,1969.71,-721636.13,JPY,Online Store
TXN0000003956,2024-07-12T16:49:24,ACC00005848,Credit,1139.46,-720496.67,EUR,Walmart
TXN0000003957,2024-10-08T16:13:17,ACC00004491,ATM,387.91,-720884.58,EUR,Shell
TXN0000003958,2024-02-22T09:35:25,ACC00009749,Credit,1453.61,-719430.97,JPY,Amazon
TXN0000003959,2024-04-12T03:20:54,ACC00001492,Credit,838.08,-718592.89,USD,Online Store
TXN0000003960,2024-12-27T01:31:11,ACC00001450,Payment,1423.26,-720016.15,USD,Online Store
TXN0000003961,2024-07-14T20:47:24,ACC00008084,Transfer,1555.66,-718460.49,EUR,Starbucks
TXN0000003962,2024-04-02T17:49:31,ACC00004778,Debit,1619.25,-720079.74,USD,Shell
TXN0000003963,2024-12-27T07:18:23,ACC00003534,Transfer,1754.61,-718325.13,JPY,Starbucks
TXN0000003964,2024-04-19T18:44:12,ACC00009507,ATM,1728.09,-720053.22,USD,Starbucks
TXN0000003965,2024-07-07T07:51:01,ACC00002609,Transfer,475.92,-719577.3,GBP,Shell
TXN0000003966,2024-10-27T18:29:16,ACC00007671,Transfer,1704.87,-717872.43,GBP,Restaurant
TXN0000003967,2024-01-23T01:00:33,ACC00002054,ATM,1173.14,-719045.57,EUR,Target
TXN0000003968,2024-10-18T16:03:55,ACC00005822,Payment,1285.44,-720331.01,EUR,Restaurant
TXN0000003969,2024-02-18T00:43:44,ACC00006411,Payment,1379.53,-721710.54,JPY,Walmart
TXN0000003970,2024-04-24T18:47:23,ACC00001592,ATM,768.7,-722479.24,GBP,Online Store
TXN0000003971,2024-05-31T23:31:07,ACC00005618,Debit,186.13,-722665.37,GBP,Target
TXN0000003972,2024-03-19T22:11:24,ACC00005286,ATM,946.72,-723612.09,JPY,Grocery
TXN0000003973,2024-07-12T11:16:13,ACC00007052,Transfer,1482.47,-722129.62,USD,Shell
TXN0000003974,2024-07-13T20:55:24,ACC00002685,ATM,808.56,-722938.18,EUR,Target
TXN0000003975,2024-12-14T23:23:20,ACC00007415,Credit,1631.6,-721306.58,GBP,Walmart
TXN0000003976,2024-02-22T19:58:29,ACC00009964,Transfer,733.44,-720573.14,GBP,Amazon
TXN0000003977,2024-09-28T01:20:53,ACC00002251,Transfer,540.74,-720032.4,EUR,Amazon
TXN0000003978,2024-09-01T21:07:55,ACC00002878,Debit,1941.23,-721973.63,GBP,Target
TXN0000003979,2024-10-17T18:17:25,ACC00003663,Payment,275.34,-722248.97,GBP,Restaurant
TXN0000003980,2024-09-10T11:11:34,ACC00001667,Transfer,1807.7,-720441.27,GBP,Starbucks
TXN0000003981,2024-10-21T00:38:23,ACC00006555,Credit,1517.23,-718924.04,USD,Walmart
TXN0000003982,2024-01-26T01:32:36,ACC00004887,ATM,1663.99,-720588.03,USD,Shell
TXN0000003983,2024-04-19T09:00:32,ACC00009235,Transfer,1329.98,-719258.05,USD,Amazon
TXN0000003984,2024-12-12T23:45:38,ACC00008064,Debit,497.05,-719755.1,GBP,Restaurant
TXN0000003985,2024-05-11T04:14:33,ACC00005644,Payment,929.41,-720684.51,USD,Amazon
TXN0000003986,2024-04-12T01:07:05,ACC00000438,ATM,1362.96,-722047.47,EUR,Starbucks
TXN0000003987,2024-04-28T04:30:31,ACC00002801,Payment,1299.31,-723346.78,EUR,Starbucks
TXN0000003988,2024-03-11T10:13:40,ACC00000513,ATM,1935.14,-725281.92,GBP,Shell
TXN0000003989,2024-12-17T05:54:38,ACC00001229,Debit,1338.52,-726620.44,GBP,Amazon
TXN0000003990,2024-05-23T02:10:55,ACC00009622,Payment,826.19,-727446.63,USD,Walmart
TXN0000003991,2024-09-15T10:54:43,ACC00006158,Payment,529.2,-727975.83,JPY,Online Store
TXN0000003992,2024-02-13T13:24:04,ACC00008144,Payment,1126.64,-729102.47,EUR,Restaurant
TXN0000003993,2024-01-07T05:26:07,ACC00000054,Payment,1340.89,-730443.36,GBP,Restaurant
TXN0000003994,2024-06-08T22:28:25,ACC00000181,Credit,1415.16,-729028.2,JPY,Shell
TXN0000003995,2024-05-14T09:45:42,ACC00002132,Credit,1124.86,-727903.34,EUR,Grocery
TXN0000003996,2024-09-24T03:17:32,ACC00003340,ATM,62.09,-727965.43,GBP,Walmart
TXN0000003997,2024-02-02T16:08:55,ACC00002356,Payment,146.21,-728111.64,GBP,Restaurant
TXN0000003998,2024-09-13T13:15:56,ACC00008294,ATM,1177.0,-729288.64,USD,Starbucks
TXN0000003999,2024-08-20T09:31:51,ACC00007253,Payment,1729.6,-731018.24,JPY,Target
TXN0000004000,2024-09-17T05:57:31,ACC00005691,Credit,748.24,-730270.0,EUR,Restaurant
TXN0000004001,2024-08-16T18:35:27,ACC00001704,Debit,1184.68,-731454.68,GBP,Restaurant
TXN0000004002,2024-12-28T05:41:15,ACC00007024,Transfer,969.22,-730485.46,EUR,Restaurant
TXN0000004003,2024-10-16T17:37:22,ACC00004525,Transfer,1182.5,-729302.96,USD,Shell
TXN0000004004,2024-07-12T02:21:36,ACC00007613,Transfer,688.2,-728614.76,GBP,Online Store
TXN0000004005,2024-06-23T03:01:13,ACC00001899,Payment,694.68,-729309.44,GBP,Online Store
TXN0000004006,2024-11-24T22:04:25,ACC00000231,Debit,1332.82,-730642.26,EUR,Amazon
TXN0000004007,2024-12-26T05:44:33,ACC00004406,Transfer,1604.05,-729038.21,USD,Target
TXN0000004008,2024-01-08T23:08:49,ACC00001722,Debit,344.03,-729382.24,GBP,Grocery
TXN0000004009,2024-09-16T02:58:29,ACC00006896,Debit,278.73,-729660.97,EUR,Starbucks
TXN0000004010,2024-11-20T14:20:34,ACC00008384,Transfer,1099.83,-728561.14,USD,Grocery
TXN0000004011,2024-08-09T11:27:48,ACC00004282,Payment,1967.35,-730528.49,JPY,Online Store
TXN0000004012,2024-07-28T14:43:48,ACC00008185,ATM,1287.51,-731816.0,GBP,Restaurant
TXN0000004013,2024-01-04T17:04:27,ACC00007876,Payment,1660.27,-733476.27,JPY,Starbucks
TXN0000004014,2024-03-02T10:03:32,ACC00000401,Payment,1839.29,-735315.56,JPY,Walmart
TXN0000004015,2024-02-04T18:11:11,ACC00002405,Credit,1831.12,-733484.44,EUR,Walmart
TXN0000004016,2024-05-25T23:06:01,ACC00002885,ATM,1388.02,-734872.46,GBP,Restaurant
TXN0000004017,2024-12-27T18:27:45,ACC00001387,Credit,774.0,-734098.46,GBP,Amazon
TXN0000004018,2024-08-28T18:19:46,ACC00009276,ATM,541.39,-734639.85,USD,Walmart
TXN0000004019,2024-07-09T15:35:51,ACC00002803,Transfer,916.15,-733723.7,GBP,Walmart
TXN0000004020,2024-11-15T20:21:51,ACC00006620,Debit,441.16,-734164.86,JPY,Walmart
TXN0000004021,2024-07-04T20:29:17,ACC00005402,Transfer,1805.09,-732359.77,EUR,Target
TXN0000004022,2024-09-28T17:03:01,ACC00009761,Credit,649.74,-731710.03,EUR,Starbucks
TXN0000004023,2024-06-02T09:02:29,ACC00006337,Credit,613.43,-731096.6,USD,Online Store
TXN0000004024,2024-03-16T14:13:15,ACC00008376,Payment,221.71,-731318.31,USD,Restaurant
TXN0000004025,2024-04-03T03:34:23,ACC00004823,Debit,1165.77,-732484.08,EUR,Target
TXN0000004026,2024-11-12T09:40:00,ACC00004651,Payment,301.24,-732785.32,EUR,Target
TXN0000004027,2024-06-28T12:38:27,ACC00000812,Payment,1328.54,-734113.86,EUR,Amazon
TXN0000004028,2024-01-04T01:29:16,ACC00004733,ATM,1108.82,-735222.68,EUR,Online Store
TXN0000004029,2024-07-16T13:48:00,ACC00008698,Debit,1486.18,-736708.86,GBP,Amazon
TXN0000004030,2024-10-08T22:06:39,ACC00002602,Transfer,1879.6,-734829.26,EUR,Amazon
TXN0000004031,2024-03-26T19:23:43,ACC00004130,Debit,1408.19,-736237.45,JPY,Starbucks
TXN0000004032,2024-02-25T18:38:12,ACC00004842,Credit,1111.64,-735125.81,GBP,Shell
TXN0000004033,2024-06-18T11:20:45,ACC00005346,Payment,1816.94,-736942.75,USD,Walmart
TXN0000004034,2024-10-05T00:38:47,ACC00004625,Debit,1817.98,-738760.73,JPY,Target
TXN0000004035,2024-11-09T02:37:21,ACC00001005,Payment,1235.45,-739996.18,EUR,Grocery
TXN0000004036,2024-02-12T00:43:43,ACC00002699,Credit,1033.45,-738962.73,JPY,Walmart
TXN0000004037,2024-10-04T04:12:56,ACC00001043,Transfer,330.2,-738632.53,EUR,Grocery
TXN0000004038,2024-01-25T12:50:31,ACC00007223,Debit,799.74,-739432.27,GBP,Amazon
TXN0000004039,2024-09-24T17:36:16,ACC00001045,Debit,1068.78,-740501.05,JPY,Restaurant
TXN0000004040,2024-04-06T04:31:59,ACC00006013,Credit,1999.59,-738501.46,USD,Starbucks
TXN0000004041,2024-03-08T02:29:00,ACC00007055,Debit,885.18,-739386.64,GBP,Grocery
TXN0000004042,2024-05-07T20:00:51,ACC00006869,Credit,1429.15,-737957.49,USD,Target
TXN0000004043,2024-08-25T23:38:03,ACC00007944,Debit,170.07,-738127.56,GBP,Online Store
TXN0000004044,2024-05-29T23:58:32,ACC00006206,Debit,1305.18,-739432.74,GBP,Shell
TXN0000004045,2024-05-15T17:58:56,ACC00009929,Debit,1998.1,-741430.84,GBP,Online Store
TXN0000004046,2024-11-12T12:07:17,ACC00005414,ATM,804.93,-742235.77,JPY,Starbucks
TXN0000004047,2024-01-28T23:33:34,ACC00009071,Debit,1606.8,-743842.57,JPY,Starbucks
TXN0000004048,2024-01-21T12:44:36,ACC00000216,Credit,1857.72,-741984.85,GBP,Target
TXN0000004049,2024-03-28T09:08:33,ACC00005840,Debit,698.48,-742683.33,EUR,Starbucks
TXN0000004050,2024-05-18T11:18:16,ACC00006246,ATM,211.6,-742894.93,USD,Amazon
TXN0000004051,2024-07-12T15:03:39,ACC00000777,Payment,975.66,-743870.59,JPY,Target
TXN0000004052,2024-12-20T23:54:16,ACC00008510,ATM,693.47,-744564.06,JPY,Starbucks
TXN0000004053,2024-06-29T15:00:19,ACC00009776,ATM,1952.14,-746516.2,GBP,Restaurant
TXN0000004054,2024-08-18T03:12:52,ACC00008144,Debit,1339.23,-747855.43,GBP,Grocery
TXN0000004055,2024-02-22T18:14:57,ACC00005711,Debit,1407.67,-749263.1,GBP,Starbucks
TXN0000004056,2024-09-10T06:26:07,ACC00005344,Transfer,387.5,-748875.6,GBP,Online Store
TXN0000004057,2024-12-01T01:06:52,ACC00003623,ATM,1740.25,-750615.85,JPY,Online Store
TXN0000004058,2024-08-23T22:28:58,ACC00000302,Payment,302.02,-750917.87,USD,Amazon
TXN0000004059,2024-06-11T04:12:42,ACC00008078,Debit,66.62,-750984.49,EUR,Grocery
TXN0000004060,2024-10-13T03:43:40,ACC00005012,ATM,1094.39,-752078.88,USD,Shell
TXN0000004061,2024-12-24T01:35:58,ACC00000121,Debit,1377.51,-753456.39,USD,Amazon
TXN0000004062,2024-01-10T15:35:45,ACC00009128,Transfer,660.07,-752796.32,GBP,Grocery
TXN0000004063,2024-07-15T01:53:17,ACC00000282,ATM,1863.57,-754659.89,GBP,Shell
TXN0000004064,2024-07-25T22:02:27,ACC00006850,ATM,1163.65,-755823.54,GBP,Online Store
TXN0000004065,2024-12-23T06:36:25,ACC00000498,Credit,1951.06,-753872.48,JPY,Target
TXN0000004066,2024-08-18T02:23:46,ACC00001175,ATM,1387.7,-755260.18,JPY,Starbucks
TXN0000004067,2024-05-20T13:26:38,ACC00008910,Credit,1259.64,-754000.54,GBP,Target
TXN0000004068,2024-09-01T04:05:04,ACC00000640,Transfer,184.95,-753815.59,GBP,Target
TXN0000004069,2024-01-12T21:34:44,ACC00006448,Credit,513.2,-753302.39,USD,Starbucks
TXN0000004070,2024-12-10T15:56:04,ACC00005468,Payment,178.89,-753481.28,EUR,Walmart
TXN0000004071,2024-12-30T21:16:46,ACC00003831,ATM,81.22,-753562.5,JPY,Amazon
TXN0000004072,2024-11-24T21:32:08,ACC00001167,ATM,758.2,-754320.7,USD,Shell
TXN0000004073,2024-06-15T16:01:35,ACC00003796,Credit,856.26,-753464.44,USD,Target
TXN0000004074,2024-03-16T17:21:29,ACC00003239,ATM,1595.13,-755059.57,JPY,Target
TXN0000004075,2024-03-04T05:41:26,ACC00007421,Debit,796.88,-755856.45,GBP,Amazon
TXN0000004076,2024-11-29T02:23:45,ACC00002015,ATM,966.34,-756822.79,GBP,Grocery
TXN0000004077,2024-04-03T10:58:25,ACC00005924,Payment,1725.85,-758548.64,GBP,Amazon
TXN0000004078,2024-06-20T01:10:53,ACC00001319,Debit,631.22,-759179.86,JPY,Restaurant
TXN0000004079,2024-11-29T03:17:56,ACC00004770,Credit,1016.12,-758163.74,JPY,Shell
TXN0000004080,2024-10-10T07:16:03,ACC00007909,ATM,452.34,-758616.08,EUR,Target
TXN0000004081,2024-05-09T01:49:03,ACC00007065,Credit,1339.42,-757276.66,GBP,Shell
TXN0000004082,2024-10-06T03:08:41,ACC00002356,Payment,138.12,-757414.78,USD,Restaurant
TXN0000004083,2024-11-27T07:07:07,ACC00005092,Credit,163.21,-757251.57,EUR,Grocery
TXN0000004084,2024-10-23T19:50:39,ACC00003134,Debit,131.86,-757383.43,JPY,Walmart
TXN0000004085,2024-11-15T22:07:58,ACC00002784,Payment,1201.04,-758584.47,EUR,Online Store
TXN0000004086,2024-09-09T11:51:59,ACC00004077,Transfer,1334.11,-757250.36,JPY,Online Store
TXN0000004087,2024-06-15T23:12:33,ACC00008550,Credit,1315.16,-755935.2,USD,Grocery
TXN0000004088,2024-07-02T08:34:03,ACC00000066,Payment,1505.9,-757441.1,GBP,Starbucks
TXN0000004089,2024-08-15T10:11:12,ACC00003392,ATM,212.28,-757653.38,GBP,Restaurant
TXN0000004090,2024-09-02T13:16:21,ACC00003389,Payment,1455.55,-759108.93,USD,Target
TXN0000004091,2024-04-26T08:33:40,ACC00000471,Payment,995.33,-760104.26,JPY,Online Store
TXN0000004092,2024-09-10T04:24:46,ACC00007602,Payment,842.47,-760946.73,GBP,Shell
TXN0000004093,2024-11-13T07:52:42,ACC00005930,Transfer,805.89,-760140.84,USD,Online Store
TXN0000004094,2024-11-27T00:41:26,ACC00009117,ATM,1110.54,-761251.38,EUR,Shell
TXN0000004095,2024-06-07T13:12:20,ACC00008889,Payment,1838.17,-763089.55,GBP,Restaurant
TXN0000004096,2024-10-29T03:42:53,ACC00000206,Credit,1517.35,-761572.2,EUR,Target
TXN0000004097,2024-12-23T09:25:10,ACC00001146,Credit,116.34,-761455.86,USD,Starbucks
TXN0000004098,2024-12-23T09:32:43,ACC00006693,Payment,1326.39,-762782.25,JPY,Shell
TXN0000004099,2024-10-04T07:46:27,ACC00000606,Transfer,572.1,-762210.15,GBP,Starbucks
TXN0000004100,2024-11-02T05:57:54,ACC00002151,Debit,610.19,-762820.34,JPY,Amazon
TXN0000004101,2024-06-28T21:11:16,ACC00004219,Credit,1262.33,-761558.01,GBP,Restaurant
TXN0000004102,2024-08-29T19:29:15,ACC00001340,Transfer,1510.56,-760047.45,USD,Grocery
TXN0000004103,2024-09-15T05:06:04,ACC00002670,Credit,1258.14,-758789.31,USD,Online Store
TXN0000004104,2024-04-15T04:23:18,ACC00008453,ATM,1934.86,-760724.17,USD,Online Store
TXN0000004105,2024-08-29T14:46:26,ACC00009769,ATM,1765.51,-762489.68,JPY,Online Store
TXN0000004106,2024-02-23T16:29:32,ACC00007071,Transfer,1325.93,-761163.75,JPY,Restaurant
TXN0000004107,2024-03-16T23:53:38,ACC00007499,Credit,855.6,-760308.15,USD,Online Store
TXN0000004108,2024-05-25T13:56:40,ACC00004110,ATM,1221.51,-761529.66,EUR,Grocery
TXN0000004109,2024-03-27T17:07:05,ACC00009548,Payment,608.62,-762138.28,JPY,Grocery
TXN0000004110,2024-04-28T00:22:31,ACC00002626,Payment,1462.26,-763600.54,USD,Restaurant
TXN0000004111,2024-12-30T04:03:30,ACC00001213,Credit,1670.52,-761930.02,GBP,Shell
TXN0000004112,2024-06-03T00:13:33,ACC00007097,Debit,1066.47,-762996.49,USD,Target
TXN0000004113,2024-01-17T10:21:06,ACC00006967,Payment,59.09,-763055.58,JPY,Grocery
TXN0000004114,2024-09-02T18:06:43,ACC00009953,Credit,1802.33,-761253.25,USD,Walmart
TXN0000004115,2024-06-27T22:37:06,ACC00007617,Credit,570.56,-760682.69,GBP,Amazon
TXN0000004116,2024-10-18T06:19:07,ACC00006419,ATM,1929.52,-762612.21,EUR,Shell
TXN0000004117,2024-12-28T10:50:37,ACC00002334,Credit,723.98,-761888.23,JPY,Restaurant
TXN0000004118,2024-09-21T18:47:20,ACC00003826,Credit,747.11,-761141.12,EUR,Online Store
TXN0000004119,2024-10-03T05:19:16,ACC00004786,Payment,1722.07,-762863.19,JPY,Online Store
TXN0000004120,2024-04-02T10:01:52,ACC00006584,Debit,328.91,-763192.1,GBP,Starbucks
TXN0000004121,2024-05-27T06:23:25,ACC00003994,Credit,1845.95,-761346.15,GBP,Restaurant
TXN0000004122,2024-02-04T07:44:59,ACC00009632,ATM,1881.16,-763227.31,EUR,Starbucks
TXN0000004123,2024-01-10T01:49:21,ACC00002759,Payment,1320.31,-764547.62,GBP,Online Store
TXN0000004124,2024-05-30T20:54:09,ACC00008441,Transfer,380.15,-764167.47,EUR,Grocery
TXN0000004125,2024-03-05T00:46:39,ACC00007033,ATM,1043.1,-765210.57,JPY,Shell
TXN0000004126,2024-07-07T00:36:06,ACC00004727,Payment,225.74,-765436.31,USD,Online Store
TXN0000004127,2024-12-18T19:31:32,ACC00005190,Payment,446.0,-765882.31,JPY,Target
TXN0000004128,2024-02-03T07:38:24,ACC00006769,Payment,345.61,-766227.92,JPY,Starbucks
TXN0000004129,2024-10-01T18:21:15,ACC00001179,Payment,1826.72,-768054.64,JPY,Target
TXN0000004130,2024-11-29T00:54:21,ACC00003046,Credit,818.13,-767236.51,GBP,Target
TXN0000004131,2024-10-19T09:56:16,ACC00005057,Transfer,356.79,-766879.72,JPY,Walmart
TXN0000004132,2024-10-31T13:37:43,ACC00001938,Debit,1623.85,-768503.57,EUR,Grocery
TXN0000004133,2024-05-17T22:29:19,ACC00009869,ATM,793.64,-769297.21,EUR,Starbucks
TXN0000004134,2024-03-31T22:41:05,ACC00005098,Transfer,885.19,-768412.02,EUR,Amazon
TXN0000004135,2024-02-08T19:13:58,ACC00008451,ATM,705.07,-769117.09,USD,Target
TXN0000004136,2024-04-24T02:20:51,ACC00000374,Credit,1104.22,-768012.87,JPY,Walmart
TXN0000004137,2024-07-29T19:19:25,ACC00002533,Payment,1764.74,-769777.61,GBP,Amazon
TXN0000004138,2024-07-03T17:34:02,ACC00005180,Payment,618.26,-770395.87,USD,Online Store
TXN0000004139,2024-04-20T19:48:49,ACC00008949,Debit,1507.99,-771903.86,USD,Amazon
TXN0000004140,2024-12-29T07:43:07,ACC00007873,Credit,511.94,-771391.92,USD,Restaurant
TXN0000004141,2024-01-20T23:34:33,ACC00001720,ATM,1669.92,-773061.84,JPY,Walmart
TXN0000004142,2024-08-28T03:18:33,ACC00000182,ATM,1056.02,-774117.86,GBP,Shell
TXN0000004143,2024-08-01T21:34:55,ACC00008764,Debit,1266.23,-775384.09,EUR,Online Store
TXN0000004144,2024-09-08T03:27:37,ACC00001005,Debit,1281.89,-776665.98,EUR,Walmart
TXN0000004145,2024-10-09T10:37:48,ACC00007012,Payment,510.75,-777176.73,USD,Restaurant
TXN0000004146,2024-07-16T14:27:03,ACC00004816,Payment,1058.9,-778235.63,GBP,Starbucks
TXN0000004147,2024-03-06T01:46:08,ACC00005040,Debit,120.54,-778356.17,USD,Walmart
TXN0000004148,2024-07-24T12:16:22,ACC00002873,Payment,862.82,-779218.99,EUR,Online Store
TXN0000004149,2024-03-09T22:43:14,ACC00009766,ATM,241.2,-779460.19,USD,Shell
TXN0000004150,2024-05-31T21:06:01,ACC00008405,Payment,173.75,-779633.94,GBP,Grocery
TXN0000004151,2024-11-25T17:05:34,ACC00009285,Payment,492.47,-780126.41,EUR,Restaurant
TXN0000004152,2024-05-06T20:20:42,ACC00006177,Payment,712.65,-780839.06,USD,Walmart
TXN0000004153,2024-01-13T15:03:54,ACC00006632,Debit,1378.82,-782217.88,EUR,Shell
TXN0000004154,2024-03-04T00:31:56,ACC00003975,Payment,1439.48,-783657.36,USD,Starbucks
TXN0000004155,2024-07-02T00:51:16,ACC00008900,Payment,1904.29,-785561.65,USD,Target
TXN0000004156,2024-08-02T23:18:56,ACC00006988,Transfer,344.86,-785216.79,USD,Shell
TXN0000004157,2024-04-23T02:09:02,ACC00009756,ATM,1623.02,-786839.81,JPY,Amazon
TXN0000004158,2024-07-21T21:39:01,ACC00006381,Transfer,761.37,-786078.44,USD,Grocery
TXN0000004159,2024-03-15T10:32:50,ACC00003330,Payment,216.5,-786294.94,GBP,Restaurant
TXN0000004160,2024-07-18T05:15:22,ACC00006089,Debit,525.62,-786820.56,USD,Shell
TXN0000004161,2024-12-23T03:30:09,ACC00008248,ATM,778.9,-787599.46,USD,Online Store
TXN0000004162,2024-06-28T19:39:53,ACC00002667,Transfer,377.95,-787221.51,GBP,Walmart
TXN0000004163,2024-12-21T12:13:05,ACC00007627,Credit,509.34,-786712.17,USD,Target
TXN0000004164,2024-04-12T22:09:26,ACC00008046,Debit,1930.64,-788642.81,USD,Starbucks
TXN0000004165,2024-04-18T02:59:13,ACC00005976,Debit,1148.01,-789790.82,EUR,Online Store
TXN0000004166,2024-12-14T12:55:52,ACC00006795,ATM,467.93,-790258.75,EUR,Restaurant
TXN0000004167,2024-10-03T14:22:57,ACC00007804,Payment,1404.91,-791663.66,EUR,Shell
TXN0000004168,2024-03-19T07:20:55,ACC00006460,Transfer,636.72,-791026.94,JPY,Walmart
TXN0000004169,2024-05-29T14:43:11,ACC00001576,Debit,1900.37,-792927.31,EUR,Shell
TXN0000004170,2024-05-21T01:52:30,ACC00000198,Transfer,216.8,-792710.51,JPY,Starbucks
TXN0000004171,2024-07-22T20:27:10,ACC00006617,Credit,1374.07,-791336.44,EUR,Grocery
TXN0000004172,2024-09-23T20:25:11,ACC00000732,Credit,1424.3,-789912.14,JPY,Walmart
TXN0000004173,2024-08-21T21:13:39,ACC00003741,Debit,1575.13,-791487.27,JPY,Target
TXN0000004174,2024-05-25T01:44:06,ACC00008945,Debit,1378.08,-792865.35,GBP,Amazon
TXN0000004175,2024-08-20T15:14:03,ACC00007975,Payment,377.2,-793242.55,USD,Amazon
TXN0000004176,2024-02-27T04:56:08,ACC00003641,Credit,1272.7,-791969.85,USD,Target
TXN0000004177,2024-07-06T19:42:27,ACC00009767,Credit,1346.88,-790622.97,USD,Walmart
TXN0000004178,2024-03-23T21:53:06,ACC00003346,ATM,1642.67,-792265.64,USD,Starbucks
TXN0000004179,2024-12-25T23:08:10,ACC00000745,Debit,750.88,-793016.52,JPY,Restaurant
TXN0000004180,2024-10-01T04:21:14,ACC00001528,Debit,1895.11,-794911.63,GBP,Starbucks
TXN0000004181,2024-04-13T16:48:32,ACC00003189,Transfer,1718.59,-793193.04,JPY,Shell
TXN0000004182,2024-10-28T15:42:29,ACC00000282,Debit,1392.28,-794585.32,JPY,Amazon
TXN0000004183,2024-09-23T12:44:50,ACC00003198,ATM,309.87,-794895.19,GBP,Grocery
TXN0000004184,2024-06-03T08:40:55,ACC00006831,Transfer,1381.64,-793513.55,EUR,Target
TXN0000004185,2024-02-06T07:05:43,ACC00007478,Transfer,1901.95,-791611.6,GBP,Online Store
TXN0000004186,2024-02-12T22:53:39,ACC00003280,Transfer,1769.25,-789842.35,GBP,Amazon
TXN0000004187,2024-03-17T11:07:04,ACC00004364,Debit,1926.83,-791769.18,GBP,Amazon
TXN0000004188,2024-12-10T10:25:48,ACC00008497,ATM,398.87,-792168.05,USD,Restaurant
TXN0000004189,2024-04-12T08:14:27,ACC00000185,Debit,959.4,-793127.45,GBP,Online Store
TXN0000004190,2024-05-04T10:24:24,ACC00008549,Transfer,1169.33,-791958.12,JPY,Walmart
TXN0000004191,2024-07-10T13:13:41,ACC00009773,Payment,1827.29,-793785.41,GBP,Target
TXN0000004192,2024-06-27T19:31:13,ACC00008308,Transfer,1156.07,-792629.34,EUR,Restaurant
TXN0000004193,2024-02-09T01:40:44,ACC00006065,Payment,549.63,-793178.97,EUR,Online Store
TXN0000004194,2024-03-12T03:32:27,ACC00001303,ATM,374.22,-793553.19,EUR,Shell
TXN0000004195,2024-05-24T07:58:50,ACC00008134,Credit,103.2,-793449.99,GBP,Starbucks
TXN0000004196,2024-04-11T08:07:23,ACC00006641,Payment,1874.47,-795324.46,JPY,Shell
TXN0000004197,2024-11-10T13:57:19,ACC00006335,ATM,1188.4,-796512.86,GBP,Walmart
TXN0000004198,2024-03-09T05:37:46,ACC00008586,Credit,1276.08,-795236.78,JPY,Restaurant
TXN0000004199,2024-06-11T01:24:23,ACC00001229,Credit,1547.91,-793688.87,EUR,Online Store
TXN0000004200,2024-12-19T08:37:47,ACC00006447,ATM,1275.34,-794964.21,EUR,Grocery
TXN0000004201,2024-03-07T18:43:30,ACC00006799,Credit,1935.33,-793028.88,USD,Starbucks
TXN0000004202,2024-11-30T19:37:09,ACC00002470,Payment,1066.18,-794095.06,USD,Walmart
TXN0000004203,2024-07-18T17:18:04,ACC00008570,Debit,672.35,-794767.41,JPY,Amazon
TXN0000004204,2024-05-12T10:56:34,ACC00004652,Payment,1687.05,-796454.46,GBP,Amazon
TXN0000004205,2024-02-19T17:30:29,ACC00000855,ATM,511.39,-796965.85,USD,Restaurant
TXN0000004206,2024-08-05T07:48:04,ACC00005309,Transfer,1545.57,-795420.28,GBP,Grocery
TXN0000004207,2024-05-21T01:58:16,ACC00005236,Transfer,279.9,-795140.38,GBP,Target
TXN0000004208,2024-02-13T12:57:34,ACC00007897,Credit,1617.27,-793523.11,GBP,Grocery
TXN0000004209,2024-04-12T04:09:16,ACC00006613,Credit,946.74,-792576.37,JPY,Target
TXN0000004210,2024-02-25T21:46:34,ACC00002496,Transfer,1901.46,-790674.91,USD,Walmart
TXN0000004211,2024-08-30T01:31:05,ACC00005391,ATM,1127.15,-791802.06,GBP,Walmart
TXN0000004212,2024-11-28T11:57:49,ACC00007343,Debit,478.9,-792280.96,EUR,Amazon
TXN0000004213,2024-04-22T09:20:40,ACC00004003,ATM,1116.36,-793397.32,USD,Grocery
TXN0000004214,2024-01-22T04:11:07,ACC00001074,Transfer,12.96,-793384.36,EUR,Starbucks
TXN0000004215,2024-11-22T04:48:48,ACC00009894,Credit,581.89,-792802.47,USD,Grocery
TXN0000004216,2024-10-26T08:13:53,ACC00005091,Payment,1729.7,-794532.17,EUR,Grocery
TXN0000004217,2024-03-01T00:28:33,ACC00003410,Transfer,1868.01,-792664.16,GBP,Restaurant
TXN0000004218,2024-04-08T17:39:43,ACC00006941,Debit,1844.46,-794508.62,USD,Shell
TXN0000004219,2024-07-28T07:52:56,ACC00001527,ATM,420.11,-794928.73,USD,Restaurant
TXN0000004220,2024-12-25T14:23:24,ACC00009733,Debit,142.09,-795070.82,EUR,Restaurant
TXN0000004221,2024-12-04T21:26:37,ACC00001291,Payment,339.43,-795410.25,GBP,Grocery
TXN0000004222,2024-06-08T13:04:42,ACC00006052,Transfer,1884.0,-793526.25,USD,Restaurant
TXN0000004223,2024-07-23T08:11:55,ACC00005409,Debit,341.95,-793868.2,GBP,Restaurant
TXN0000004224,2024-05-03T09:29:48,ACC00005511,ATM,1125.54,-794993.74,GBP,Restaurant
TXN0000004225,2024-08-24T04:05:38,ACC00009102,Transfer,514.25,-794479.49,GBP,Starbucks
TXN0000004226,2024-08-01T04:10:38,ACC00000790,Transfer,1158.52,-793320.97,JPY,Starbucks
TXN0000004227,2024-11-18T12:18:25,ACC00003657,Credit,315.21,-793005.76,EUR,Shell
TXN0000004228,2024-08-28T11:14:04,ACC00001364,Payment,1933.13,-794938.89,GBP,Amazon
TXN0000004229,2024-03-29T12:53:01,ACC00007724,Transfer,1260.18,-793678.71,USD,Restaurant
TXN0000004230,2024-06-25T10:44:53,ACC00007157,Credit,1392.18,-792286.53,USD,Restaurant
TXN0000004231,2024-03-25T08:25:07,ACC00009157,Debit,367.65,-792654.18,USD,Amazon
TXN0000004232,2024-12-16T13:45:52,ACC00007844,Payment,1478.96,-794133.14,EUR,Starbucks
TXN0000004233,2024-06-09T05:11:27,ACC00001271,Payment,1674.71,-795807.85,JPY,Online Store
TXN0000004234,2024-11-05T14:13:00,ACC00005060,Transfer,1188.72,-794619.13,USD,Amazon
TXN0000004235,2024-09-29T12:07:21,ACC00008237,Transfer,1513.33,-793105.8,EUR,Starbucks
TXN0000004236,2024-05-17T23:46:03,ACC00008657,ATM,1859.89,-794965.69,GBP,Walmart
TXN0000004237,2024-10-19T14:25:58,ACC00003960,Payment,410.92,-795376.61,JPY,Walmart
TXN0000004238,2024-09-19T11:35:11,ACC00002797,Debit,544.03,-795920.64,EUR,Shell
TXN0000004239,2024-05-06T18:23:34,ACC00009180,Payment,1102.48,-797023.12,JPY,Online Store
TXN0000004240,2024-09-08T06:02:56,ACC00006195,ATM,1013.37,-798036.49,GBP,Grocery
TXN0000004241,2024-05-04T07:28:51,ACC00003319,Payment,22.07,-798058.56,USD,Restaurant
TXN0000004242,2024-08-26T03:01:11,ACC00002387,Transfer,1323.84,-796734.72,EUR,Restaurant
TXN0000004243,2024-07-14T20:28:04,ACC00009137,Credit,1216.24,-795518.48,USD,Target
TXN0000004244,2024-01-30T13:39:18,ACC00006922,ATM,1493.05,-797011.53,EUR,Amazon
TXN0000004245,2024-03-26T13:54:34,ACC00002541,Payment,1570.68,-798582.21,USD,Amazon
TXN0000004246,2024-07-28T03:47:26,ACC00000021,Payment,1122.75,-799704.96,JPY,Walmart
TXN0000004247,2024-11-11T06:06:32,ACC00006478,ATM,1709.99,-801414.95,GBP,Starbucks
TXN0000004248,2024-06-12T07:14:23,ACC00002036,ATM,1673.18,-803088.13,EUR,Amazon
TXN0000004249,2024-04-08T18:20:57,ACC00001822,Credit,923.83,-802164.3,JPY,Online Store
TXN0000004250,2024-11-01T05:31:19,ACC00003347,Debit,1209.71,-803374.01,USD,Restaurant
TXN0000004251,2024-05-24T19:26:10,ACC00001581,Payment,208.59,-803582.6,GBP,Target
TXN0000004252,2024-04-21T01:14:44,ACC00008813,Transfer,634.75,-802947.85,JPY,Starbucks
TXN0000004253,2024-01-20T04:17:22,ACC00005773,Transfer,397.24,-802550.61,EUR,Target
TXN0000004254,2024-08-24T05:59:58,ACC00004217,Debit,1119.6,-803670.21,JPY,Target
TXN0000004255,2024-06-03T13:40:37,ACC00008817,Credit,301.93,-803368.28,USD,Amazon
TXN0000004256,2024-10-04T22:59:44,ACC00004056,Debit,1447.63,-804815.91,JPY,Amazon
TXN0000004257,2024-07-02T07:56:20,ACC00005514,Transfer,1077.36,-803738.55,USD,Online Store
TXN0000004258,2024-03-13T01:19:28,ACC00001632,Debit,458.14,-804196.69,JPY,Shell
TXN0000004259,2024-06-05T17:38:35,ACC00006618,Transfer,1665.77,-802530.92,GBP,Shell
TXN0000004260,2024-10-28T04:50:26,ACC00007002,Debit,92.64,-802623.56,GBP,Grocery
TXN0000004261,2024-03-03T09:59:09,ACC00003710,Credit,754.97,-801868.59,EUR,Restaurant
TXN0000004262,2024-01-21T05:39:51,ACC00002951,ATM,1559.07,-803427.66,USD,Starbucks
TXN0000004263,2024-07-14T03:41:33,ACC00008822,Debit,704.77,-804132.43,USD,Restaurant
TXN0000004264,2024-01-02T01:32:22,ACC00006014,Payment,1654.03,-805786.46,USD,Online Store
TXN0000004265,2024-08-20T12:40:50,ACC00006920,Credit,866.55,-804919.91,GBP,Online Store
TXN0000004266,2024-04-19T23:39:35,ACC00008262,Debit,1614.07,-806533.98,USD,Restaurant
TXN0000004267,2024-11-18T05:22:06,ACC00007046,Debit,1588.43,-808122.41,JPY,Amazon
TXN0000004268,2024-04-07T08:35:38,ACC00008601,Debit,348.75,-808471.16,USD,Grocery
TXN0000004269,2024-04-26T20:50:54,ACC00002528,Payment,1740.53,-810211.69,USD,Target
TXN0000004270,2024-06-10T04:26:46,ACC00003343,Transfer,1295.97,-808915.72,JPY,Amazon
TXN0000004271,2024-07-31T18:08:21,ACC00004095,ATM,1027.91,-809943.63,JPY,Grocery
TXN0000004272,2024-08-03T23:17:51,ACC00003031,Payment,1101.27,-811044.9,EUR,Grocery
TXN0000004273,2024-11-21T04:22:52,ACC00008592,Credit,1936.36,-809108.54,GBP,Amazon
TXN0000004274,2024-02-20T21:25:08,ACC00009867,Transfer,1883.2,-807225.34,JPY,Starbucks
TXN0000004275,2024-03-01T11:23:37,ACC00004995,Credit,550.54,-806674.8,EUR,Target
TXN0000004276,2024-09-14T11:02:27,ACC00000750,Payment,628.18,-807302.98,EUR,Starbucks
TXN0000004277,2024-03-10T22:27:44,ACC00005244,Debit,1347.83,-808650.81,JPY,Online Store
TXN0000004278,2024-06-11T13:15:08,ACC00009329,Credit,1876.63,-806774.18,EUR,Grocery
TXN0000004279,2024-07-12T13:34:01,ACC00005501,Debit,1135.7,-807909.88,GBP,Starbucks
TXN0000004280,2024-07-02T01:39:55,ACC00000761,Transfer,808.8,-807101.08,GBP,Restaurant
TXN0000004281,2024-11-06T07:15:02,ACC00004737,Transfer,581.6,-806519.48,USD,Starbucks
TXN0000004282,2024-08-22T09:05:29,ACC00007398,Debit,920.46,-807439.94,GBP,Grocery
TXN0000004283,2024-05-01T21:25:08,ACC00006256,Transfer,978.32,-806461.62,EUR,Amazon
TXN0000004284,2024-02-13T21:39:40,ACC00007171,Credit,331.59,-806130.03,EUR,Target
TXN0000004285,2024-10-13T15:49:50,ACC00003929,Transfer,672.89,-805457.14,JPY,Starbucks
TXN0000004286,2024-06-15T16:57:23,ACC00004882,Debit,75.32,-805532.46,EUR,Online Store
TXN0000004287,2024-07-27T17:06:28,ACC00006069,Payment,545.67,-806078.13,GBP,Walmart
TXN0000004288,2024-08-16T15:10:41,ACC00005080,Debit,1801.72,-807879.85,USD,Amazon
TXN0000004289,2024-01-16T08:03:00,ACC00007161,Debit,1690.48,-809570.33,USD,Amazon
TXN0000004290,2024-07-22T01:53:50,ACC00007078,ATM,572.94,-810143.27,EUR,Target
TXN0000004291,2024-06-21T23:24:45,ACC00002338,Transfer,1416.08,-808727.19,USD,Walmart
TXN0000004292,2024-09-25T08:58:26,ACC00003918,Credit,1963.43,-806763.76,USD,Starbucks
TXN0000004293,2024-12-21T08:34:07,ACC00003616,Transfer,135.6,-806628.16,JPY,Grocery
TXN0000004294,2024-08-17T05:56:30,ACC00006981,Debit,501.71,-807129.87,USD,Grocery
TXN0000004295,2024-08-16T09:40:41,ACC00007264,Debit,1716.03,-808845.9,JPY,Walmart
TXN0000004296,2024-07-14T12:07:55,ACC00001781,Payment,159.47,-809005.37,GBP,Amazon
TXN0000004297,2024-07-01T07:46:19,ACC00008895,ATM,1650.53,-810655.9,EUR,Amazon
TXN0000004298,2024-08-09T11:26:09,ACC00000542,Credit,895.39,-809760.51,EUR,Target
TXN0000004299,2024-12-06T04:11:56,ACC00001841,Transfer,1388.94,-808371.57,EUR,Grocery
TXN0000004300,2024-01-14T13:45:27,ACC00009698,Transfer,374.2,-807997.37,JPY,Target
TXN0000004301,2024-02-15T05:36:27,ACC00007331,ATM,1408.78,-809406.15,USD,Walmart
TXN0000004302,2024-07-31T16:50:52,ACC00005335,Transfer,1012.28,-808393.87,JPY,Restaurant
TXN0000004303,2024-03-28T15:21:05,ACC00009432,ATM,735.91,-809129.78,JPY,Amazon
TXN0000004304,2024-03-07T19:45:10,ACC00008753,Transfer,1434.22,-807695.56,JPY,Starbucks
TXN0000004305,2024-02-16T20:21:13,ACC00000042,ATM,224.69,-807920.25,GBP,Shell
TXN0000004306,2024-06-30T10:23:35,ACC00009628,Payment,1051.46,-808971.71,GBP,Amazon
TXN0000004307,2024-02-01T22:35:25,ACC00000548,Debit,1031.82,-810003.53,EUR,Amazon
TXN0000004308,2024-06-13T09:48:48,ACC00005671,Debit,1000.76,-811004.29,GBP,Shell
TXN0000004309,2024-12-30T09:02:17,ACC00000393,ATM,1482.11,-812486.4,JPY,Target
TXN0000004310,2024-08-17T06:34:45,ACC00005165,Credit,724.41,-811761.99,GBP,Shell
TXN0000004311,2024-10-30T11:01:01,ACC00003596,Debit,1459.83,-813221.82,USD,Shell
TXN0000004312,2024-11-12T11:53:26,ACC00000866,Payment,1123.2,-814345.02,JPY,Grocery
TXN0000004313,2024-02-24T21:09:50,ACC00004383,Debit,728.99,-815074.01,USD,Shell
TXN0000004314,2024-10-12T08:50:36,ACC00005411,Credit,1922.71,-813151.3,USD,Grocery
TXN0000004315,2024-02-09T20:27:44,ACC00004902,Transfer,1273.57,-811877.73,GBP,Amazon
TXN0000004316,2024-02-07T02:46:16,ACC00005746,Transfer,1344.95,-810532.78,JPY,Amazon
TXN0000004317,2024-11-12T11:32:48,ACC00007969,Payment,1313.35,-811846.13,EUR,Starbucks
TXN0000004318,2024-08-29T03:04:35,ACC00001573,Transfer,284.24,-811561.89,USD,Starbucks
TXN0000004319,2024-10-24T08:14:07,ACC00008106,Debit,378.72,-811940.61,GBP,Starbucks
TXN0000004320,2024-07-24T10:20:41,ACC00007139,Payment,1626.75,-813567.36,GBP,Grocery
TXN0000004321,2024-07-15T06:21:36,ACC00007650,Transfer,39.31,-813528.05,GBP,Amazon
TXN0000004322,2024-03-03T02:07:32,ACC00007297,Debit,348.49,-813876.54,EUR,Amazon
TXN0000004323,2024-11-10T18:18:02,ACC00004976,Credit,813.87,-813062.67,USD,Amazon
TXN0000004324,2024-11-07T12:37:31,ACC00004789,Transfer,1327.9,-811734.77,JPY,Grocery
TXN0000004325,2024-02-05T13:36:19,ACC00006713,ATM,1041.9,-812776.67,GBP,Walmart
TXN0000004326,2024-03-26T01:09:19,ACC00009860,Debit,1903.39,-814680.06,GBP,Starbucks
TXN0000004327,2024-03-22T09:22:35,ACC00001508,Credit,1760.27,-812919.79,EUR,Target
TXN0000004328,2024-11-11T18:59:17,ACC00003725,ATM,358.0,-813277.79,EUR,Restaurant
TXN0000004329,2024-11-16T19:31:29,ACC00009837,Credit,1872.94,-811404.85,GBP,Walmart
TXN0000004330,2024-05-09T09:16:06,ACC00006018,Payment,841.53,-812246.38,USD,Shell
TXN0000004331,2024-11-05T22:22:51,ACC00000968,Credit,504.79,-811741.59,EUR,Online Store
TXN0000004332,2024-09-11T02:33:16,ACC00004875,Transfer,269.92,-811471.67,EUR,Grocery
TXN0000004333,2024-12-21T14:27:41,ACC00009433,Credit,1632.67,-809839.0,EUR,Amazon
TXN0000004334,2024-12-07T09:42:55,ACC00004293,Payment,590.92,-810429.92,JPY,Shell
TXN0000004335,2024-02-24T22:36:27,ACC00007632,Transfer,537.09,-809892.83,GBP,Restaurant
TXN0000004336,2024-06-10T21:35:52,ACC00008863,Payment,918.61,-810811.44,JPY,Restaurant
TXN0000004337,2024-05-25T22:30:23,ACC00004141,Payment,1331.19,-812142.63,JPY,Amazon
TXN0000004338,2024-04-04T06:26:06,ACC00008232,Transfer,58.47,-812084.16,JPY,Restaurant
TXN0000004339,2024-08-16T21:25:35,ACC00000152,Debit,667.78,-812751.94,USD,Grocery
TXN0000004340,2024-07-03T14:22:51,ACC00000408,ATM,1542.54,-814294.48,JPY,Grocery
TXN0000004341,2024-05-29T12:46:57,ACC00003426,Credit,1769.31,-812525.17,EUR,Online Store
TXN0000004342,2024-11-12T00:26:37,ACC00000027,ATM,86.15,-812611.32,USD,Grocery
TXN0000004343,2024-10-12T01:38:54,ACC00006317,Payment,159.96,-812771.28,JPY,Starbucks
TXN0000004344,2024-04-01T01:17:58,ACC00009248,Debit,1997.39,-814768.67,EUR,Shell
TXN0000004345,2024-10-05T05:59:44,ACC00002033,Payment,1567.24,-816335.91,EUR,Amazon
TXN0000004346,2024-02-27T08:38:46,ACC00006150,Payment,439.57,-816775.48,EUR,Restaurant
TXN0000004347,2024-01-28T17:58:50,ACC00004494,Payment,57.5,-816832.98,GBP,Walmart
TXN0000004348,2024-11-20T11:50:38,ACC00008021,Debit,1309.87,-818142.85,JPY,Starbucks
TXN0000004349,2024-01-05T10:39:45,ACC00004190,Payment,1793.98,-819936.83,JPY,Grocery
TXN0000004350,2024-11-22T13:31:31,ACC00000720,Debit,1627.07,-821563.9,JPY,Walmart
TXN0000004351,2024-04-19T16:56:12,ACC00005258,Credit,183.29,-821380.61,USD,Amazon
TXN0000004352,2024-09-05T21:17:37,ACC00007884,Debit,1296.16,-822676.77,EUR,Online Store
TXN0000004353,2024-08-06T09:19:39,ACC00007023,Credit,1766.0,-820910.77,USD,Target
TXN0000004354,2024-08-24T00:48:50,ACC00003407,Transfer,356.61,-820554.16,USD,Online Store
TXN0000004355,2024-02-17T08:20:25,ACC00004460,Credit,993.53,-819560.63,USD,Starbucks
TXN0000004356,2024-07-22T02:59:05,ACC00005211,Debit,689.82,-820250.45,USD,Amazon
TXN0000004357,2024-02-10T03:04:31,ACC00001742,Payment,107.89,-820358.34,EUR,Shell
TXN0000004358,2024-06-20T16:47:28,ACC00009268,ATM,841.55,-821199.89,EUR,Amazon
TXN0000004359,2024-03-17T17:37:16,ACC00007952,ATM,1838.94,-823038.83,EUR,Starbucks
TXN0000004360,2024-02-19T22:53:37,ACC00004314,Transfer,1508.4,-821530.43,GBP,Restaurant
TXN0000004361,2024-03-16T05:55:57,ACC00009439,Credit,396.46,-821133.97,EUR,Online Store
TXN0000004362,2024-04-11T08:23:45,ACC00008683,ATM,364.32,-821498.29,USD,Target
TXN0000004363,2024-01-22T00:03:44,ACC00007412,Credit,839.88,-820658.41,GBP,Starbucks
TXN0000004364,2024-05-02T14:46:08,ACC00009205,Payment,657.69,-821316.1,EUR,Starbucks
TXN0000004365,2024-05-31T08:31:41,ACC00007872,Debit,1851.55,-823167.65,USD,Starbucks
TXN0000004366,2024-08-30T22:39:52,ACC00004049,Debit,1648.91,-824816.56,USD,Target
TXN0000004367,2024-12-22T03:48:03,ACC00001010,Debit,1541.32,-826357.88,JPY,Walmart
TXN0000004368,2024-06-18T00:10:47,ACC00006966,Payment,1244.99,-827602.87,GBP,Shell
TXN0000004369,2024-06-12T12:48:09,ACC00006255,Credit,1788.49,-825814.38,EUR,Shell
TXN0000004370,2024-05-21T11:40:11,ACC00007830,Payment,886.08,-826700.46,EUR,Shell
TXN0000004371,2024-05-23T00:41:43,ACC00008237,ATM,1769.83,-828470.29,JPY,Starbucks
TXN0000004372,2024-03-22T20:44:14,ACC00002344,Debit,76.2,-828546.49,EUR,Online Store
TXN0000004373,2024-01-18T08:51:02,ACC00005015,Payment,1526.38,-830072.87,USD,Amazon
TXN0000004374,2024-04-30T06:19:37,ACC00004289,Credit,1423.64,-828649.23,USD,Amazon
TXN0000004375,2024-10-24T15:09:25,ACC00003139,Payment,1090.22,-829739.45,USD,Starbucks
TXN0000004376,2024-06-06T16:29:56,ACC00008017,Debit,1617.23,-831356.68,EUR,Grocery
TXN0000004377,2024-07-20T02:45:11,ACC00005436,Transfer,165.17,-831191.51,JPY,Online Store
TXN0000004378,2024-02-08T17:41:28,ACC00002025,ATM,1937.42,-833128.93,JPY,Online Store
TXN0000004379,2024-08-27T03:18:49,ACC00003757,Payment,72.17,-833201.1,USD,Online Store
TXN0000004380,2024-05-24T23:10:55,ACC00008903,ATM,744.05,-833945.15,GBP,Grocery
TXN0000004381,2024-07-25T16:41:49,ACC00009192,Credit,1131.78,-832813.37,GBP,Shell
TXN0000004382,2024-12-28T05:40:14,ACC00001641,Transfer,387.01,-832426.36,EUR,Starbucks
TXN0000004383,2024-05-19T09:02:54,ACC00004570,Credit,1394.51,-831031.85,EUR,Shell
TXN0000004384,2024-08-23T19:18:45,ACC00006247,Payment,129.05,-831160.9,EUR,Target
TXN0000004385,2024-08-19T17:40:27,ACC00008552,Payment,915.53,-832076.43,EUR,Amazon
TXN0000004386,2024-11-03T16:41:34,ACC00000870,Credit,257.88,-831818.55,JPY,Online Store
TXN0000004387,2024-04-21T00:58:39,ACC00008287,ATM,1522.36,-833340.91,USD,Target
TXN0000004388,2024-01-22T05:27:05,ACC00005987,Payment,1947.37,-835288.28,GBP,Amazon
TXN0000004389,2024-02-25T09:01:44,ACC00000543,Credit,150.08,-835138.2,USD,Amazon
TXN0000004390,2024-10-14T00:44:06,ACC00001555,Transfer,1793.84,-833344.36,GBP,Grocery
TXN0000004391,2024-05-16T11:00:13,ACC00007849,Transfer,1509.74,-831834.62,EUR,Grocery
TXN0000004392,2024-03-23T14:13:28,ACC00005446,Debit,70.05,-831904.67,USD,Grocery
TXN0000004393,2024-08-07T06:59:02,ACC00003287,Transfer,1272.87,-830631.8,JPY,Shell
TXN0000004394,2024-08-30T12:05:21,ACC00009520,Credit,778.56,-829853.24,USD,Target
TXN0000004395,2024-09-17T16:30:52,ACC00006805,Payment,757.3,-830610.54,GBP,Amazon
TXN0000004396,2024-09-29T04:50:35,ACC00002222,Debit,750.69,-831361.23,GBP,Restaurant
TXN0000004397,2024-05-03T04:48:55,ACC00002037,Payment,274.23,-831635.46,USD,Amazon
TXN0000004398,2024-05-02T05:55:01,ACC00009235,Payment,1580.71,-833216.17,JPY,Shell
TXN0000004399,2024-09-23T23:07:46,ACC00008795,ATM,941.83,-834158.0,USD,Restaurant
TXN0000004400,2024-09-13T09:33:01,ACC00004446,Debit,1824.39,-835982.39,JPY,Online Store
TXN0000004401,2024-12-19T08:57:19,ACC00000381,Debit,306.76,-836289.15,GBP,Target
TXN0000004402,2024-10-30T10:13:31,ACC00009562,Payment,1572.08,-837861.23,GBP,Restaurant
TXN0000004403,2024-11-08T08:24:05,ACC00001755,Credit,1807.61,-836053.62,USD,Walmart
TXN0000004404,2024-01-19T08:42:48,ACC00005883,Credit,1818.04,-834235.58,EUR,Amazon
TXN0000004405,2024-05-23T07:46:23,ACC00009314,Credit,216.15,-834019.43,USD,Target
TXN0000004406,2024-07-28T12:54:07,ACC00003206,Debit,220.25,-834239.68,JPY,Grocery
TXN0000004407,2024-12-29T04:53:29,ACC00008680,Payment,1981.12,-836220.8,EUR,Grocery
TXN0000004408,2024-12-12T23:54:06,ACC00007538,ATM,1364.15,-837584.95,JPY,Walmart
TXN0000004409,2024-06-07T10:50:32,ACC00007800,ATM,135.53,-837720.48,JPY,Amazon
TXN0000004410,2024-04-15T08:18:12,ACC00003357,ATM,1407.32,-839127.8,EUR,Restaurant
TXN0000004411,2024-01-24T00:41:30,ACC00000589,Transfer,970.85,-838156.95,USD,Shell
TXN0000004412,2024-06-05T22:00:30,ACC00002378,ATM,1077.71,-839234.66,EUR,Amazon
TXN0000004413,2024-06-07T06:47:21,ACC00008576,ATM,346.23,-839580.89,USD,Amazon
TXN0000004414,2024-12-23T00:39:53,ACC00008579,Transfer,1376.25,-838204.64,USD,Target
TXN0000004415,2024-12-13T09:03:16,ACC00006412,Credit,217.63,-837987.01,JPY,Target
TXN0000004416,2024-04-16T07:04:28,ACC00001023,Credit,1300.63,-836686.38,JPY,Online Store
TXN0000004417,2024-05-13T03:49:57,ACC00002080,Transfer,932.27,-835754.11,JPY,Target
TXN0000004418,2024-11-16T23:46:16,ACC00002372,Credit,530.68,-835223.43,EUR,Target
TXN0000004419,2024-03-17T22:00:40,ACC00006181,ATM,1339.51,-836562.94,JPY,Online Store
TXN0000004420,2024-09-02T15:35:26,ACC00004873,Debit,293.66,-836856.6,USD,Target
TXN0000004421,2024-07-30T00:31:43,ACC00009875,ATM,235.91,-837092.51,JPY,Shell
TXN0000004422,2024-04-24T03:25:12,ACC00002514,Payment,1186.37,-838278.88,EUR,Shell
TXN0000004423,2024-06-05T07:31:41,ACC00003092,ATM,515.38,-838794.26,JPY,Walmart
TXN0000004424,2024-06-18T19:47:27,ACC00009984,Credit,1155.96,-837638.3,USD,Amazon
TXN0000004425,2024-09-25T19:27:35,ACC00000699,Credit,1900.14,-835738.16,JPY,Target
TXN0000004426,2024-04-27T06:00:53,ACC00009088,ATM,10.67,-835748.83,USD,Amazon
TXN0000004427,2024-11-23T02:49:58,ACC00004629,Payment,270.15,-836018.98,GBP,Walmart
TXN0000004428,2024-09-01T06:38:03,ACC00004301,Debit,630.51,-836649.49,JPY,Amazon
TXN0000004429,2024-07-03T23:26:07,ACC00005412,Debit,339.53,-836989.02,GBP,Starbucks
TXN0000004430,2024-02-02T22:32:09,ACC00005804,ATM,1557.55,-838546.57,JPY,Amazon
TXN0000004431,2024-09-07T20:58:43,ACC00007255,ATM,30.56,-838577.13,USD,Target
TXN0000004432,2024-06-06T02:56:52,ACC00003083,ATM,232.27,-838809.4,USD,Amazon
TXN0000004433,2024-07-27T20:12:35,ACC00006822,Transfer,127.57,-838681.83,JPY,Target
TXN0000004434,2024-04-29T18:30:35,ACC00000114,Debit,338.63,-839020.46,GBP,Target
TXN0000004435,2024-02-20T14:46:47,ACC00003378,ATM,793.19,-839813.65,JPY,Amazon
TXN0000004436,2024-09-01T04:46:01,ACC00008063,ATM,576.81,-840390.46,EUR,Walmart
TXN0000004437,2024-05-02T08:46:17,ACC00006321,Payment,205.35,-840595.81,JPY,Starbucks
TXN0000004438,2024-09-09T03:12:18,ACC00007859,ATM,925.4,-841521.21,USD,Amazon
TXN0000004439,2024-05-25T14:40:04,ACC00000804,Credit,485.6,-841035.61,JPY,Amazon
TXN0000004440,2024-10-11T20:47:33,ACC00006713,ATM,1992.71,-843028.32,JPY,Restaurant
TXN0000004441,2024-12-24T07:52:55,ACC00008242,Credit,295.22,-842733.1,GBP,Amazon
TXN0000004442,2024-09-28T21:05:11,ACC00002207,Credit,1444.52,-841288.58,USD,Amazon
TXN0000004443,2024-07-05T03:29:13,ACC00003442,Debit,1337.59,-842626.17,GBP,Grocery
TXN0000004444,2024-04-02T13:50:40,ACC00005657,ATM,1964.29,-844590.46,JPY,Walmart
TXN0000004445,2024-05-29T17:44:01,ACC00005017,Transfer,1401.25,-843189.21,USD,Shell
TXN0000004446,2024-08-10T09:31:13,ACC00002412,Debit,722.11,-843911.32,GBP,Target
TXN0000004447,2024-10-06T03:02:45,ACC00004583,Debit,996.22,-844907.54,USD,Target
TXN0000004448,2024-11-07T08:04:28,ACC00003628,Payment,1258.94,-846166.48,GBP,Grocery
TXN0000004449,2024-03-28T11:46:36,ACC00000991,Debit,1927.56,-848094.04,GBP,Amazon
TXN0000004450,2024-01-26T02:57:21,ACC00002299,Transfer,298.8,-847795.24,JPY,Shell
TXN0000004451,2024-08-31T21:23:07,ACC00003670,Payment,823.34,-848618.58,EUR,Grocery
TXN0000004452,2024-08-26T04:42:34,ACC00008139,Debit,345.58,-848964.16,USD,Shell
TXN0000004453,2024-10-21T11:39:04,ACC00003331,Credit,1062.34,-847901.82,GBP,Target
TXN0000004454,2024-02-10T02:54:34,ACC00003867,ATM,576.72,-848478.54,USD,Starbucks
TXN0000004455,2024-04-12T15:41:18,ACC00007161,ATM,20.64,-848499.18,JPY,Restaurant
TXN0000004456,2024-09-25T10:34:48,ACC00007321,Payment,204.96,-848704.14,GBP,Grocery
TXN0000004457,2024-11-28T08:27:46,ACC00002116,Payment,1698.96,-850403.1,EUR,Grocery
TXN0000004458,2024-04-20T23:34:32,ACC00000634,Credit,1999.8,-848403.3,USD,Restaurant
TXN0000004459,2024-01-12T19:52:26,ACC00003328,Transfer,997.72,-847405.58,GBP,Restaurant
TXN0000004460,2024-01-24T01:56:21,ACC00007059,Debit,249.86,-847655.44,JPY,Starbucks
TXN0000004461,2024-02-15T08:55:36,ACC00008238,Credit,598.29,-847057.15,EUR,Amazon
TXN0000004462,2024-05-13T23:53:13,ACC00000361,ATM,1914.27,-848971.42,EUR,Online Store
TXN0000004463,2024-05-26T07:05:24,ACC00006745,Credit,447.41,-848524.01,USD,Online Store
TXN0000004464,2024-02-12T17:19:33,ACC00000061,Transfer,136.5,-848387.51,GBP,Walmart
TXN0000004465,2024-12-18T16:36:24,ACC00001005,ATM,1181.8,-849569.31,JPY,Restaurant
TXN0000004466,2024-06-14T08:20:36,ACC00005225,ATM,579.1,-850148.41,JPY,Online Store
TXN0000004467,2024-07-30T20:00:38,ACC00001379,ATM,524.9,-850673.31,GBP,Shell
TXN0000004468,2024-03-12T20:27:13,ACC00003918,Credit,609.74,-850063.57,USD,Restaurant
TXN0000004469,2024-07-04T01:21:58,ACC00001598,Credit,1861.78,-848201.79,JPY,Grocery
TXN0000004470,2024-04-05T15:15:55,ACC00004215,Transfer,1799.86,-846401.93,JPY,Restaurant
TXN0000004471,2024-02-02T11:44:15,ACC00001630,Transfer,127.59,-846274.34,USD,Shell
TXN0000004472,2024-07-28T08:07:01,ACC00009922,Transfer,1987.63,-844286.71,EUR,Restaurant
TXN0000004473,2024-04-28T22:09:37,ACC00009720,Credit,1170.84,-843115.87,GBP,Restaurant
TXN0000004474,2024-12-10T05:15:50,ACC00005177,ATM,1267.1,-844382.97,GBP,Shell
TXN0000004475,2024-02-18T10:46:12,ACC00007856,Debit,269.17,-844652.14,GBP,Amazon
TXN0000004476,2024-10-13T19:57:11,ACC00008570,Debit,1633.48,-846285.62,GBP,Shell
TXN0000004477,2024-08-02T21:13:38,ACC00007106,Debit,10.84,-846296.46,USD,Shell
TXN0000004478,2024-09-22T19:26:02,ACC00008059,Credit,1823.54,-844472.92,EUR,Grocery
TXN0000004479,2024-11-18T23:20:12,ACC00003593,ATM,945.31,-845418.23,EUR,Starbucks
TXN0000004480,2024-06-27T15:58:31,ACC00000762,Payment,917.1,-846335.33,USD,Walmart
TXN0000004481,2024-06-23T00:14:57,ACC00006178,Debit,27.83,-846363.16,GBP,Starbucks
TXN0000004482,2024-09-25T02:22:52,ACC00001398,Transfer,1518.58,-844844.58,JPY,Starbucks
TXN0000004483,2024-12-19T10:06:55,ACC00004448,Payment,1461.22,-846305.8,JPY,Shell
TXN0000004484,2024-12-25T07:59:07,ACC00007270,Transfer,1635.97,-844669.83,JPY,Shell
TXN0000004485,2024-05-30T22:30:36,ACC00006351,Payment,781.39,-845451.22,USD,Shell
TXN0000004486,2024-05-06T15:42:57,ACC00004071,Credit,1901.44,-843549.78,EUR,Online Store
TXN0000004487,2024-07-03T03:33:08,ACC00004658,Payment,264.31,-843814.09,EUR,Online Store
TXN0000004488,2024-12-21T03:00:02,ACC00006494,Debit,371.98,-844186.07,GBP,Grocery
TXN0000004489,2024-09-01T07:16:17,ACC00001708,Payment,47.45,-844233.52,EUR,Amazon
TXN0000004490,2024-01-17T08:54:03,ACC00004809,Debit,964.42,-845197.94,EUR,Walmart
TXN0000004491,2024-07-28T04:56:27,ACC00009828,Credit,1289.96,-843907.98,EUR,Online Store
TXN0000004492,2024-02-22T03:49:29,ACC00007885,Transfer,317.77,-843590.21,USD,Walmart
TXN0000004493,2024-07-30T09:24:57,ACC00003379,Transfer,1936.88,-841653.33,JPY,Starbucks
TXN0000004494,2024-11-21T14:41:07,ACC00009275,Credit,1377.91,-840275.42,USD,Target
TXN0000004495,2024-01-19T05:35:07,ACC00005634,Credit,725.04,-839550.38,EUR,Grocery
TXN0000004496,2024-08-03T04:38:49,ACC00008934,Debit,1878.74,-841429.12,JPY,Grocery
TXN0000004497,2024-03-08T13:49:25,ACC00007529,Transfer,518.62,-840910.5,USD,Amazon
TXN0000004498,2024-07-24T11:10:10,ACC00007022,ATM,850.83,-841761.33,JPY,Restaurant
TXN0000004499,2024-12-20T20:32:40,ACC00007003,Payment,124.74,-841886.07,USD,Walmart
TXN0000004500,2024-06-25T03:56:42,ACC00000716,Credit,278.72,-841607.35,USD,Target
TXN0000004501,2024-07-01T02:37:22,ACC00004923,ATM,1032.87,-842640.22,EUR,Restaurant
TXN0000004502,2024-09-18T03:10:33,ACC00004731,Transfer,354.47,-842285.75,GBP,Target
TXN0000004503,2024-01-10T09:50:59,ACC00002276,Credit,1079.12,-841206.63,USD,Walmart
TXN0000004504,2024-08-23T07:11:23,ACC00008784,Transfer,617.42,-840589.21,JPY,Walmart
TXN0000004505,2024-08-18T11:24:24,ACC00006636,ATM,1852.84,-842442.05,GBP,Target
TXN0000004506,2024-08-13T06:09:38,ACC00008842,Transfer,1675.9,-840766.15,EUR,Online Store
TXN0000004507,2024-11-21T06:59:31,ACC00001216,Payment,297.28,-841063.43,EUR,Online Store
TXN0000004508,2024-07-20T02:35:10,ACC00000650,ATM,1429.97,-842493.4,GBP,Walmart
TXN0000004509,2024-06-20T12:28:58,ACC00004781,Debit,94.7,-842588.1,JPY,Online Store
TXN0000004510,2024-07-14T06:27:32,ACC00001506,ATM,499.55,-843087.65,USD,Online Store
TXN0000004511,2024-08-18T19:37:10,ACC00005477,ATM,1040.79,-844128.44,JPY,Restaurant
TXN0000004512,2024-09-18T21:42:39,ACC00001508,Credit,695.71,-843432.73,EUR,Walmart
TXN0000004513,2024-08-20T04:16:45,ACC00008684,ATM,1053.94,-844486.67,GBP,Online Store
TXN0000004514,2024-06-05T09:54:18,ACC00002753,Debit,695.44,-845182.11,USD,Starbucks
TXN0000004515,2024-02-20T19:51:51,ACC00000268,Credit,1410.57,-843771.54,JPY,Restaurant
TXN0000004516,2024-09-22T12:45:30,ACC00003755,ATM,1825.79,-845597.33,GBP,Shell
TXN0000004517,2024-02-23T18:37:17,ACC00006050,Credit,871.09,-844726.24,EUR,Shell
TXN0000004518,2024-05-26T06:07:31,ACC00001287,ATM,154.53,-844880.77,EUR,Restaurant
TXN0000004519,2024-07-21T22:56:09,ACC00004977,ATM,28.95,-844909.72,JPY,Restaurant
TXN0000004520,2024-08-30T21:11:09,ACC00006993,ATM,1522.85,-846432.57,USD,Shell
TXN0000004521,2024-04-17T05:52:28,ACC00002599,Payment,916.3,-847348.87,GBP,Restaurant
TXN0000004522,2024-07-27T21:39:41,ACC00007282,Payment,1143.04,-848491.91,EUR,Grocery
TXN0000004523,2024-10-16T05:15:08,ACC00005626,Credit,1045.69,-847446.22,EUR,Target
TXN0000004524,2024-06-29T18:52:18,ACC00007003,Payment,1124.23,-848570.45,GBP,Starbucks
TXN0000004525,2024-06-26T10:03:47,ACC00005001,Transfer,871.74,-847698.71,EUR,Walmart
TXN0000004526,2024-11-06T00:31:31,ACC00006542,Debit,1912.61,-849611.32,USD,Restaurant
TXN0000004527,2024-11-01T00:13:06,ACC00004541,Credit,1763.03,-847848.29,USD,Restaurant
TXN0000004528,2024-07-09T12:09:52,ACC00006793,Credit,135.91,-847712.38,GBP,Walmart
TXN0000004529,2024-04-12T15:17:20,ACC00009840,Credit,1204.89,-846507.49,EUR,Starbucks
TXN0000004530,2024-03-30T03:01:58,ACC00005503,Payment,111.76,-846619.25,USD,Restaurant
TXN0000004531,2024-05-31T00:49:25,ACC00009010,Payment,1308.58,-847927.83,USD,Online Store
TXN0000004532,2024-07-22T18:04:00,ACC00009446,Credit,563.92,-847363.91,GBP,Shell
TXN0000004533,2024-09-02T10:38:09,ACC00008657,Debit,550.05,-847913.96,EUR,Shell
TXN0000004534,2024-04-04T10:15:12,ACC00005991,Payment,143.8,-848057.76,GBP,Restaurant
TXN0000004535,2024-07-31T23:39:35,ACC00002907,ATM,1865.1,-849922.86,USD,Grocery
TXN0000004536,2024-10-24T23:30:37,ACC00001592,Transfer,1004.88,-848917.98,EUR,Walmart
TXN0000004537,2024-06-16T08:18:46,ACC00004574,Transfer,1978.46,-846939.52,USD,Online Store
TXN0000004538,2024-04-21T10:30:54,ACC00000585,Debit,473.25,-847412.77,USD,Starbucks
TXN0000004539,2024-08-28T08:31:36,ACC00001556,Debit,1969.3,-849382.07,JPY,Restaurant
TXN0000004540,2024-12-04T20:29:35,ACC00005291,Payment,1951.24,-851333.31,USD,Starbucks
TXN0000004541,2024-01-21T02:58:31,ACC00009252,Debit,914.47,-852247.78,JPY,Grocery
TXN0000004542,2024-08-15T13:58:55,ACC00001227,ATM,567.38,-852815.16,JPY,Grocery
TXN0000004543,2024-03-09T19:33:54,ACC00004346,Transfer,1212.19,-851602.97,JPY,Walmart
TXN0000004544,2024-09-05T05:49:22,ACC00008424,ATM,1620.07,-853223.04,JPY,Walmart
TXN0000004545,2024-02-10T14:31:53,ACC00003504,Payment,67.52,-853290.56,USD,Grocery
TXN0000004546,2024-07-17T13:20:40,ACC00001341,Debit,1651.71,-854942.27,JPY,Grocery
TXN0000004547,2024-01-24T21:29:17,ACC00007765,Credit,97.38,-854844.89,GBP,Shell
TXN0000004548,2024-05-19T17:16:43,ACC00008133,Payment,892.45,-855737.34,EUR,Shell
TXN0000004549,2024-06-09T00:37:30,ACC00000730,Payment,1258.39,-856995.73,GBP,Online Store
TXN0000004550,2024-07-04T16:18:38,ACC00004274,Debit,1448.5,-858444.23,GBP,Walmart
TXN0000004551,2024-04-03T04:36:14,ACC00003201,Payment,307.24,-858751.47,USD,Target
TXN0000004552,2024-12-20T18:11:05,ACC00001362,Payment,1519.28,-860270.75,EUR,Shell
TXN0000004553,2024-05-09T20:10:43,ACC00002654,Credit,1583.96,-858686.79,JPY,Target
TXN0000004554,2024-11-29T04:32:04,ACC00005701,ATM,368.47,-859055.26,GBP,Walmart
TXN0000004555,2024-01-07T12:09:24,ACC00004887,Payment,170.88,-859226.14,GBP,Amazon
TXN0000004556,2024-03-21T19:21:35,ACC00005881,Transfer,1402.91,-857823.23,EUR,Walmart
TXN0000004557,2024-09-27T03:44:12,ACC00001792,Debit,1918.18,-859741.41,USD,Amazon
TXN0000004558,2024-01-06T00:12:39,ACC00009461,Credit,613.48,-859127.93,USD,Shell
TXN0000004559,2024-03-10T09:13:59,ACC00002618,Transfer,1724.79,-857403.14,USD,Starbucks
TXN0000004560,2024-11-21T04:57:48,ACC00001150,Debit,649.61,-858052.75,EUR,Target
TXN0000004561,2024-02-11T01:29:00,ACC00009257,Payment,1360.03,-859412.78,JPY,Grocery
TXN0000004562,2024-06-12T06:49:58,ACC00006047,ATM,780.61,-860193.39,EUR,Amazon
TXN0000004563,2024-08-27T16:25:45,ACC00003399,Payment,484.12,-860677.51,JPY,Amazon
TXN0000004564,2024-11-28T19:01:42,ACC00003628,Credit,946.95,-859730.56,GBP,Amazon
TXN0000004565,2024-12-10T23:05:25,ACC00002630,Debit,1534.98,-861265.54,GBP,Shell
TXN0000004566,2024-06-01T20:37:38,ACC00004898,Credit,1618.59,-859646.95,USD,Shell
TXN0000004567,2024-01-22T15:21:49,ACC00009107,Payment,76.9,-859723.85,USD,Shell
TXN0000004568,2024-04-26T14:41:22,ACC00009648,ATM,1167.94,-860891.79,USD,Grocery
TXN0000004569,2024-06-09T01:39:56,ACC00008791,Debit,455.01,-861346.8,USD,Target
TXN0000004570,2024-03-03T11:34:47,ACC00001387,Payment,1355.34,-862702.14,USD,Target
TXN0000004571,2024-12-15T01:05:33,ACC00007954,Credit,79.8,-862622.34,USD,Shell
TXN0000004572,2024-07-13T14:48:26,ACC00004423,Transfer,909.64,-861712.7,JPY,Online Store
TXN0000004573,2024-03-29T11:12:22,ACC00004783,Transfer,1945.97,-859766.73,JPY,Restaurant
TXN0000004574,2024-02-09T12:48:32,ACC00001136,Transfer,538.15,-859228.58,USD,Online Store
TXN0000004575,2024-11-15T16:19:35,ACC00007853,ATM,972.7,-860201.28,JPY,Walmart
TXN0000004576,2024-08-26T18:51:37,ACC00004656,Debit,1334.09,-861535.37,EUR,Shell
TXN0000004577,2024-02-15T18:17:54,ACC00002077,Debit,1736.56,-863271.93,GBP,Walmart
TXN0000004578,2024-02-22T09:59:26,ACC00000663,Transfer,13.09,-863258.84,GBP,Starbucks
TXN0000004579,2024-03-14T02:25:37,ACC00007915,Debit,600.16,-863859.0,USD,Amazon
TXN0000004580,2024-12-04T16:14:07,ACC00009122,Debit,980.39,-864839.39,GBP,Shell
TXN0000004581,2024-07-10T04:31:51,ACC00000249,Transfer,1838.81,-863000.58,GBP,Grocery
TXN0000004582,2024-05-10T11:02:57,ACC00007106,Transfer,391.65,-862608.93,GBP,Walmart
TXN0000004583,2024-10-24T14:32:13,ACC00009904,Payment,290.26,-862899.19,EUR,Starbucks
TXN0000004584,2024-04-19T17:17:15,ACC00009310,ATM,1633.4,-864532.59,EUR,Grocery
TXN0000004585,2024-10-24T04:26:15,ACC00008985,Debit,1077.63,-865610.22,JPY,Target
TXN0000004586,2024-10-12T02:39:24,ACC00005351,Debit,1896.79,-867507.01,JPY,Shell
TXN0000004587,2024-05-09T15:13:50,ACC00005313,Payment,599.85,-868106.86,USD,Online Store
TXN0000004588,2024-06-03T09:24:04,ACC00008681,Payment,1834.67,-869941.53,USD,Starbucks
TXN0000004589,2024-12-30T19:20:06,ACC00009726,Debit,1162.05,-871103.58,EUR,Target
TXN0000004590,2024-09-20T01:50:57,ACC00000908,Transfer,1698.9,-869404.68,USD,Grocery
TXN0000004591,2024-01-18T15:11:59,ACC00007135,Credit,1787.37,-867617.31,USD,Target
TXN0000004592,2024-10-11T20:55:17,ACC00000506,ATM,1924.26,-869541.57,JPY,Shell
TXN0000004593,2024-10-18T15:27:03,ACC00006668,Debit,471.21,-870012.78,EUR,Amazon
TXN0000004594,2024-04-16T15:20:27,ACC00005434,Transfer,1877.62,-868135.16,JPY,Restaurant
TXN0000004595,2024-11-24T18:07:00,ACC00000518,Debit,1379.89,-869515.05,GBP,Target
TXN0000004596,2024-02-20T22:11:19,ACC00002017,Payment,1994.52,-871509.57,JPY,Starbucks
TXN0000004597,2024-09-09T22:00:53,ACC00003883,Payment,1210.76,-872720.33,JPY,Starbucks
TXN0000004598,2024-01-13T14:25:42,ACC00003783,Transfer,1978.19,-870742.14,GBP,Grocery
TXN0000004599,2024-10-29T13:51:17,ACC00005999,Payment,1858.99,-872601.13,EUR,Online Store
TXN0000004600,2024-11-06T09:38:10,ACC00004477,Transfer,950.28,-871650.85,JPY,Shell
TXN0000004601,2024-11-11T15:28:10,ACC00006281,Credit,1521.24,-870129.61,JPY,Starbucks
TXN0000004602,2024-11-27T21:53:44,ACC00001984,Debit,214.84,-870344.45,GBP,Walmart
TXN0000004603,2024-03-22T14:23:27,ACC00003609,Transfer,1143.89,-869200.56,JPY,Online Store
TXN0000004604,2024-08-16T10:04:52,ACC00003882,ATM,1961.43,-871161.99,USD,Target
TXN0000004605,2024-03-30T21:53:18,ACC00000779,ATM,1288.03,-872450.02,USD,Shell
TXN0000004606,2024-04-25T03:31:55,ACC00002840,Payment,78.75,-872528.77,GBP,Walmart
TXN0000004607,2024-04-02T05:58:26,ACC00008221,Debit,1637.27,-874166.04,USD,Amazon
TXN0000004608,2024-10-12T09:41:20,ACC00009476,Transfer,1713.08,-872452.96,EUR,Shell
TXN0000004609,2024-06-06T10:18:52,ACC00004704,Debit,142.87,-872595.83,USD,Grocery
TXN0000004610,2024-03-02T20:10:34,ACC00008701,Debit,1660.73,-874256.56,EUR,Grocery
TXN0000004611,2024-02-19T20:23:43,ACC00001376,Debit,1172.35,-875428.91,EUR,Walmart
TXN0000004612,2024-02-28T19:45:56,ACC00006435,Debit,1967.48,-877396.39,USD,Grocery
TXN0000004613,2024-01-14T19:34:13,ACC00004224,Credit,1266.01,-876130.38,JPY,Shell
TXN0000004614,2024-08-13T00:51:30,ACC00008877,Credit,669.08,-875461.3,EUR,Online Store
TXN0000004615,2024-05-05T13:53:52,ACC00009634,ATM,527.48,-875988.78,USD,Restaurant
TXN0000004616,2024-09-22T02:17:07,ACC00006937,Payment,1336.04,-877324.82,JPY,Starbucks
TXN0000004617,2024-07-26T18:50:06,ACC00003653,Transfer,478.72,-876846.1,JPY,Grocery
TXN0000004618,2024-11-12T14:59:37,ACC00000269,Debit,1122.41,-877968.51,EUR,Shell
TXN0000004619,2024-10-24T07:38:16,ACC00000097,Payment,1644.34,-879612.85,JPY,Walmart
TXN0000004620,2024-01-19T07:12:51,ACC00007683,Payment,680.82,-880293.67,USD,Online Store
TXN0000004621,2024-02-25T07:18:39,ACC00007192,Credit,1116.03,-879177.64,EUR,Starbucks
TXN0000004622,2024-03-27T19:23:14,ACC00007611,ATM,1714.48,-880892.12,JPY,Starbucks
TXN0000004623,2024-09-18T08:58:25,ACC00003124,Payment,350.33,-881242.45,EUR,Shell
TXN0000004624,2024-04-27T04:11:28,ACC00001402,Transfer,563.47,-880678.98,JPY,Amazon
TXN0000004625,2024-07-06T09:41:11,ACC00008906,Credit,1175.26,-879503.72,JPY,Grocery
TXN0000004626,2024-06-28T09:46:31,ACC00007001,Transfer,1737.04,-877766.68,EUR,Shell
TXN0000004627,2024-05-11T22:52:14,ACC00002749,Credit,651.45,-877115.23,JPY,Target
TXN0000004628,2024-01-19T05:03:09,ACC00004363,Debit,1100.07,-878215.3,EUR,Walmart
TXN0000004629,2024-05-07T01:12:28,ACC00005490,Debit,447.03,-878662.33,EUR,Online Store
TXN0000004630,2024-03-22T12:09:13,ACC00000596,ATM,1163.41,-879825.74,JPY,Target
TXN0000004631,2024-09-17T06:24:03,ACC00003751,Credit,895.3,-878930.44,USD,Target
TXN0000004632,2024-09-22T07:13:11,ACC00006676,ATM,367.52,-879297.96,USD,Starbucks
TXN0000004633,2024-04-23T06:54:49,ACC00004060,Debit,1901.29,-881199.25,EUR,Shell
TXN0000004634,2024-05-15T22:45:31,ACC00002076,Payment,1536.44,-882735.69,JPY,Target
TXN0000004635,2024-03-30T01:54:16,ACC00009048,ATM,1577.67,-884313.36,JPY,Online Store
TXN0000004636,2024-05-02T16:58:24,ACC00003660,ATM,1335.42,-885648.78,JPY,Grocery
TXN0000004637,2024-10-14T06:40:41,ACC00003767,Payment,438.43,-886087.21,JPY,Amazon
TXN0000004638,2024-10-25T01:03:39,ACC00000020,Transfer,514.25,-885572.96,EUR,Amazon
TXN0000004639,2024-10-25T21:05:22,ACC00003133,Payment,1630.23,-887203.19,GBP,Walmart
TXN0000004640,2024-04-17T20:18:05,ACC00001804,Transfer,131.49,-887071.7,EUR,Shell
TXN0000004641,2024-01-05T04:37:47,ACC00004702,Payment,84.92,-887156.62,JPY,Walmart
TXN0000004642,2024-08-04T18:08:02,ACC00001050,Payment,1893.38,-889050.0,USD,Target
TXN0000004643,2024-01-18T01:56:32,ACC00001887,ATM,486.57,-889536.57,EUR,Grocery
TXN0000004644,2024-07-22T08:49:58,ACC00005545,Debit,1478.47,-891015.04,GBP,Restaurant
TXN0000004645,2024-09-01T20:44:16,ACC00003611,Debit,1054.32,-892069.36,GBP,Starbucks
TXN0000004646,2024-10-17T11:54:18,ACC00007013,Payment,18.12,-892087.48,EUR,Target
TXN0000004647,2024-04-08T03:56:56,ACC00008799,Transfer,317.76,-891769.72,JPY,Restaurant
TXN0000004648,2024-01-30T02:06:34,ACC00009856,Payment,1307.05,-893076.77,EUR,Target
TXN0000004649,2024-02-26T16:18:22,ACC00008776,Payment,1769.15,-894845.92,USD,Amazon
TXN0000004650,2024-12-15T13:29:12,ACC00001410,Transfer,1219.17,-893626.75,JPY,Starbucks
TXN0000004651,2024-06-19T23:35:59,ACC00001276,Transfer,515.85,-893110.9,JPY,Online Store
TXN0000004652,2024-12-19T07:29:34,ACC00005784,ATM,1107.63,-894218.53,USD,Target
TXN0000004653,2024-06-30T20:55:23,ACC00000048,Credit,221.76,-893996.77,JPY,Restaurant
TXN0000004654,2024-05-17T19:47:47,ACC00007109,Credit,1964.6,-892032.17,USD,Grocery
TXN0000004655,2024-01-26T21:36:30,ACC00003397,ATM,217.64,-892249.81,EUR,Target
TXN0000004656,2024-04-13T04:28:08,ACC00003748,ATM,1023.15,-893272.96,JPY,Target
TXN0000004657,2024-04-01T20:54:50,ACC00003957,ATM,1952.18,-895225.14,EUR,Grocery
TXN0000004658,2024-07-25T02:09:14,ACC00007368,ATM,1468.34,-896693.48,GBP,Starbucks
TXN0000004659,2024-12-01T07:01:10,ACC00003538,Transfer,398.43,-896295.05,JPY,Restaurant
TXN0000004660,2024-11-03T11:33:22,ACC00009190,ATM,182.2,-896477.25,EUR,Walmart
TXN0000004661,2024-01-24T04:36:03,ACC00007672,Payment,1581.04,-898058.29,EUR,Shell
TXN0000004662,2024-07-31T15:49:56,ACC00004751,ATM,1049.85,-899108.14,EUR,Walmart
TXN0000004663,2024-11-29T16:37:37,ACC00000107,Transfer,594.61,-898513.53,JPY,Amazon
TXN0000004664,2024-04-02T17:41:20,ACC00008044,Credit,1964.49,-896549.04,JPY,Grocery
TXN0000004665,2024-02-21T17:07:21,ACC00009286,Debit,1642.13,-898191.17,USD,Target
TXN0000004666,2024-04-17T17:51:10,ACC00009372,Debit,683.1,-898874.27,JPY,Starbucks
TXN0000004667,2024-09-10T10:23:48,ACC00001596,Payment,122.04,-898996.31,GBP,Walmart
TXN0000004668,2024-05-28T12:06:02,ACC00006699,Transfer,640.66,-898355.65,GBP,Shell
TXN0000004669,2024-08-12T17:17:00,ACC00005960,Payment,1642.61,-899998.26,JPY,Grocery
TXN0000004670,2024-08-27T00:19:22,ACC00000262,Payment,542.14,-900540.4,GBP,Grocery
TXN0000004671,2024-01-27T01:54:09,ACC00001422,Transfer,455.33,-900085.07,USD,Amazon
TXN0000004672,2024-01-10T07:23:50,ACC00007080,Credit,1754.09,-898330.98,EUR,Shell
TXN0000004673,2024-06-14T02:28:58,ACC00004657,Debit,303.48,-898634.46,JPY,Amazon
TXN0000004674,2024-11-15T08:11:07,ACC00001871,Credit,566.86,-898067.6,EUR,Grocery
TXN0000004675,2024-07-24T21:52:04,ACC00006246,ATM,1316.18,-899383.78,USD,Amazon
TXN0000004676,2024-09-07T10:55:25,ACC00008925,Debit,686.65,-900070.43,JPY,Shell
TXN0000004677,2024-10-31T16:53:30,ACC00003442,Debit,477.5,-900547.93,USD,Amazon
TXN0000004678,2024-03-17T04:04:50,ACC00002004,Debit,134.33,-900682.26,GBP,Grocery
TXN0000004679,2024-07-25T19:11:14,ACC00006462,Transfer,382.92,-900299.34,JPY,Online Store
TXN0000004680,2024-03-30T22:40:58,ACC00006823,Payment,1600.88,-901900.22,USD,Walmart
TXN0000004681,2024-03-11T22:58:46,ACC00003282,ATM,1619.31,-903519.53,GBP,Grocery
TXN0000004682,2024-11-29T13:56:30,ACC00005426,Debit,1048.18,-904567.71,GBP,Target
TXN0000004683,2024-10-03T16:40:41,ACC00001410,Debit,1737.79,-906305.5,EUR,Shell
TXN0000004684,2024-10-29T15:50:33,ACC00002482,Debit,869.75,-907175.25,EUR,Online Store
TXN0000004685,2024-08-25T10:30:44,ACC00006893,Credit,1070.76,-906104.49,JPY,Grocery
TXN0000004686,2024-07-18T19:48:09,ACC00007537,Transfer,1554.89,-904549.6,JPY,Shell
TXN0000004687,2024-07-11T06:22:39,ACC00002684,Transfer,63.83,-904485.77,EUR,Shell
TXN0000004688,2024-05-02T00:46:44,ACC00004738,Credit,1864.02,-902621.75,GBP,Walmart
TXN0000004689,2024-05-25T01:02:57,ACC00004177,Transfer,1268.9,-901352.85,EUR,Amazon
TXN0000004690,2024-10-11T17:03:43,ACC00003535,Debit,1563.05,-902915.9,JPY,Restaurant
TXN0000004691,2024-03-26T16:20:15,ACC00008259,Transfer,1760.33,-901155.57,GBP,Restaurant
TXN0000004692,2024-04-13T03:58:35,ACC00004427,Payment,1266.32,-902421.89,USD,Target
TXN0000004693,2024-12-21T20:18:59,ACC00000388,ATM,31.41,-902453.3,USD,Starbucks
TXN0000004694,2024-01-24T17:06:00,ACC00001103,Payment,1617.8,-904071.1,GBP,Online Store
TXN0000004695,2024-11-19T18:40:06,ACC00009681,Credit,584.9,-903486.2,JPY,Shell
TXN0000004696,2024-11-12T21:58:16,ACC00008739,Payment,911.32,-904397.52,USD,Amazon
TXN0000004697,2024-01-16T12:19:01,ACC00004963,Transfer,1846.07,-902551.45,EUR,Shell
TXN0000004698,2024-02-09T04:52:45,ACC00002962,ATM,623.13,-903174.58,GBP,Starbucks
TXN0000004699,2024-12-09T14:54:11,ACC00001146,Payment,881.86,-904056.44,EUR,Target
TXN0000004700,2024-06-13T02:56:13,ACC00000201,ATM,810.15,-904866.59,USD,Restaurant
TXN0000004701,2024-11-29T04:44:24,ACC00005118,Payment,1256.03,-906122.62,USD,Target
TXN0000004702,2024-06-18T05:55:47,ACC00005712,Transfer,75.02,-906047.6,GBP,Starbucks
TXN0000004703,2024-11-12T12:09:42,ACC00003338,Transfer,1741.33,-904306.27,USD,Shell
TXN0000004704,2024-07-30T03:11:22,ACC00001760,Credit,1833.42,-902472.85,JPY,Starbucks
TXN0000004705,2024-01-17T11:29:42,ACC00000260,Transfer,1765.85,-900707.0,JPY,Amazon
TXN0000004706,2024-08-20T19:44:11,ACC00006349,Credit,1940.86,-898766.14,EUR,Walmart
TXN0000004707,2024-08-28T10:10:45,ACC00000449,Credit,362.17,-898403.97,USD,Online Store
TXN0000004708,2024-07-27T19:51:48,ACC00003295,Payment,445.84,-898849.81,EUR,Amazon
TXN0000004709,2024-04-03T05:55:41,ACC00006338,Debit,734.94,-899584.75,USD,Restaurant
TXN0000004710,2024-05-22T07:36:34,ACC00001386,Credit,596.49,-898988.26,EUR,Restaurant
TXN0000004711,2024-01-15T07:36:01,ACC00007309,Payment,470.77,-899459.03,JPY,Starbucks
TXN0000004712,2024-05-09T16:39:19,ACC00002931,Payment,1290.87,-900749.9,GBP,Restaurant
TXN0000004713,2024-03-12T22:36:23,ACC00008292,Debit,555.55,-901305.45,JPY,Amazon
TXN0000004714,2024-01-23T06:05:01,ACC00001991,Transfer,1679.81,-899625.64,EUR,Starbucks
TXN0000004715,2024-08-30T16:31:18,ACC00000901,Payment,1714.91,-901340.55,EUR,Walmart
TXN0000004716,2024-02-22T14:18:42,ACC00007965,Debit,1990.67,-903331.22,USD,Walmart
TXN0000004717,2024-02-11T12:52:04,ACC00006329,Payment,443.53,-903774.75,JPY,Shell
TXN0000004718,2024-04-09T19:06:57,ACC00007541,ATM,945.74,-904720.49,JPY,Amazon
TXN0000004719,2024-06-07T02:00:11,ACC00002421,Credit,1462.46,-903258.03,USD,Shell
TXN0000004720,2024-11-03T19:19:04,ACC00006776,Payment,167.57,-903425.6,EUR,Online Store
TXN0000004721,2024-06-02T10:19:04,ACC00007739,Credit,1726.36,-901699.24,EUR,Restaurant
TXN0000004722,2024-04-07T11:29:56,ACC00007613,Transfer,1648.31,-900050.93,USD,Walmart
TXN0000004723,2024-08-24T05:14:19,ACC00000520,Credit,369.43,-899681.5,USD,Shell
TXN0000004724,2024-05-18T22:56:06,ACC00007042,Payment,1707.68,-901389.18,JPY,Target
TXN0000004725,2024-08-04T04:05:01,ACC00007835,Payment,25.92,-901415.1,GBP,Target
TXN0000004726,2024-12-07T20:25:59,ACC00004006,Credit,85.9,-901329.2,EUR,Walmart
TXN0000004727,2024-05-17T02:27:38,ACC00007220,ATM,1799.88,-903129.08,EUR,Walmart
TXN0000004728,2024-07-21T13:24:48,ACC00003959,Credit,1552.6,-901576.48,EUR,Starbucks
TXN0000004729,2024-08-26T08:25:08,ACC00000155,Transfer,703.16,-900873.32,USD,Amazon
TXN0000004730,2024-08-03T02:16:21,ACC00008284,Transfer,1786.87,-899086.45,EUR,Amazon
TXN0000004731,2024-04-10T08:57:02,ACC00009075,Credit,502.73,-898583.72,JPY,Walmart
TXN0000004732,2024-02-29T23:41:46,ACC00006518,Payment,658.41,-899242.13,JPY,Starbucks
TXN0000004733,2024-11-26T16:34:17,ACC00002214,Credit,515.63,-898726.5,JPY,Online Store
TXN0000004734,2024-05-05T07:36:34,ACC00003808,Debit,340.98,-899067.48,JPY,Target
TXN0000004735,2024-02-16T10:38:32,ACC00002350,Payment,678.0,-899745.48,EUR,Walmart
TXN0000004736,2024-10-08T05:49:06,ACC00002330,Transfer,1698.25,-898047.23,JPY,Online Store
TXN0000004737,2024-09-23T04:26:16,ACC00005950,Credit,911.46,-897135.77,EUR,Target
TXN0000004738,2024-05-30T08:41:19,ACC00006215,Credit,1708.03,-895427.74,EUR,Grocery
TXN0000004739,2024-03-08T10:26:44,ACC00000178,Credit,1986.14,-893441.6,JPY,Shell
TXN0000004740,2024-11-15T04:18:50,ACC00002549,ATM,1957.79,-895399.39,GBP,Grocery
TXN0000004741,2024-09-09T11:38:36,ACC00009463,Transfer,728.32,-894671.07,USD,Amazon
TXN0000004742,2024-06-24T13:46:07,ACC00003037,Transfer,1993.22,-892677.85,GBP,Online Store
TXN0000004743,2024-05-13T20:22:15,ACC00005046,Transfer,1637.11,-891040.74,GBP,Walmart
TXN0000004744,2024-11-22T21:57:54,ACC00009709,Credit,320.22,-890720.52,EUR,Walmart
TXN0000004745,2024-03-26T17:59:28,ACC00004487,Debit,252.38,-890972.9,JPY,Grocery
TXN0000004746,2024-12-04T22:38:35,ACC00006577,ATM,194.43,-891167.33,GBP,Target
TXN0000004747,2024-06-28T18:15:18,ACC00007653,Credit,1505.28,-889662.05,EUR,Starbucks
TXN0000004748,2024-08-04T08:30:12,ACC00001405,Credit,387.61,-889274.44,JPY,Shell
TXN0000004749,2024-08-24T05:25:24,ACC00003814,Debit,1437.58,-890712.02,USD,Online Store
TXN0000004750,2024-10-12T17:51:55,ACC00006698,Debit,1185.88,-891897.9,USD,Online Store
TXN0000004751,2024-03-04T04:54:08,ACC00001054,Debit,480.67,-892378.57,USD,Online Store
TXN0000004752,2024-09-07T21:00:07,ACC00000159,Credit,1480.63,-890897.94,JPY,Grocery
TXN0000004753,2024-06-14T22:17:45,ACC00009908,Credit,960.59,-889937.35,EUR,Walmart
TXN0000004754,2024-05-19T23:12:33,ACC00004300,Payment,1836.07,-891773.42,GBP,Walmart
TXN0000004755,2024-04-20T04:54:14,ACC00008390,Debit,637.92,-892411.34,GBP,Starbucks
TXN0000004756,2024-11-08T22:13:09,ACC00000497,Payment,968.85,-893380.19,EUR,Shell
TXN0000004757,2024-08-02T17:38:24,ACC00000531,Transfer,331.21,-893048.98,USD,Online Store
TXN0000004758,2024-01-13T13:15:09,ACC00009253,Credit,1041.91,-892007.07,USD,Online Store
TXN0000004759,2024-05-26T23:48:21,ACC00000906,Transfer,616.75,-891390.32,JPY,Online Store
TXN0000004760,2024-12-28T09:30:11,ACC00005182,Transfer,281.85,-891108.47,JPY,Grocery
TXN0000004761,2024-11-01T20:13:36,ACC00003584,Credit,1768.9,-889339.57,JPY,Target
TXN0000004762,2024-12-16T07:29:40,ACC00003276,Debit,1206.63,-890546.2,JPY,Online Store
TXN0000004763,2024-07-22T23:06:37,ACC00003267,Payment,1340.01,-891886.21,GBP,Restaurant
TXN0000004764,2024-04-12T10:49:44,ACC00003794,Payment,1365.0,-893251.21,JPY,Target
TXN0000004765,2024-08-15T21:04:25,ACC00007534,ATM,403.65,-893654.86,USD,Shell
TXN0000004766,2024-08-28T13:13:01,ACC00003354,Payment,1902.24,-895557.1,GBP,Grocery
TXN0000004767,2024-02-24T09:43:43,ACC00001452,Payment,1872.45,-897429.55,GBP,Online Store
TXN0000004768,2024-08-15T22:36:19,ACC00006205,ATM,1289.18,-898718.73,GBP,Restaurant
TXN0000004769,2024-10-17T03:31:28,ACC00009851,ATM,1262.7,-899981.43,EUR,Online Store
TXN0000004770,2024-09-19T13:38:57,ACC00003294,Credit,763.02,-899218.41,USD,Amazon
TXN0000004771,2024-11-12T13:09:58,ACC00008349,Debit,243.8,-899462.21,JPY,Online Store
TXN0000004772,2024-10-26T21:56:12,ACC00002615,ATM,1780.01,-901242.22,USD,Online Store
TXN0000004773,2024-12-12T08:46:15,ACC00007682,Payment,572.21,-901814.43,USD,Starbucks
TXN0000004774,2024-12-17T21:55:46,ACC00004265,ATM,1597.42,-903411.85,EUR,Walmart
TXN0000004775,2024-11-30T19:22:48,ACC00000345,Debit,210.92,-903622.77,EUR,Amazon
TXN0000004776,2024-04-30T02:32:39,ACC00001245,Credit,1796.13,-901826.64,JPY,Amazon
TXN0000004777,2024-02-03T03:38:05,ACC00001971,Payment,773.06,-902599.7,JPY,Shell
TXN0000004778,2024-10-28T10:44:05,ACC00003568,Debit,983.95,-903583.65,USD,Walmart
TXN0000004779,2024-11-02T23:00:49,ACC00009175,Payment,941.17,-904524.82,GBP,Walmart
TXN0000004780,2024-05-09T20:06:38,ACC00008236,Transfer,324.21,-904200.61,JPY,Starbucks
TXN0000004781,2024-03-17T10:09:20,ACC00000154,Payment,829.53,-905030.14,USD,Restaurant
TXN0000004782,2024-04-03T17:04:19,ACC00000569,Transfer,1364.38,-903665.76,JPY,Online Store
TXN0000004783,2024-03-24T21:34:07,ACC00007373,ATM,515.61,-904181.37,EUR,Starbucks
TXN0000004784,2024-06-02T11:55:20,ACC00002667,Payment,673.86,-904855.23,USD,Grocery
TXN0000004785,2024-03-24T18:03:01,ACC00004346,Transfer,770.5,-904084.73,USD,Amazon
TXN0000004786,2024-09-16T17:53:33,ACC00009818,Transfer,1070.19,-903014.54,JPY,Shell
TXN0000004787,2024-11-15T17:22:55,ACC00003893,ATM,1701.72,-904716.26,USD,Online Store
TXN0000004788,2024-10-30T15:54:53,ACC00007722,Payment,1004.08,-905720.34,USD,Shell
TXN0000004789,2024-02-11T02:55:47,ACC00009239,Credit,1323.49,-904396.85,GBP,Grocery
TXN0000004790,2024-05-31T09:54:36,ACC00001082,Transfer,1759.67,-902637.18,USD,Grocery
TXN0000004791,2024-09-09T16:55:07,ACC00008540,Credit,910.99,-901726.19,EUR,Target
TXN0000004792,2024-11-19T17:09:27,ACC00004598,Transfer,643.9,-901082.29,JPY,Shell
TXN0000004793,2024-04-02T12:00:34,ACC00000765,Credit,51.47,-901030.82,USD,Grocery
TXN0000004794,2024-05-27T00:17:00,ACC00002843,ATM,1679.37,-902710.19,JPY,Shell
TXN0000004795,2024-03-20T16:21:23,ACC00005064,Debit,210.85,-902921.04,JPY,Shell
TXN0000004796,2024-05-11T20:19:51,ACC00007589,Transfer,1169.96,-901751.08,JPY,Walmart
TXN0000004797,2024-03-12T00:51:39,ACC00006871,Payment,76.65,-901827.73,GBP,Online Store
TXN0000004798,2024-11-11T07:29:59,ACC00005643,Payment,547.7,-902375.43,USD,Target
TXN0000004799,2024-03-30T21:38:26,ACC00001809,Payment,797.24,-903172.67,USD,Restaurant
TXN0000004800,2024-06-09T20:15:08,ACC00006272,Debit,981.15,-904153.82,GBP,Amazon
TXN0000004801,2024-08-26T16:15:38,ACC00002868,Payment,97.5,-904251.32,JPY,Online Store
TXN0000004802,2024-01-20T22:00:40,ACC00006561,Payment,1833.0,-906084.32,USD,Target
TXN0000004803,2024-05-24T06:23:45,ACC00006651,Payment,1504.18,-907588.5,USD,Target
TXN0000004804,2024-03-07T04:42:12,ACC00002472,Credit,865.51,-906722.99,GBP,Online Store
TXN0000004805,2024-11-12T15:59:32,ACC00008521,Credit,1796.12,-904926.87,EUR,Walmart
TXN0000004806,2024-04-07T06:11:32,ACC00006243,Transfer,1718.63,-903208.24,GBP,Online Store
TXN0000004807,2024-09-13T17:10:11,ACC00008638,Transfer,1650.79,-901557.45,USD,Amazon
TXN0000004808,2024-03-12T15:59:59,ACC00007870,Payment,1057.4,-902614.85,GBP,Walmart
TXN0000004809,2024-12-18T17:08:37,ACC00005893,Transfer,1787.23,-900827.62,USD,Amazon
TXN0000004810,2024-12-02T22:19:28,ACC00006020,Payment,735.56,-901563.18,GBP,Shell
TXN0000004811,2024-07-03T00:08:33,ACC00003307,Transfer,1475.92,-900087.26,JPY,Starbucks
TXN0000004812,2024-07-16T05:23:44,ACC00004239,Transfer,1485.38,-898601.88,EUR,Restaurant
TXN0000004813,2024-07-26T02:53:36,ACC00008106,Credit,459.14,-898142.74,JPY,Shell
TXN0000004814,2024-03-30T12:51:59,ACC00000248,Payment,1900.04,-900042.78,GBP,Restaurant
TXN0000004815,2024-05-27T17:11:19,ACC00008929,Debit,1075.97,-901118.75,EUR,Starbucks
TXN0000004816,2024-09-29T07:54:28,ACC00000634,Credit,1874.25,-899244.5,EUR,Amazon
TXN0000004817,2024-11-02T21:48:19,ACC00000063,Payment,1065.74,-900310.24,JPY,Amazon
TXN0000004818,2024-02-11T04:59:59,ACC00005206,ATM,273.78,-900584.02,USD,Restaurant
TXN0000004819,2024-04-23T03:23:22,ACC00004981,Payment,1503.39,-902087.41,USD,Grocery
TXN0000004820,2024-01-24T05:42:56,ACC00007321,Debit,815.42,-902902.83,USD,Target
TXN0000004821,2024-11-25T08:45:04,ACC00008749,Debit,1563.13,-904465.96,USD,Target
TXN0000004822,2024-07-26T06:29:26,ACC00008621,Payment,875.54,-905341.5,EUR,Walmart
TXN0000004823,2024-02-25T04:22:49,ACC00003607,Debit,1124.36,-906465.86,EUR,Restaurant
TXN0000004824,2024-11-25T09:52:48,ACC00009606,Credit,343.88,-906121.98,EUR,Target
TXN0000004825,2024-04-30T19:35:01,ACC00007136,Payment,1992.83,-908114.81,JPY,Starbucks
TXN0000004826,2024-02-20T13:55:15,ACC00001924,Debit,1248.82,-909363.63,EUR,Grocery
TXN0000004827,2024-07-30T03:22:12,ACC00003601,Payment,1367.2,-910730.83,USD,Shell
TXN0000004828,2024-11-03T11:15:19,ACC00001393,Debit,1361.25,-912092.08,USD,Walmart
TXN0000004829,2024-09-07T03:16:49,ACC00005236,Credit,1891.83,-910200.25,JPY,Starbucks
TXN0000004830,2024-06-26T07:31:05,ACC00001343,Debit,390.09,-910590.34,USD,Amazon
TXN0000004831,2024-01-08T07:39:52,ACC00008971,Credit,977.51,-909612.83,GBP,Starbucks
TXN0000004832,2024-09-02T23:00:18,ACC00008318,ATM,1586.65,-911199.48,USD,Target
TXN0000004833,2024-10-30T09:17:04,ACC00005441,Payment,1347.11,-912546.59,GBP,Shell
TXN0000004834,2024-10-26T15:38:37,ACC00005680,Transfer,1442.03,-911104.56,USD,Walmart
TXN0000004835,2024-04-12T22:14:42,ACC00004998,Payment,932.26,-912036.82,USD,Target
TXN0000004836,2024-03-28T19:06:59,ACC00003751,Payment,268.89,-912305.71,EUR,Restaurant
TXN0000004837,2024-05-21T16:32:47,ACC00003586,ATM,1516.62,-913822.33,USD,Walmart
TXN0000004838,2024-02-06T06:07:55,ACC00008678,ATM,471.76,-914294.09,EUR,Target
TXN0000004839,2024-03-21T00:24:43,ACC00003883,Credit,1489.54,-912804.55,JPY,Restaurant
TXN0000004840,2024-04-29T00:50:13,ACC00002023,Transfer,1829.58,-910974.97,JPY,Starbucks
TXN0000004841,2024-08-11T05:51:25,ACC00003090,Payment,832.46,-911807.43,GBP,Amazon
TXN0000004842,2024-12-16T10:40:40,ACC00007514,Payment,1976.31,-913783.74,EUR,Shell
TXN0000004843,2024-02-21T21:54:00,ACC00006928,ATM,692.1,-914475.84,USD,Amazon
TXN0000004844,2024-11-20T14:18:30,ACC00006673,Debit,611.36,-915087.2,GBP,Restaurant
TXN0000004845,2024-01-25T09:23:48,ACC00005102,ATM,1876.06,-916963.26,USD,Shell
TXN0000004846,2024-06-26T18:17:14,ACC00007440,Credit,1953.3,-915009.96,GBP,Shell
TXN0000004847,2024-04-18T09:58:39,ACC00001562,ATM,616.46,-915626.42,EUR,Shell
TXN0000004848,2024-02-07T19:54:37,ACC00006874,ATM,666.31,-916292.73,GBP,Starbucks
TXN0000004849,2024-01-29T22:46:03,ACC00008964,Transfer,1408.51,-914884.22,GBP,Target
TXN0000004850,2024-10-20T14:13:42,ACC00007117,Transfer,734.73,-914149.49,JPY,Grocery
TXN0000004851,2024-05-11T06:12:21,ACC00008228,Transfer,409.37,-913740.12,GBP,Shell
TXN0000004852,2024-06-08T19:36:43,ACC00008612,Transfer,1625.91,-912114.21,GBP,Shell
TXN0000004853,2024-09-28T17:52:19,ACC00001174,Payment,1307.78,-913421.99,GBP,Starbucks
TXN0000004854,2024-04-14T23:55:54,ACC00000852,Credit,1584.92,-911837.07,USD,Starbucks
TXN0000004855,2024-10-17T13:52:31,ACC00007359,Credit,1686.11,-910150.96,EUR,Walmart
TXN0000004856,2024-03-07T14:27:49,ACC00009696,ATM,381.02,-910531.98,EUR,Amazon
TXN0000004857,2024-01-31T06:24:01,ACC00009396,ATM,1466.69,-911998.67,JPY,Shell
TXN0000004858,2024-10-13T12:51:05,ACC00005780,Debit,78.97,-912077.64,EUR,Starbucks
TXN0000004859,2024-02-16T22:51:38,ACC00005183,Debit,178.86,-912256.5,JPY,Restaurant
TXN0000004860,2024-07-30T15:21:16,ACC00000380,Debit,1141.38,-913397.88,USD,Shell
TXN0000004861,2024-10-01T20:32:30,ACC00005510,ATM,661.79,-914059.67,EUR,Online Store
TXN0000004862,2024-07-12T18:30:05,ACC00000556,Transfer,1974.73,-912084.94,USD,Restaurant
TXN0000004863,2024-05-28T21:51:44,ACC00009056,Transfer,1419.52,-910665.42,EUR,Target
TXN0000004864,2024-02-28T12:49:25,ACC00008959,Credit,309.71,-910355.71,JPY,Target
TXN0000004865,2024-07-24T06:21:40,ACC00009676,Debit,1252.42,-911608.13,JPY,Restaurant
TXN0000004866,2024-01-15T16:46:14,ACC00009037,Payment,1173.79,-912781.92,EUR,Online Store
TXN0000004867,2024-01-20T10:49:24,ACC00008413,Debit,64.17,-912846.09,USD,Shell
TXN0000004868,2024-05-03T04:42:01,ACC00005924,Credit,1822.63,-911023.46,GBP,Grocery
TXN0000004869,2024-01-22T14:56:24,ACC00008673,Payment,156.88,-911180.34,JPY,Target
TXN0000004870,2024-02-28T23:10:17,ACC00005506,Credit,786.54,-910393.8,GBP,Shell
TXN0000004871,2024-10-07T13:53:10,ACC00004199,Credit,1176.85,-909216.95,GBP,Target
TXN0000004872,2024-05-03T07:37:40,ACC00005334,Payment,1043.27,-910260.22,JPY,Target
TXN0000004873,2024-12-21T16:58:35,ACC00006715,Debit,998.14,-911258.36,JPY,Starbucks
TXN0000004874,2024-02-23T01:45:51,ACC00008371,Payment,427.97,-911686.33,JPY,Online Store
TXN0000004875,2024-07-12T00:29:46,ACC00002530,Debit,270.31,-911956.64,USD,Walmart
TXN0000004876,2024-11-10T11:00:02,ACC00002600,Debit,209.52,-912166.16,USD,Amazon
TXN0000004877,2024-07-06T02:15:07,ACC00001932,Credit,712.03,-911454.13,GBP,Amazon
TXN0000004878,2024-09-06T03:45:36,ACC00004818,Transfer,1697.12,-909757.01,GBP,Amazon
TXN0000004879,2024-02-16T22:58:04,ACC00005228,ATM,1250.72,-911007.73,EUR,Online Store
TXN0000004880,2024-03-02T21:08:15,ACC00004483,Credit,1676.25,-909331.48,EUR,Amazon
TXN0000004881,2024-04-08T06:00:28,ACC00005613,Payment,979.05,-910310.53,GBP,Target
TXN0000004882,2024-04-29T00:45:54,ACC00009508,Transfer,123.35,-910187.18,JPY,Walmart
TXN0000004883,2024-03-25T19:10:12,ACC00008183,Payment,641.75,-910828.93,EUR,Target
TXN0000004884,2024-08-06T08:44:26,ACC00009887,Payment,1116.01,-911944.94,USD,Walmart
TXN0000004885,2024-10-27T15:45:48,ACC00005218,ATM,1834.58,-913779.52,EUR,Grocery
TXN0000004886,2024-02-15T00:25:10,ACC00003194,Credit,734.54,-913044.98,USD,Target
TXN0000004887,2024-12-18T12:29:13,ACC00007709,Credit,192.76,-912852.22,EUR,Online Store
TXN0000004888,2024-12-15T03:29:48,ACC00008849,Transfer,1845.25,-911006.97,USD,Grocery
TXN0000004889,2024-04-24T15:46:59,ACC00009240,Credit,1878.89,-909128.08,GBP,Shell
TXN0000004890,2024-03-26T00:23:46,ACC00007129,ATM,704.58,-909832.66,GBP,Target
TXN0000004891,2024-07-12T05:42:41,ACC00008730,Debit,1091.9,-910924.56,USD,Online Store
TXN0000004892,2024-05-20T11:17:51,ACC00003781,Debit,655.65,-911580.21,JPY,Walmart
TXN0000004893,2024-03-23T09:44:53,ACC00009777,ATM,970.97,-912551.18,GBP,Shell
TXN0000004894,2024-08-15T16:32:37,ACC00007028,Debit,896.33,-913447.51,JPY,Walmart
TXN0000004895,2024-02-17T13:45:30,ACC00003049,Transfer,503.21,-912944.3,GBP,Amazon
TXN0000004896,2024-01-14T11:08:08,ACC00001297,Credit,253.68,-912690.62,USD,Restaurant
TXN0000004897,2024-12-20T06:11:17,ACC00002915,ATM,483.73,-913174.35,EUR,Online Store
TXN0000004898,2024-03-31T06:28:38,ACC00005687,ATM,1544.24,-914718.59,USD,Starbucks
TXN0000004899,2024-02-18T16:33:16,ACC00008205,ATM,1876.25,-916594.84,USD,Online Store
TXN0000004900,2024-02-19T00:09:49,ACC00002820,Credit,224.66,-916370.18,JPY,Target
TXN0000004901,2024-01-31T23:33:56,ACC00005571,ATM,1807.97,-918178.15,GBP,Online Store
TXN0000004902,2024-12-22T07:29:58,ACC00001728,Payment,1883.62,-920061.77,USD,Shell
TXN0000004903,2024-08-15T00:32:34,ACC00003843,Debit,793.35,-920855.12,JPY,Amazon
TXN0000004904,2024-10-11T05:24:26,ACC00001741,Payment,1891.08,-922746.2,JPY,Shell
TXN0000004905,2024-10-24T07:33:48,ACC00005653,Payment,1304.49,-924050.69,EUR,Starbucks
TXN0000004906,2024-02-16T07:28:08,ACC00008929,Credit,1016.52,-923034.17,GBP,Walmart
TXN0000004907,2024-03-02T06:50:56,ACC00002300,Payment,1018.32,-924052.49,GBP,Restaurant
TXN0000004908,2024-11-01T07:25:24,ACC00001163,Payment,584.78,-924637.27,GBP,Starbucks
TXN0000004909,2024-09-08T01:38:07,ACC00002250,Payment,1162.64,-925799.91,GBP,Starbucks
TXN0000004910,2024-02-01T16:24:50,ACC00007654,Debit,1319.17,-927119.08,JPY,Grocery
TXN0000004911,2024-12-23T20:10:28,ACC00006931,Payment,785.16,-927904.24,EUR,Walmart
TXN0000004912,2024-01-21T16:45:26,ACC00003739,ATM,40.38,-927944.62,JPY,Shell
TXN0000004913,2024-08-17T11:54:21,ACC00008837,Credit,1078.92,-926865.7,GBP,Starbucks
TXN0000004914,2024-08-07T05:20:52,ACC00006437,Credit,953.21,-925912.49,JPY,Walmart
TXN0000004915,2024-12-07T06:48:28,ACC00000056,ATM,575.35,-926487.84,GBP,Amazon
TXN0000004916,2024-05-24T12:50:28,ACC00009007,Transfer,1949.94,-924537.9,GBP,Starbucks
TXN0000004917,2024-07-13T01:22:28,ACC00000235,Transfer,672.68,-923865.22,EUR,Restaurant
TXN0000004918,2024-04-12T15:43:02,ACC00009176,ATM,804.36,-924669.58,EUR,Online Store
TXN0000004919,2024-12-06T00:25:12,ACC00008544,Transfer,933.81,-923735.77,EUR,Amazon
TXN0000004920,2024-08-10T16:57:24,ACC00007713,Credit,146.68,-923589.09,USD,Online Store
TXN0000004921,2024-11-15T07:15:41,ACC00004440,Debit,1496.07,-925085.16,EUR,Walmart
TXN0000004922,2024-02-07T22:43:00,ACC00005543,ATM,778.12,-925863.28,GBP,Walmart
TXN0000004923,2024-07-05T08:08:48,ACC00003186,Payment,1195.11,-927058.39,GBP,Shell
TXN0000004924,2024-05-08T20:45:43,ACC00003954,Debit,811.9,-927870.29,GBP,Restaurant
TXN0000004925,2024-11-05T11:37:44,ACC00004509,ATM,1713.95,-929584.24,GBP,Grocery
TXN0000004926,2024-09-23T15:31:41,ACC00005218,ATM,826.98,-930411.22,GBP,Amazon
TXN0000004927,2024-11-15T23:41:34,ACC00009837,Debit,232.5,-930643.72,USD,Amazon
TXN0000004928,2024-02-12T23:04:06,ACC00007899,Transfer,1165.71,-929478.01,EUR,Amazon
TXN0000004929,2024-05-26T22:38:11,ACC00005901,Payment,213.21,-929691.22,EUR,Restaurant
TXN0000004930,2024-05-29T07:35:00,ACC00001524,Debit,1733.85,-931425.07,EUR,Starbucks
TXN0000004931,2024-05-12T08:30:42,ACC00006339,ATM,1946.75,-933371.82,JPY,Restaurant
TXN0000004932,2024-12-24T02:15:25,ACC00001141,Debit,578.16,-933949.98,JPY,Starbucks
TXN0000004933,2024-01-11T23:01:46,ACC00005387,Credit,1836.56,-932113.42,USD,Starbucks
TXN0000004934,2024-12-13T09:52:26,ACC00006040,Payment,358.26,-932471.68,USD,Amazon
TXN0000004935,2024-05-18T11:46:11,ACC00006804,Payment,865.02,-933336.7,EUR,Restaurant
TXN0000004936,2024-07-12T12:55:36,ACC00004524,Debit,402.92,-933739.62,USD,Target
TXN0000004937,2024-05-27T23:27:26,ACC00001210,Payment,342.76,-934082.38,USD,Starbucks
TXN0000004938,2024-03-17T04:37:24,ACC00003543,Debit,1715.59,-935797.97,EUR,Restaurant
TXN0000004939,2024-11-24T00:20:42,ACC00009829,Payment,938.88,-936736.85,GBP,Shell
TXN0000004940,2024-05-08T01:14:54,ACC00003950,Credit,1841.42,-934895.43,EUR,Shell
TXN0000004941,2024-01-16T06:15:50,ACC00003000,Credit,671.71,-934223.72,JPY,Walmart
TXN0000004942,2024-08-26T16:55:47,ACC00003653,Credit,1947.36,-932276.36,JPY,Online Store
TXN0000004943,2024-10-14T05:05:02,ACC00008940,Credit,596.27,-931680.09,JPY,Grocery
TXN0000004944,2024-06-09T16:28:35,ACC00008234,ATM,904.27,-932584.36,USD,Target
TXN0000004945,2024-10-04T03:41:45,ACC00001488,ATM,1151.58,-933735.94,USD,Shell
TXN0000004946,2024-02-24T23:34:39,ACC00003732,Debit,89.54,-933825.48,JPY,Walmart
TXN0000004947,2024-03-30T18:30:34,ACC00002882,Payment,175.7,-934001.18,GBP,Shell
TXN0000004948,2024-03-04T10:28:33,ACC00009946,Payment,807.23,-934808.41,JPY,Online Store
TXN0000004949,2024-04-28T00:56:11,ACC00007180,ATM,33.9,-934842.31,GBP,Amazon
TXN0000004950,2024-01-17T08:09:36,ACC00000499,Credit,36.18,-934806.13,GBP,Grocery
TXN0000004951,2024-04-09T09:40:39,ACC00006010,Credit,866.46,-933939.67,JPY,Restaurant
TXN0000004952,2024-04-08T04:04:55,ACC00003381,ATM,1776.28,-935715.95,USD,Online Store
TXN0000004953,2024-08-20T22:50:45,ACC00000675,Credit,887.21,-934828.74,EUR,Target
TXN0000004954,2024-12-14T04:12:07,ACC00002746,ATM,1197.21,-936025.95,EUR,Grocery
TXN0000004955,2024-06-25T05:35:01,ACC00005626,Payment,817.68,-936843.63,GBP,Amazon
TXN0000004956,2024-08-02T21:46:22,ACC00006608,Credit,499.88,-936343.75,EUR,Target
TXN0000004957,2024-02-10T19:01:16,ACC00004098,Credit,1532.76,-934810.99,USD,Walmart
TXN0000004958,2024-10-28T05:52:37,ACC00002654,Debit,1716.87,-936527.86,USD,Shell
TXN0000004959,2024-03-07T17:40:37,ACC00004006,Payment,91.48,-936619.34,JPY,Walmart
TXN0000004960,2024-01-24T03:32:14,ACC00000773,Debit,781.54,-937400.88,JPY,Walmart
TXN0000004961,2024-01-23T19:44:22,ACC00009029,Debit,885.23,-938286.11,JPY,Shell
TXN0000004962,2024-08-04T19:06:57,ACC00002334,ATM,1828.39,-940114.5,JPY,Grocery
TXN0000004963,2024-01-14T05:58:02,ACC00009110,Transfer,1037.02,-939077.48,JPY,Restaurant
TXN0000004964,2024-11-09T20:13:50,ACC00000717,ATM,1534.51,-940611.99,USD,Grocery
TXN0000004965,2024-05-03T00:12:04,ACC00008875,Debit,1047.77,-941659.76,USD,Restaurant
TXN0000004966,2024-05-02T21:29:55,ACC00002448,Credit,1222.11,-940437.65,EUR,Shell
TXN0000004967,2024-04-01T12:37:42,ACC00008409,Transfer,553.05,-939884.6,EUR,Restaurant
TXN0000004968,2024-02-20T00:34:36,ACC00006664,Payment,1696.4,-941581.0,JPY,Starbucks
TXN0000004969,2024-04-29T23:32:26,ACC00000173,ATM,654.43,-942235.43,USD,Grocery
TXN0000004970,2024-04-08T03:00:08,ACC00000693,Debit,1475.34,-943710.77,GBP,Walmart
TXN0000004971,2024-09-03T22:13:38,ACC00005806,Payment,1045.0,-944755.77,JPY,Online Store
TXN0000004972,2024-08-08T08:39:43,ACC00004853,Credit,1195.44,-943560.33,JPY,Online Store
TXN0000004973,2024-12-25T05:39:05,ACC00006095,Debit,1685.62,-945245.95,JPY,Amazon
TXN0000004974,2024-09-22T23:28:30,ACC00000666,Payment,1528.16,-946774.11,USD,Restaurant
TXN0000004975,2024-01-30T17:40:48,ACC00007373,Debit,962.36,-947736.47,EUR,Walmart
TXN0000004976,2024-11-29T15:11:55,ACC00000495,Payment,1288.94,-949025.41,JPY,Starbucks
TXN0000004977,2024-12-02T04:19:27,ACC00000801,Debit,229.87,-949255.28,JPY,Target
TXN0000004978,2024-05-08T05:33:23,ACC00001236,Payment,429.04,-949684.32,EUR,Target
TXN0000004979,2024-06-12T17:42:20,ACC00004599,Payment,1536.88,-951221.2,GBP,Online Store
TXN0000004980,2024-11-07T15:25:57,ACC00002199,Payment,1555.25,-952776.45,GBP,Online Store
TXN0000004981,2024-06-03T21:14:38,ACC00005482,Transfer,1927.6,-950848.85,JPY,Restaurant
TXN0000004982,2024-10-09T08:43:03,ACC00002286,Payment,818.05,-951666.9,EUR,Starbucks
TXN0000004983,2024-01-28T06:41:49,ACC00000943,ATM,53.65,-951720.55,USD,Starbucks
TXN0000004984,2024-01-20T22:03:21,ACC00000800,Credit,916.72,-950803.83,USD,Grocery
TXN0000004985,2024-03-20T18:29:14,ACC00004071,Transfer,1687.67,-949116.16,GBP,Online Store
TXN0000004986,2024-07-26T03:00:54,ACC00008373,Transfer,448.39,-948667.77,USD,Online Store
TXN0000004987,2024-02-08T10:53:31,ACC00002280,ATM,208.4,-948876.17,GBP,Shell
TXN0000004988,2024-02-23T02:59:27,ACC00001752,Transfer,1444.44,-947431.73,JPY,Amazon
TXN0000004989,2024-09-17T00:42:43,ACC00006539,Credit,1184.05,-946247.68,GBP,Restaurant
TXN0000004990,2024-06-27T21:49:52,ACC00003653,ATM,1665.09,-947912.77,EUR,Shell
TXN0000004991,2024-11-05T02:53:19,ACC00000809,Credit,255.74,-947657.03,GBP,Grocery
TXN0000004992,2024-06-15T13:48:31,ACC00008852,Debit,628.32,-948285.35,EUR,Restaurant
TXN0000004993,2024-02-10T04:01:48,ACC00007693,Payment,977.64,-949262.99,USD,Restaurant
TXN0000004994,2024-10-13T17:29:07,ACC00003805,Debit,1964.2,-951227.19,EUR,Starbucks
TXN0000004995,2024-08-31T00:46:55,ACC00003581,Debit,313.64,-951540.83,USD,Amazon
TXN0000004996,2024-12-05T04:11:47,ACC00001021,Payment,726.73,-952267.56,USD,Grocery
TXN0000004997,2024-12-03T13:40:10,ACC00006718,Payment,1902.47,-954170.03,GBP,Amazon
TXN0000004998,2024-05-06T15:16:34,ACC00000881,Credit,86.68,-954083.35,EUR,Shell
TXN0000004999,2024-12-09T22:14:19,ACC00005798,Debit,566.04,-954649.39,EUR,Restaurant
TXN0000005000,2024-10-20T22:25:03,ACC00005365,ATM,595.65,-955245.04,JPY,Restaurant
TXN0000005001,2024-01-28T02:30:26,ACC00001018,Transfer,283.18,-954961.86,USD,Walmart
TXN0000005002,2024-01-01T22:41:49,ACC00007154,Debit,945.07,-955906.93,JPY,Starbucks
TXN0000005003,2024-11-24T02:00:12,ACC00009725,ATM,1991.53,-957898.46,JPY,Walmart
TXN0000005004,2024-12-11T11:16:37,ACC00001461,Debit,1725.71,-959624.17,JPY,Starbucks
TXN0000005005,2024-07-12T05:23:06,ACC00004370,ATM,1943.43,-961567.6,GBP,Amazon
TXN0000005006,2024-05-01T00:11:15,ACC00009304,Transfer,470.95,-961096.65,EUR,Grocery
TXN0000005007,2024-07-18T18:22:00,ACC00000881,Payment,389.97,-961486.62,GBP,Online Store
TXN0000005008,2024-09-12T21:17:29,ACC00005273,ATM,1431.69,-962918.31,JPY,Shell
TXN0000005009,2024-12-27T13:22:35,ACC00007273,Transfer,1326.41,-961591.9,JPY,Target
TXN0000005010,2024-04-13T03:04:56,ACC00009027,Credit,1019.44,-960572.46,EUR,Grocery
TXN0000005011,2024-05-11T09:14:26,ACC00001741,Credit,103.58,-960468.88,GBP,Amazon
TXN0000005012,2024-04-28T03:18:26,ACC00001823,Debit,778.62,-961247.5,EUR,Restaurant
TXN0000005013,2024-04-03T04:45:53,ACC00008267,Payment,740.87,-961988.37,JPY,Shell
TXN0000005014,2024-06-24T14:15:26,ACC00008580,Credit,1906.05,-960082.32,GBP,Online Store
TXN0000005015,2024-10-06T06:27:06,ACC00001558,ATM,1748.42,-961830.74,USD,Amazon
TXN0000005016,2024-02-21T04:41:21,ACC00002520,ATM,824.63,-962655.37,JPY,Shell
TXN0000005017,2024-02-27T01:21:25,ACC00007129,Transfer,1514.79,-961140.58,EUR,Restaurant
TXN0000005018,2024-04-28T10:41:31,ACC00004544,Payment,331.24,-961471.82,JPY,Online Store
TXN0000005019,2024-06-18T23:50:46,ACC00007193,Debit,1394.65,-962866.47,GBP,Starbucks
TXN0000005020,2024-05-08T14:14:54,ACC00002344,Debit,929.84,-963796.31,JPY,Walmart
TXN0000005021,2024-07-21T13:51:42,ACC00008785,Payment,1164.79,-964961.1,JPY,Walmart
TXN0000005022,2024-07-18T01:47:10,ACC00006396,ATM,1827.0,-966788.1,USD,Restaurant
TXN0000005023,2024-02-26T05:27:28,ACC00009612,Debit,1872.4,-968660.5,EUR,Shell
TXN0000005024,2024-11-20T03:55:05,ACC00004305,Payment,342.68,-969003.18,USD,Shell
TXN0000005025,2024-12-23T10:03:18,ACC00002736,Credit,613.03,-968390.15,USD,Amazon
TXN0000005026,2024-03-30T10:14:36,ACC00007248,Transfer,1122.18,-967267.97,JPY,Amazon
TXN0000005027,2024-01-20T14:47:23,ACC00002417,Debit,376.93,-967644.9,EUR,Starbucks
TXN0000005028,2024-11-26T04:44:35,ACC00003945,Debit,1811.01,-969455.91,GBP,Starbucks
TXN0000005029,2024-07-13T10:35:56,ACC00007394,Payment,911.9,-970367.81,USD,Walmart
TXN0000005030,2024-04-17T11:29:39,ACC00003098,Debit,1462.85,-971830.66,GBP,Shell
TXN0000005031,2024-07-19T05:13:05,ACC00003584,Transfer,1152.12,-970678.54,EUR,Restaurant
TXN0000005032,2024-08-31T07:13:57,ACC00002934,Payment,1139.88,-971818.42,EUR,Target
TXN0000005033,2024-04-21T10:28:34,ACC00004235,Transfer,1247.01,-970571.41,USD,Shell
TXN0000005034,2024-09-26T08:05:17,ACC00004052,Transfer,662.01,-969909.4,USD,Shell
TXN0000005035,2024-07-31T23:46:38,ACC00009275,Debit,1539.5,-971448.9,GBP,Target
TXN0000005036,2024-05-01T17:21:21,ACC00000082,Debit,27.76,-971476.66,JPY,Starbucks
TXN0000005037,2024-12-13T21:28:29,ACC00001770,Transfer,1313.0,-970163.66,USD,Amazon
TXN0000005038,2024-09-18T02:01:48,ACC00001844,ATM,162.41,-970326.07,GBP,Starbucks
TXN0000005039,2024-04-20T19:57:20,ACC00007216,Debit,1125.17,-971451.24,JPY,Shell
TXN0000005040,2024-01-19T12:15:19,ACC00002031,ATM,1877.16,-973328.4,USD,Starbucks
TXN0000005041,2024-05-19T01:54:09,ACC00009762,Payment,107.26,-973435.66,JPY,Starbucks
TXN0000005042,2024-05-10T00:16:35,ACC00003935,ATM,602.04,-974037.7,EUR,Online Store
TXN0000005043,2024-01-05T21:33:35,ACC00005624,Credit,918.44,-973119.26,JPY,Target
TXN0000005044,2024-10-21T02:15:12,ACC00006162,Debit,1251.0,-974370.26,USD,Starbucks
TXN0000005045,2024-04-09T20:08:08,ACC00002831,Transfer,1561.69,-972808.57,USD,Shell
TXN0000005046,2024-10-29T06:52:07,ACC00009668,Payment,1664.85,-974473.42,USD,Walmart
TXN0000005047,2024-09-21T14:54:39,ACC00006135,Credit,1351.21,-973122.21,JPY,Shell
TXN0000005048,2024-07-03T07:39:35,ACC00002393,Payment,1979.28,-975101.49,EUR,Target
TXN0000005049,2024-03-07T17:28:30,ACC00009676,Debit,669.86,-975771.35,GBP,Amazon
TXN0000005050,2024-08-24T17:23:03,ACC00006365,Credit,910.63,-974860.72,GBP,Amazon
TXN0000005051,2024-12-09T06:00:57,ACC00006354,Payment,811.67,-975672.39,JPY,Starbucks
TXN0000005052,2024-09-06T08:55:37,ACC00005828,Transfer,1750.2,-973922.19,USD,Amazon
TXN0000005053,2024-09-06T09:11:39,ACC00006922,Payment,37.55,-973959.74,USD,Target
TXN0000005054,2024-10-03T07:15:49,ACC00003621,Debit,1971.52,-975931.26,EUR,Amazon
TXN0000005055,2024-12-29T10:26:37,ACC00007047,Payment,635.02,-976566.28,EUR,Shell
TXN0000005056,2024-02-25T04:13:02,ACC00002595,Payment,152.9,-976719.18,USD,Starbucks
TXN0000005057,2024-03-18T12:52:48,ACC00007187,ATM,1934.38,-978653.56,EUR,Amazon
TXN0000005058,2024-02-09T14:07:25,ACC00005801,Debit,1760.84,-980414.4,JPY,Shell
TXN0000005059,2024-07-30T17:48:15,ACC00005008,Transfer,1658.8,-978755.6,EUR,Shell
TXN0000005060,2024-01-25T22:34:10,ACC00007837,Debit,1998.12,-980753.72,JPY,Walmart
TXN0000005061,2024-10-28T06:00:09,ACC00000492,Transfer,933.76,-979819.96,EUR,Grocery
TXN0000005062,2024-10-18T02:33:29,ACC00004856,Payment,1138.59,-980958.55,JPY,Grocery
TXN0000005063,2024-01-04T19:56:43,ACC00000420,ATM,1054.33,-982012.88,GBP,Target
TXN0000005064,2024-07-16T22:33:40,ACC00006280,Debit,1378.7,-983391.58,EUR,Shell
TXN0000005065,2024-11-17T14:57:00,ACC00001542,Debit,376.81,-983768.39,GBP,Amazon
TXN0000005066,2024-10-13T09:11:08,ACC00005159,ATM,592.39,-984360.78,USD,Restaurant
TXN0000005067,2024-03-09T06:19:58,ACC00009542,ATM,1050.9,-985411.68,EUR,Target
TXN0000005068,2024-06-01T11:45:35,ACC00001243,Payment,1293.63,-986705.31,EUR,Online Store
TXN0000005069,2024-05-02T09:45:11,ACC00000055,Credit,1283.39,-985421.92,GBP,Starbucks
TXN0000005070,2024-06-28T11:13:31,ACC00003360,ATM,1850.27,-987272.19,JPY,Starbucks
TXN0000005071,2024-08-10T07:24:28,ACC00006864,Credit,673.8,-986598.39,USD,Online Store
TXN0000005072,2024-07-16T10:06:58,ACC00001687,Payment,465.94,-987064.33,GBP,Shell
TXN0000005073,2024-07-22T07:50:50,ACC00003823,Payment,1382.06,-988446.39,USD,Restaurant
TXN0000005074,2024-01-11T01:04:48,ACC00001058,ATM,601.49,-989047.88,EUR,Grocery
TXN0000005075,2024-05-15T02:50:10,ACC00007186,Transfer,84.26,-988963.62,EUR,Online Store
TXN0000005076,2024-05-27T17:41:35,ACC00006819,ATM,336.99,-989300.61,GBP,Target
TXN0000005077,2024-09-07T18:45:36,ACC00005038,Debit,1138.09,-990438.7,EUR,Target
TXN0000005078,2024-03-17T06:33:29,ACC00009518,Transfer,138.25,-990300.45,USD,Target
TXN0000005079,2024-08-25T21:06:23,ACC00000832,Debit,1176.53,-991476.98,JPY,Restaurant
TXN0000005080,2024-06-10T08:14:45,ACC00002302,Transfer,1163.27,-990313.71,GBP,Shell
TXN0000005081,2024-01-17T03:23:35,ACC00008448,Credit,468.09,-989845.62,JPY,Target
TXN0000005082,2024-10-13T19:20:24,ACC00003067,ATM,95.48,-989941.1,EUR,Shell
TXN0000005083,2024-02-11T08:06:02,ACC00001419,Transfer,1908.54,-988032.56,USD,Online Store
TXN0000005084,2024-05-22T16:37:28,ACC00007307,Debit,816.59,-988849.15,JPY,Amazon
TXN0000005085,2024-03-10T08:38:22,ACC00006077,ATM,1670.64,-990519.79,EUR,Grocery
TXN0000005086,2024-06-17T04:54:01,ACC00006576,Transfer,619.21,-989900.58,JPY,Shell
TXN0000005087,2024-12-23T16:31:38,ACC00007960,Debit,842.51,-990743.09,JPY,Grocery
TXN0000005088,2024-04-02T04:41:45,ACC00001505,Debit,1000.81,-991743.9,GBP,Amazon
TXN0000005089,2024-10-06T21:34:20,ACC00007872,Payment,1984.04,-993727.94,USD,Target
TXN0000005090,2024-01-15T23:20:36,ACC00000445,ATM,1044.39,-994772.33,JPY,Shell
TXN0000005091,2024-01-16T23:53:28,ACC00008608,ATM,1559.9,-996332.23,USD,Grocery
TXN0000005092,2024-03-31T23:23:30,ACC00003945,ATM,1695.61,-998027.84,JPY,Shell
TXN0000005093,2024-01-20T19:41:36,ACC00006651,Transfer,404.35,-997623.49,GBP,Shell
TXN0000005094,2024-09-23T14:58:20,ACC00007696,Debit,1995.35,-999618.84,JPY,Target
TXN0000005095,2024-08-13T13:24:55,ACC00003718,Debit,1610.4,-1001229.24,GBP,Amazon
TXN0000005096,2024-05-03T11:45:29,ACC00009624,Credit,1795.78,-999433.46,JPY,Online Store
TXN0000005097,2024-10-25T15:00:37,ACC00005376,Credit,1535.27,-997898.19,GBP,Amazon
TXN0000005098,2024-03-05T07:12:30,ACC00006315,Payment,498.15,-998396.34,GBP,Target
TXN0000005099,2024-01-31T16:54:33,ACC00004199,Credit,1636.81,-996759.53,USD,Target
TXN0000005100,2024-05-17T17:50:21,ACC00005600,Transfer,1508.36,-995251.17,USD,Shell
TXN0000005101,2024-02-21T03:58:46,ACC00001396,Payment,401.42,-995652.59,GBP,Online Store
TXN0000005102,2024-01-20T13:59:53,ACC00003331,Debit,1727.31,-997379.9,GBP,Grocery
TXN0000005103,2024-12-11T16:35:08,ACC00005036,Payment,695.74,-998075.64,USD,Grocery
TXN0000005104,2024-04-10T07:53:52,ACC00004200,Credit,910.82,-997164.82,USD,Grocery
TXN0000005105,2024-05-06T16:03:28,ACC00007802,ATM,1247.14,-998411.96,EUR,Starbucks
TXN0000005106,2024-09-08T22:37:33,ACC00000287,Credit,1696.05,-996715.91,USD,Grocery
TXN0000005107,2024-10-11T13:07:55,ACC00003375,ATM,272.26,-996988.17,JPY,Amazon
TXN0000005108,2024-01-28T04:07:01,ACC00001077,Credit,1969.34,-995018.83,USD,Shell
TXN0000005109,2024-02-05T09:02:05,ACC00000319,ATM,1393.28,-996412.11,EUR,Target
TXN0000005110,2024-04-14T17:05:07,ACC00007939,Payment,1051.01,-997463.12,GBP,Restaurant
TXN0000005111,2024-04-05T04:50:27,ACC00009331,Debit,1415.37,-998878.49,GBP,Starbucks
TXN0000005112,2024-01-25T18:38:28,ACC00003140,Credit,167.8,-998710.69,GBP,Online Store
TXN0000005113,2024-02-20T06:57:47,ACC00000810,Transfer,288.98,-998421.71,JPY,Online Store
TXN0000005114,2024-06-07T19:46:12,ACC00005016,Debit,1179.44,-999601.15,EUR,Walmart
TXN0000005115,2024-08-03T22:14:26,ACC00009418,Debit,1737.64,-1001338.79,EUR,Walmart
TXN0000005116,2024-11-16T09:40:28,ACC00003024,Transfer,1910.16,-999428.63,GBP,Online Store
TXN0000005117,2024-01-21T18:30:50,ACC00005004,ATM,1465.41,-1000894.04,GBP,Online Store
TXN0000005118,2024-02-22T03:15:29,ACC00000145,Payment,825.99,-1001720.03,GBP,Walmart
TXN0000005119,2024-03-07T11:10:42,ACC00001850,ATM,1705.05,-1003425.08,EUR,Restaurant
TXN0000005120,2024-07-08T00:08:00,ACC00004849,Credit,1860.86,-1001564.22,JPY,Amazon
TXN0000005121,2024-08-11T05:29:55,ACC00008028,Credit,1697.46,-999866.76,EUR,Online Store
TXN0000005122,2024-08-14T05:03:44,ACC00002128,Transfer,1022.02,-998844.74,EUR,Starbucks
TXN0000005123,2024-01-14T08:52:15,ACC00007174,ATM,1619.8,-1000464.54,EUR,Online Store
TXN0000005124,2024-12-19T20:46:30,ACC00004855,Payment,1182.96,-1001647.5,JPY,Target
TXN0000005125,2024-01-06T05:48:01,ACC00000557,ATM,1450.05,-1003097.55,GBP,Walmart
TXN0000005126,2024-12-09T04:01:04,ACC00007425,Debit,861.72,-1003959.27,GBP,Restaurant
TXN0000005127,2024-02-25T22:26:48,ACC00009026,Debit,402.09,-1004361.36,EUR,Amazon
TXN0000005128,2024-03-18T15:52:42,ACC00002601,Transfer,183.03,-1004178.33,EUR,Walmart
TXN0000005129,2024-03-08T15:03:26,ACC00003878,Credit,969.91,-1003208.42,USD,Shell
TXN0000005130,2024-10-17T08:03:11,ACC00009681,Transfer,1484.99,-1001723.43,USD,Walmart
TXN0000005131,2024-05-27T18:55:23,ACC00006941,Payment,1641.99,-1003365.42,EUR,Walmart
TXN0000005132,2024-09-25T16:36:12,ACC00006343,Payment,926.81,-1004292.23,EUR,Online Store
TXN0000005133,2024-09-16T08:58:50,ACC00004375,Debit,1821.97,-1006114.2,EUR,Starbucks
TXN0000005134,2024-06-15T03:37:30,ACC00006616,ATM,617.24,-1006731.44,GBP,Grocery
TXN0000005135,2024-02-20T19:43:19,ACC00006727,Credit,966.02,-1005765.42,USD,Amazon
TXN0000005136,2024-08-10T11:30:22,ACC00005117,ATM,187.7,-1005953.12,GBP,Shell
TXN0000005137,2024-09-22T07:53:16,ACC00002726,Payment,218.58,-1006171.7,JPY,Walmart
TXN0000005138,2024-07-12T09:59:44,ACC00009544,Debit,215.8,-1006387.5,GBP,Grocery
TXN0000005139,2024-08-19T20:27:28,ACC00001182,Debit,424.36,-1006811.86,JPY,Grocery
TXN0000005140,2024-06-14T17:05:25,ACC00003854,Payment,525.13,-1007336.99,EUR,Walmart
TXN0000005141,2024-06-08T15:41:22,ACC00009326,Credit,1962.65,-1005374.34,JPY,Starbucks
TXN0000005142,2024-05-22T20:09:23,ACC00009960,Transfer,936.19,-1004438.15,JPY,Starbucks
TXN0000005143,2024-07-30T17:44:54,ACC00004172,Debit,351.53,-1004789.68,USD,Online Store
TXN0000005144,2024-09-20T12:42:39,ACC00007758,ATM,730.24,-1005519.92,GBP,Target
TXN0000005145,2024-02-24T01:54:54,ACC00009394,ATM,83.59,-1005603.51,EUR,Target
TXN0000005146,2024-03-07T14:31:07,ACC00005374,Debit,1272.9,-1006876.41,USD,Amazon
TXN0000005147,2024-06-14T10:33:39,ACC00001317,Payment,1626.83,-1008503.24,EUR,Shell
TXN0000005148,2024-06-13T17:46:59,ACC00005109,ATM,1292.28,-1009795.52,USD,Walmart
TXN0000005149,2024-11-18T18:53:33,ACC00000461,Payment,1424.29,-1011219.81,USD,Starbucks
TXN0000005150,2024-08-23T10:38:34,ACC00001836,Credit,320.05,-1010899.76,JPY,Shell
TXN0000005151,2024-04-04T11:05:34,ACC00005013,Credit,1272.84,-1009626.92,JPY,Shell
TXN0000005152,2024-03-19T16:59:52,ACC00007198,Credit,1058.5,-1008568.42,JPY,Target
TXN0000005153,2024-09-30T00:22:24,ACC00009065,ATM,282.81,-1008851.23,GBP,Amazon
TXN0000005154,2024-10-21T20:16:40,ACC00009859,Credit,1485.75,-1007365.48,EUR,Online Store
TXN0000005155,2024-02-21T15:07:57,ACC00003343,Debit,1378.11,-1008743.59,EUR,Online Store
TXN0000005156,2024-08-26T03:12:21,ACC00006773,Payment,1539.58,-1010283.17,USD,Target
TXN0000005157,2024-06-19T05:58:12,ACC00005459,Payment,133.23,-1010416.4,GBP,Starbucks
TXN0000005158,2024-03-20T21:30:37,ACC00003615,ATM,332.58,-1010748.98,EUR,Walmart
TXN0000005159,2024-06-03T15:24:29,ACC00004317,Transfer,796.96,-1009952.02,GBP,Grocery
TXN0000005160,2024-08-08T08:11:55,ACC00000429,ATM,1345.9,-1011297.92,JPY,Shell
TXN0000005161,2024-05-08T11:42:27,ACC00006198,Credit,1657.99,-1009639.93,GBP,Shell
TXN0000005162,2024-12-03T02:31:53,ACC00001106,Payment,753.68,-1010393.61,JPY,Grocery
TXN0000005163,2024-03-06T04:33:33,ACC00006512,Transfer,1931.84,-1008461.77,GBP,Walmart
TXN0000005164,2024-09-23T16:07:17,ACC00005782,Transfer,1734.7,-1006727.07,JPY,Walmart
TXN0000005165,2024-07-04T02:44:14,ACC00003005,Transfer,93.2,-1006633.87,EUR,Restaurant
TXN0000005166,2024-02-22T04:45:55,ACC00002984,Payment,1971.53,-1008605.4,EUR,Starbucks
TXN0000005167,2024-04-02T18:07:51,ACC00003184,Debit,864.62,-1009470.02,GBP,Target
TXN0000005168,2024-03-28T18:52:42,ACC00008313,Payment,1309.75,-1010779.77,USD,Amazon
TXN0000005169,2024-09-27T21:17:18,ACC00002401,Transfer,1789.35,-1008990.42,JPY,Shell
TXN0000005170,2024-12-01T06:23:02,ACC00002702,Debit,885.9,-1009876.32,USD,Grocery
TXN0000005171,2024-05-27T06:18:05,ACC00002490,ATM,491.02,-1010367.34,JPY,Walmart
TXN0000005172,2024-08-06T20:13:09,ACC00000470,Debit,518.09,-1010885.43,USD,Restaurant
TXN0000005173,2024-08-04T22:34:08,ACC00009149,ATM,1187.11,-1012072.54,USD,Grocery
TXN0000005174,2024-03-28T10:10:57,ACC00001041,Payment,894.53,-1012967.07,USD,Target
TXN0000005175,2024-04-19T01:41:07,ACC00009576,Debit,1782.71,-1014749.78,USD,Target
TXN0000005176,2024-11-17T23:44:36,ACC00007783,ATM,1046.33,-1015796.11,GBP,Grocery
TXN0000005177,2024-12-22T19:04:00,ACC00004465,ATM,1945.69,-1017741.8,USD,Restaurant
TXN0000005178,2024-11-02T00:51:47,ACC00008627,Payment,579.51,-1018321.31,EUR,Shell
TXN0000005179,2024-03-22T14:21:21,ACC00001170,Payment,758.16,-1019079.47,GBP,Online Store
TXN0000005180,2024-08-23T04:26:14,ACC00003177,Credit,428.65,-1018650.82,GBP,Amazon
TXN0000005181,2024-09-16T06:57:40,ACC00004060,Transfer,1184.84,-1017465.98,JPY,Restaurant
TXN0000005182,2024-09-16T05:52:55,ACC00002866,Credit,771.03,-1016694.95,GBP,Amazon
TXN0000005183,2024-07-15T04:55:38,ACC00002069,Payment,1841.69,-1018536.64,USD,Grocery
TXN0000005184,2024-05-21T11:34:53,ACC00007314,Credit,1423.76,-1017112.88,USD,Restaurant
TXN0000005185,2024-06-16T14:05:55,ACC00009851,Credit,680.02,-1016432.86,EUR,Amazon
TXN0000005186,2024-03-18T22:50:04,ACC00002483,Transfer,1600.7,-1014832.16,JPY,Walmart
TXN0000005187,2024-04-24T16:52:47,ACC00008227,ATM,462.66,-1015294.82,USD,Online Store
TXN0000005188,2024-03-03T16:31:14,ACC00003944,Transfer,810.86,-1014483.96,GBP,Restaurant
TXN0000005189,2024-07-10T08:03:18,ACC00008263,Payment,918.18,-1015402.14,EUR,Starbucks
TXN0000005190,2024-07-23T17:05:29,ACC00005022,Payment,53.84,-1015455.98,JPY,Grocery
TXN0000005191,2024-03-03T05:05:19,ACC00001857,Payment,294.32,-1015750.3,JPY,Starbucks
TXN0000005192,2024-10-30T08:49:03,ACC00000293,Payment,735.16,-1016485.46,GBP,Grocery
TXN0000005193,2024-07-13T09:52:26,ACC00001890,Credit,176.39,-1016309.07,EUR,Shell
TXN0000005194,2024-07-18T20:39:02,ACC00006427,Credit,435.7,-1015873.37,USD,Starbucks
TXN0000005195,2024-12-06T21:44:02,ACC00007155,Debit,987.31,-1016860.68,EUR,Online Store
TXN0000005196,2024-07-18T02:00:25,ACC00002916,Transfer,1929.94,-1014930.74,EUR,Target
TXN0000005197,2024-10-25T22:22:37,ACC00009759,Credit,1745.13,-1013185.61,USD,Walmart
TXN0000005198,2024-07-30T23:21:27,ACC00003924,Transfer,1811.61,-1011374.0,EUR,Amazon
TXN0000005199,2024-12-19T22:47:56,ACC00000661,Debit,348.99,-1011722.99,USD,Starbucks
TXN0000005200,2024-05-14T17:57:06,ACC00007238,Transfer,1480.93,-1010242.06,USD,Restaurant
TXN0000005201,2024-11-11T14:38:03,ACC00003857,Debit,1467.86,-1011709.92,GBP,Online Store
TXN0000005202,2024-10-23T02:31:03,ACC00005842,Transfer,1762.93,-1009946.99,EUR,Starbucks
TXN0000005203,2024-06-13T01:03:28,ACC00005603,Payment,334.93,-1010281.92,GBP,Starbucks
TXN0000005204,2024-04-05T04:27:38,ACC00006060,Debit,1101.82,-1011383.74,JPY,Grocery
TXN0000005205,2024-11-11T20:37:42,ACC00001846,Debit,1825.87,-1013209.61,USD,Shell
TXN0000005206,2024-12-23T14:12:25,ACC00002866,Debit,1349.41,-1014559.02,GBP,Online Store
TXN0000005207,2024-07-28T00:41:32,ACC00004248,Payment,1304.13,-1015863.15,EUR,Amazon
TXN0000005208,2024-11-27T17:28:12,ACC00000101,Transfer,1924.59,-1013938.56,USD,Walmart
TXN0000005209,2024-08-12T11:52:28,ACC00000949,Payment,1613.3,-1015551.86,EUR,Walmart
TXN0000005210,2024-02-22T23:14:42,ACC00008478,ATM,1365.28,-1016917.14,USD,Target
TXN0000005211,2024-10-06T11:13:40,ACC00004942,Payment,1505.58,-1018422.72,GBP,Shell
TXN0000005212,2024-05-09T07:01:06,ACC00009635,Credit,584.03,-1017838.69,GBP,Shell
TXN0000005213,2024-04-01T18:59:17,ACC00007674,Transfer,1630.62,-1016208.07,USD,Walmart
TXN0000005214,2024-06-16T18:15:40,ACC00003184,Debit,1405.65,-1017613.72,EUR,Shell
TXN0000005215,2024-11-02T11:35:28,ACC00009580,Debit,922.7,-1018536.42,GBP,Shell
TXN0000005216,2024-07-17T14:52:59,ACC00002690,Credit,333.46,-1018202.96,JPY,Amazon
TXN0000005217,2024-08-17T22:57:27,ACC00000087,Transfer,1596.72,-1016606.24,GBP,Grocery
TXN0000005218,2024-11-24T18:43:06,ACC00000556,Credit,1468.72,-1015137.52,JPY,Amazon
TXN0000005219,2024-05-23T04:07:23,ACC00003530,ATM,170.81,-1015308.33,GBP,Grocery
TXN0000005220,2024-02-19T15:41:51,ACC00003320,Credit,124.26,-1015184.07,EUR,Walmart
TXN0000005221,2024-10-02T01:06:20,ACC00005350,Payment,1879.05,-1017063.12,EUR,Walmart
TXN0000005222,2024-02-01T02:27:10,ACC00006708,Transfer,1635.82,-1015427.3,GBP,Online Store
TXN0000005223,2024-09-16T20:01:07,ACC00007181,ATM,484.25,-1015911.55,EUR,Shell
TXN0000005224,2024-10-04T04:57:32,ACC00008858,Credit,44.81,-1015866.74,USD,Amazon
TXN0000005225,2024-10-06T14:09:40,ACC00001449,Debit,1324.7,-1017191.44,EUR,Restaurant
TXN0000005226,2024-05-06T13:12:02,ACC00003890,Transfer,344.48,-1016846.96,USD,Grocery
TXN0000005227,2024-10-12T09:37:00,ACC00007672,Credit,1347.14,-1015499.82,USD,Restaurant
TXN0000005228,2024-12-02T21:09:14,ACC00003223,Transfer,957.22,-1014542.6,USD,Amazon
TXN0000005229,2024-01-30T03:29:28,ACC00005000,Payment,1778.62,-1016321.22,GBP,Target
TXN0000005230,2024-03-24T13:30:01,ACC00000825,Credit,781.88,-1015539.34,GBP,Starbucks
TXN0000005231,2024-02-02T16:36:10,ACC00000318,Payment,1883.42,-1017422.76,JPY,Target
TXN0000005232,2024-07-11T04:51:35,ACC00001048,Debit,544.61,-1017967.37,JPY,Restaurant
TXN0000005233,2024-02-25T16:12:48,ACC00004601,Payment,179.98,-1018147.35,USD,Restaurant
TXN0000005234,2024-12-22T22:43:43,ACC00004073,ATM,827.92,-1018975.27,USD,Grocery
TXN0000005235,2024-12-16T09:54:25,ACC00004456,Debit,1315.59,-1020290.86,JPY,Online Store
TXN0000005236,2024-05-12T00:42:13,ACC00008166,Payment,1673.95,-1021964.81,USD,Walmart
TXN0000005237,2024-11-18T05:34:30,ACC00003891,Debit,265.12,-1022229.93,USD,Grocery
TXN0000005238,2024-10-06T20:45:48,ACC00004798,ATM,282.41,-1022512.34,JPY,Grocery
TXN0000005239,2024-12-17T10:11:13,ACC00009112,Transfer,1633.92,-1020878.42,GBP,Walmart
TXN0000005240,2024-12-22T05:49:16,ACC00001410,Debit,1250.4,-1022128.82,JPY,Restaurant
TXN0000005241,2024-07-24T11:57:34,ACC00001488,ATM,824.07,-1022952.89,GBP,Amazon
TXN0000005242,2024-06-04T01:59:15,ACC00008271,Credit,1614.71,-1021338.18,GBP,Online Store
TXN0000005243,2024-08-07T02:57:05,ACC00003547,Transfer,1923.38,-1019414.8,GBP,Target
TXN0000005244,2024-05-17T16:23:00,ACC00009076,Debit,550.38,-1019965.18,GBP,Shell
TXN0000005245,2024-12-02T12:46:31,ACC00000812,Credit,706.44,-1019258.74,JPY,Grocery
TXN0000005246,2024-05-27T01:04:11,ACC00000260,Debit,1241.03,-1020499.77,GBP,Starbucks
TXN0000005247,2024-06-07T05:10:48,ACC00005899,Debit,1436.75,-1021936.52,USD,Starbucks
TXN0000005248,2024-07-06T22:28:23,ACC00002803,Transfer,885.47,-1021051.05,GBP,Walmart
TXN0000005249,2024-07-11T16:02:50,ACC00005799,Debit,37.43,-1021088.48,USD,Shell
TXN0000005250,2024-07-02T09:41:18,ACC00007410,ATM,600.76,-1021689.24,GBP,Shell
TXN0000005251,2024-07-25T04:44:37,ACC00000130,Payment,1870.92,-1023560.16,JPY,Amazon
TXN0000005252,2024-06-18T04:46:30,ACC00005426,Transfer,1635.98,-1021924.18,USD,Online Store
TXN0000005253,2024-11-16T10:03:04,ACC00004281,Credit,242.25,-1021681.93,EUR,Target
TXN0000005254,2024-06-22T23:17:03,ACC00009807,ATM,280.22,-1021962.15,EUR,Walmart
TXN0000005255,2024-03-23T19:12:22,ACC00006922,Debit,1495.57,-1023457.72,EUR,Target
TXN0000005256,2024-11-13T03:45:34,ACC00008127,Credit,1106.71,-1022351.01,JPY,Target
TXN0000005257,2024-01-04T12:53:51,ACC00005635,Credit,918.03,-1021432.98,EUR,Walmart
TXN0000005258,2024-08-26T23:54:42,ACC00005224,Transfer,1105.25,-1020327.73,EUR,Shell
TXN0000005259,2024-05-31T12:24:08,ACC00007914,Payment,1685.89,-1022013.62,EUR,Online Store
TXN0000005260,2024-04-13T11:32:35,ACC00006978,Debit,1321.96,-1023335.58,EUR,Amazon
TXN0000005261,2024-02-02T15:28:17,ACC00002930,Debit,1562.35,-1024897.93,JPY,Shell
TXN0000005262,2024-09-14T16:48:27,ACC00004226,Payment,188.66,-1025086.59,JPY,Amazon
TXN0000005263,2024-10-27T17:05:56,ACC00004657,ATM,1135.46,-1026222.05,EUR,Shell
TXN0000005264,2024-01-22T01:55:53,ACC00007416,ATM,27.46,-1026249.51,JPY,Online Store
TXN0000005265,2024-09-15T14:11:38,ACC00001758,Transfer,1925.96,-1024323.55,EUR,Restaurant
TXN0000005266,2024-06-19T04:24:48,ACC00000047,Payment,1087.35,-1025410.9,GBP,Walmart
TXN0000005267,2024-09-28T13:41:46,ACC00004517,ATM,805.52,-1026216.42,JPY,Shell
TXN0000005268,2024-01-28T14:14:14,ACC00003635,Payment,357.5,-1026573.92,GBP,Shell
TXN0000005269,2024-03-23T13:29:26,ACC00001425,Payment,1682.81,-1028256.73,EUR,Restaurant
TXN0000005270,2024-11-25T01:53:52,ACC00003178,Transfer,166.51,-1028090.22,USD,Amazon
TXN0000005271,2024-09-12T20:35:53,ACC00003732,Payment,1842.86,-1029933.08,USD,Walmart
TXN0000005272,2024-10-01T16:20:21,ACC00008854,Debit,256.88,-1030189.96,EUR,Shell
TXN0000005273,2024-12-09T11:02:49,ACC00005839,Credit,1287.76,-1028902.2,JPY,Starbucks
TXN0000005274,2024-10-19T07:14:23,ACC00002900,Debit,1017.41,-1029919.61,USD,Online Store
TXN0000005275,2024-09-19T04:02:52,ACC00002484,Credit,725.27,-1029194.34,EUR,Target
TXN0000005276,2024-12-01T05:49:12,ACC00003078,ATM,916.19,-1030110.53,USD,Restaurant
TXN0000005277,2024-08-15T19:34:00,ACC00004092,Credit,151.76,-1029958.77,GBP,Restaurant
TXN0000005278,2024-01-07T14:17:54,ACC00000497,Credit,368.55,-1029590.22,GBP,Restaurant
TXN0000005279,2024-10-15T11:22:25,ACC00000121,Payment,1205.69,-1030795.91,GBP,Walmart
TXN0000005280,2024-04-16T15:02:04,ACC00001318,Payment,1492.41,-1032288.32,USD,Amazon
TXN0000005281,2024-12-05T15:50:46,ACC00005938,Credit,520.41,-1031767.91,USD,Online Store
TXN0000005282,2024-09-05T13:38:04,ACC00002368,Transfer,1233.6,-1030534.31,JPY,Starbucks
TXN0000005283,2024-09-07T03:11:32,ACC00006255,ATM,1202.39,-1031736.7,USD,Shell
TXN0000005284,2024-05-08T17:17:57,ACC00009598,ATM,280.89,-1032017.59,JPY,Grocery
TXN0000005285,2024-04-16T04:50:17,ACC00004166,ATM,1541.53,-1033559.12,USD,Online Store
TXN0000005286,2024-09-26T10:22:29,ACC00009260,Debit,1774.65,-1035333.77,EUR,Walmart
TXN0000005287,2024-01-31T10:39:01,ACC00005649,ATM,1783.2,-1037116.97,JPY,Grocery
TXN0000005288,2024-03-14T08:52:34,ACC00000549,Debit,41.5,-1037158.47,EUR,Walmart
TXN0000005289,2024-04-01T23:39:05,ACC00000925,Payment,397.51,-1037555.98,JPY,Amazon
TXN0000005290,2024-08-07T11:07:07,ACC00004588,Debit,1426.69,-1038982.67,USD,Starbucks
TXN0000005291,2024-09-18T16:38:34,ACC00006285,Transfer,450.33,-1038532.34,USD,Online Store
TXN0000005292,2024-10-27T00:21:32,ACC00009269,Payment,1326.42,-1039858.76,USD,Restaurant
TXN0000005293,2024-01-10T03:16:36,ACC00000861,Credit,1239.78,-1038618.98,GBP,Online Store
TXN0000005294,2024-09-28T09:12:44,ACC00001648,Payment,249.32,-1038868.3,GBP,Amazon
TXN0000005295,2024-01-31T11:05:43,ACC00006683,Debit,1178.8,-1040047.1,JPY,Target
TXN0000005296,2024-11-21T18:42:34,ACC00005419,Debit,762.96,-1040810.06,JPY,Amazon
TXN0000005297,2024-04-27T15:49:37,ACC00009765,ATM,1820.62,-1042630.68,GBP,Walmart
TXN0000005298,2024-11-14T06:59:54,ACC00009811,Transfer,1466.9,-1041163.78,JPY,Starbucks
TXN0000005299,2024-09-19T01:05:38,ACC00003741,Transfer,1836.7,-1039327.08,GBP,Target
TXN0000005300,2024-03-03T00:27:48,ACC00004951,Credit,456.18,-1038870.9,GBP,Shell
TXN0000005301,2024-05-10T00:47:49,ACC00006960,Debit,1141.32,-1040012.22,JPY,Target
TXN0000005302,2024-10-03T13:02:36,ACC00002802,ATM,1849.12,-1041861.34,EUR,Restaurant
TXN0000005303,2024-06-19T22:30:23,ACC00002855,ATM,985.72,-1042847.06,JPY,Target
TXN0000005304,2024-10-15T22:13:02,ACC00001215,Debit,1032.27,-1043879.33,USD,Target
TXN0000005305,2024-01-17T08:43:36,ACC00006246,Debit,1753.64,-1045632.97,USD,Target
TXN0000005306,2024-09-23T13:15:03,ACC00003589,ATM,1910.62,-1047543.59,JPY,Walmart
TXN0000005307,2024-11-30T12:08:55,ACC00009682,Credit,1599.69,-1045943.9,USD,Walmart
TXN0000005308,2024-07-27T08:59:32,ACC00001467,Transfer,1494.0,-1044449.9,USD,Amazon
TXN0000005309,2024-05-30T19:17:04,ACC00006258,Transfer,507.47,-1043942.43,GBP,Shell
TXN0000005310,2024-10-30T06:14:01,ACC00002428,Transfer,648.27,-1043294.16,JPY,Online Store
TXN0000005311,2024-12-08T17:45:05,ACC00008611,Credit,1831.35,-1041462.81,JPY,Walmart
TXN0000005312,2024-01-15T16:08:04,ACC00002683,ATM,1614.23,-1043077.04,GBP,Grocery
TXN0000005313,2024-06-08T19:57:04,ACC00001241,Credit,1744.94,-1041332.1,EUR,Restaurant
TXN0000005314,2024-10-02T01:28:27,ACC00000558,Debit,905.1,-1042237.2,EUR,Amazon
TXN0000005315,2024-09-15T09:23:10,ACC00008761,Credit,422.16,-1041815.04,JPY,Grocery
TXN0000005316,2024-05-15T21:24:08,ACC00006994,Debit,1096.08,-1042911.12,GBP,Target
TXN0000005317,2024-02-04T14:11:21,ACC00009731,Payment,223.07,-1043134.19,GBP,Starbucks
TXN0000005318,2024-02-20T04:49:50,ACC00009519,Credit,533.87,-1042600.32,USD,Online Store
TXN0000005319,2024-06-02T09:42:22,ACC00007454,Debit,1444.59,-1044044.91,JPY,Restaurant
TXN0000005320,2024-10-21T09:15:47,ACC00008659,Payment,1574.92,-1045619.83,EUR,Starbucks
TXN0000005321,2024-05-30T18:39:29,ACC00008731,ATM,882.89,-1046502.72,GBP,Walmart
TXN0000005322,2024-07-18T16:22:35,ACC00009225,Debit,699.53,-1047202.25,EUR,Amazon
TXN0000005323,2024-11-03T18:11:43,ACC00009482,Credit,1545.14,-1045657.11,EUR,Starbucks
TXN0000005324,2024-02-24T11:35:57,ACC00005408,ATM,778.02,-1046435.13,EUR,Walmart
TXN0000005325,2024-05-16T20:21:43,ACC00008028,Debit,978.21,-1047413.34,EUR,Target
TXN0000005326,2024-03-11T21:50:15,ACC00009924,Debit,603.76,-1048017.1,EUR,Amazon
TXN0000005327,2024-12-23T02:15:15,ACC00007285,Payment,353.71,-1048370.81,GBP,Target
TXN0000005328,2024-06-27T20:16:45,ACC00006316,Transfer,1800.33,-1046570.48,USD,Starbucks
TXN0000005329,2024-07-23T17:53:45,ACC00003543,Debit,576.32,-1047146.8,GBP,Grocery
TXN0000005330,2024-02-03T11:13:34,ACC00009158,Credit,1203.66,-1045943.14,EUR,Grocery
TXN0000005331,2024-01-22T20:00:41,ACC00003169,Transfer,238.01,-1045705.13,EUR,Shell
TXN0000005332,2024-01-03T03:10:50,ACC00001552,Credit,1314.26,-1044390.87,EUR,Online Store
TXN0000005333,2024-12-21T17:09:44,ACC00003525,Payment,1036.96,-1045427.83,JPY,Online Store
TXN0000005334,2024-02-11T06:15:08,ACC00005479,Debit,963.89,-1046391.72,EUR,Grocery
TXN0000005335,2024-12-06T20:53:49,ACC00000374,Payment,446.55,-1046838.27,GBP,Walmart
TXN0000005336,2024-12-23T14:34:59,ACC00001157,Debit,362.16,-1047200.43,JPY,Target
TXN0000005337,2024-10-07T09:32:57,ACC00009345,Credit,510.92,-1046689.51,USD,Restaurant
TXN0000005338,2024-12-03T18:46:20,ACC00009738,Credit,1965.12,-1044724.39,USD,Target
TXN0000005339,2024-12-14T17:21:09,ACC00007923,ATM,742.09,-1045466.48,USD,Shell
TXN0000005340,2024-05-17T01:54:26,ACC00009302,ATM,176.71,-1045643.19,JPY,Walmart
TXN0000005341,2024-03-20T10:06:48,ACC00009405,Payment,381.42,-1046024.61,GBP,Online Store
TXN0000005342,2024-02-03T17:17:15,ACC00006308,Credit,1038.19,-1044986.42,JPY,Restaurant
TXN0000005343,2024-07-27T05:19:55,ACC00002806,Credit,332.1,-1044654.32,EUR,Online Store
TXN0000005344,2024-09-05T16:58:35,ACC00004830,ATM,85.41,-1044739.73,GBP,Target
TXN0000005345,2024-10-05T07:29:22,ACC00001100,Payment,988.43,-1045728.16,GBP,Starbucks
TXN0000005346,2024-08-21T21:38:39,ACC00003747,Debit,972.75,-1046700.91,JPY,Walmart
TXN0000005347,2024-06-26T15:15:22,ACC00008376,Debit,1533.29,-1048234.2,USD,Starbucks
TXN0000005348,2024-12-26T04:34:16,ACC00009011,Credit,856.99,-1047377.21,EUR,Restaurant
TXN0000005349,2024-05-03T01:16:18,ACC00006613,Transfer,1353.12,-1046024.09,JPY,Online Store
TXN0000005350,2024-02-12T17:21:04,ACC00000399,Transfer,1092.57,-1044931.52,JPY,Starbucks
TXN0000005351,2024-07-22T05:22:55,ACC00003036,Credit,25.89,-1044905.63,USD,Amazon
TXN0000005352,2024-09-19T23:15:05,ACC00007940,ATM,1878.42,-1046784.05,GBP,Online Store
TXN0000005353,2024-11-12T18:17:44,ACC00009600,Debit,1511.92,-1048295.97,USD,Shell
TXN0000005354,2024-12-19T05:37:26,ACC00002642,Transfer,1904.58,-1046391.39,JPY,Restaurant
TXN0000005355,2024-10-08T06:29:23,ACC00001957,Payment,1426.46,-1047817.85,EUR,Amazon
TXN0000005356,2024-04-23T09:12:08,ACC00007260,Transfer,1305.94,-1046511.91,JPY,Amazon
TXN0000005357,2024-09-04T00:53:28,ACC00001774,Credit,574.63,-1045937.28,EUR,Starbucks
TXN0000005358,2024-07-24T16:34:23,ACC00002589,Debit,663.68,-1046600.96,EUR,Amazon
TXN0000005359,2024-05-29T12:48:45,ACC00008351,Transfer,1239.04,-1045361.92,USD,Target
TXN0000005360,2024-08-08T19:53:38,ACC00002779,Credit,1832.65,-1043529.27,EUR,Target
TXN0000005361,2024-01-01T07:54:10,ACC00009514,Debit,759.64,-1044288.91,USD,Shell
TXN0000005362,2024-07-06T09:45:43,ACC00000096,Payment,242.53,-1044531.44,EUR,Shell
TXN0000005363,2024-12-28T21:57:14,ACC00005111,Debit,224.54,-1044755.98,EUR,Amazon
TXN0000005364,2024-06-12T10:22:08,ACC00009814,Transfer,236.78,-1044519.2,EUR,Grocery
TXN0000005365,2024-06-18T08:26:03,ACC00001353,Payment,1009.02,-1045528.22,EUR,Walmart
TXN0000005366,2024-06-19T09:51:46,ACC00006180,Debit,196.07,-1045724.29,USD,Online Store
TXN0000005367,2024-06-13T23:22:18,ACC00007427,Credit,632.9,-1045091.39,EUR,Restaurant
TXN0000005368,2024-02-10T03:38:41,ACC00005216,Debit,1619.68,-1046711.07,USD,Restaurant
TXN0000005369,2024-10-04T21:55:55,ACC00004743,Debit,1656.06,-1048367.13,JPY,Shell
TXN0000005370,2024-04-07T07:07:29,ACC00009641,Debit,34.02,-1048401.15,EUR,Online Store
TXN0000005371,2024-06-08T21:50:30,ACC00004152,Payment,1027.84,-1049428.99,GBP,Grocery
TXN0000005372,2024-03-10T11:59:01,ACC00001853,Payment,1379.77,-1050808.76,JPY,Starbucks
TXN0000005373,2024-10-14T10:31:55,ACC00000137,ATM,187.34,-1050996.1,JPY,Target
TXN0000005374,2024-11-29T01:58:44,ACC00007433,ATM,1136.44,-1052132.54,USD,Grocery
TXN0000005375,2024-02-14T22:12:33,ACC00000675,Payment,1992.19,-1054124.73,USD,Grocery
TXN0000005376,2024-02-12T15:26:28,ACC00004159,Payment,1222.42,-1055347.15,USD,Amazon
TXN0000005377,2024-10-19T06:14:30,ACC00006965,Payment,1803.56,-1057150.71,GBP,Amazon
TXN0000005378,2024-11-05T11:22:04,ACC00000890,Credit,609.14,-1056541.57,USD,Online Store
TXN0000005379,2024-06-25T04:10:26,ACC00009574,Credit,1836.77,-1054704.8,EUR,Restaurant
TXN0000005380,2024-07-03T06:21:19,ACC00007724,Transfer,325.75,-1054379.05,JPY,Target
TXN0000005381,2024-11-07T19:35:58,ACC00006366,Credit,1094.42,-1053284.63,JPY,Shell
TXN0000005382,2024-09-09T17:14:35,ACC00008064,Credit,1107.0,-1052177.63,EUR,Restaurant
TXN0000005383,2024-08-14T10:43:20,ACC00008586,Debit,839.44,-1053017.07,GBP,Restaurant
TXN0000005384,2024-09-02T08:52:59,ACC00008496,Credit,677.51,-1052339.56,GBP,Amazon
TXN0000005385,2024-02-26T05:32:12,ACC00006125,Debit,1059.87,-1053399.43,JPY,Starbucks
TXN0000005386,2024-02-18T05:38:33,ACC00001090,Credit,1784.15,-1051615.28,USD,Starbucks
TXN0000005387,2024-05-03T04:30:30,ACC00008290,Transfer,1419.09,-1050196.19,JPY,Online Store
TXN0000005388,2024-03-28T12:43:32,ACC00008049,Transfer,1648.41,-1048547.78,GBP,Starbucks
TXN0000005389,2024-04-01T04:10:20,ACC00005650,Debit,89.56,-1048637.34,JPY,Walmart
TXN0000005390,2024-05-30T23:11:26,ACC00007810,Transfer,1842.67,-1046794.67,JPY,Shell
TXN0000005391,2024-11-04T04:37:40,ACC00008740,Debit,906.55,-1047701.22,EUR,Walmart
TXN0000005392,2024-12-06T01:01:04,ACC00003357,Transfer,1150.76,-1046550.46,USD,Online Store
TXN0000005393,2024-02-04T16:15:59,ACC00003926,Transfer,365.43,-1046185.03,USD,Online Store
TXN0000005394,2024-04-03T20:01:15,ACC00009313,ATM,541.89,-1046726.92,USD,Walmart
TXN0000005395,2024-01-30T03:02:54,ACC00004086,ATM,235.56,-1046962.48,GBP,Walmart
TXN0000005396,2024-01-16T19:04:36,ACC00006008,Credit,1213.64,-1045748.84,EUR,Shell
TXN0000005397,2024-09-26T06:36:08,ACC00000919,Credit,713.57,-1045035.27,EUR,Amazon
TXN0000005398,2024-09-03T21:52:01,ACC00006355,ATM,1578.22,-1046613.49,GBP,Grocery
TXN0000005399,2024-11-15T04:29:30,ACC00009973,ATM,903.19,-1047516.68,JPY,Restaurant
TXN0000005400,2024-03-10T21:32:58,ACC00004388,Transfer,164.21,-1047352.47,USD,Restaurant
TXN0000005401,2024-06-23T18:57:55,ACC00007315,Payment,1529.0,-1048881.47,JPY,Restaurant
TXN0000005402,2024-04-29T18:07:19,ACC00000939,ATM,802.27,-1049683.74,JPY,Walmart
TXN0000005403,2024-06-17T05:33:44,ACC00007347,Debit,1865.35,-1051549.09,EUR,Target
TXN0000005404,2024-04-26T00:01:53,ACC00006003,Payment,814.55,-1052363.64,USD,Shell
TXN0000005405,2024-10-07T22:38:27,ACC00001647,Credit,216.33,-1052147.31,GBP,Shell
TXN0000005406,2024-08-12T18:37:01,ACC00000686,Debit,102.51,-1052249.82,EUR,Grocery
TXN0000005407,2024-02-29T19:39:52,ACC00007693,Transfer,1668.81,-1050581.01,USD,Target
TXN0000005408,2024-07-30T06:46:25,ACC00009879,Transfer,98.86,-1050482.15,USD,Restaurant
TXN0000005409,2024-12-09T03:02:08,ACC00000552,Transfer,1479.96,-1049002.19,USD,Amazon
TXN0000005410,2024-12-30T09:47:56,ACC00000865,Debit,1667.93,-1050670.12,JPY,Shell
TXN0000005411,2024-09-30T20:23:00,ACC00000743,Payment,1270.88,-1051941.0,USD,Target
TXN0000005412,2024-11-01T18:55:38,ACC00002087,Payment,1100.2,-1053041.2,USD,Shell
TXN0000005413,2024-02-25T19:44:16,ACC00005635,Payment,1183.82,-1054225.02,EUR,Target
TXN0000005414,2024-03-22T22:50:51,ACC00005790,Credit,440.7,-1053784.32,EUR,Amazon
TXN0000005415,2024-02-20T12:16:35,ACC00003987,Payment,929.77,-1054714.09,EUR,Online Store
TXN0000005416,2024-02-18T06:44:36,ACC00009803,Credit,1766.82,-1052947.27,EUR,Target
TXN0000005417,2024-07-15T14:53:05,ACC00006881,Payment,1733.6,-1054680.87,JPY,Walmart
TXN0000005418,2024-07-20T06:19:48,ACC00003929,Debit,1262.24,-1055943.11,GBP,Grocery
TXN0000005419,2024-02-19T16:07:27,ACC00008110,Credit,1951.91,-1053991.2,GBP,Grocery
TXN0000005420,2024-06-18T11:19:49,ACC00007016,Transfer,759.44,-1053231.76,USD,Online Store
TXN0000005421,2024-02-11T03:03:59,ACC00000888,Payment,595.26,-1053827.02,USD,Starbucks
TXN0000005422,2024-09-23T07:35:26,ACC00006659,Debit,1562.5,-1055389.52,EUR,Starbucks
TXN0000005423,2024-12-13T09:47:36,ACC00001808,Transfer,206.36,-1055183.16,GBP,Walmart
TXN0000005424,2024-11-05T21:26:26,ACC00008344,Payment,1509.84,-1056693.0,JPY,Grocery
TXN0000005425,2024-05-01T03:54:34,ACC00002822,Payment,605.92,-1057298.92,GBP,Amazon
TXN0000005426,2024-10-01T00:02:17,ACC00008574,Transfer,1744.4,-1055554.52,JPY,Restaurant
TXN0000005427,2024-09-01T19:48:31,ACC00009827,Payment,1799.65,-1057354.17,USD,Shell
TXN0000005428,2024-01-03T00:57:53,ACC00008897,Credit,1167.75,-1056186.42,JPY,Walmart
TXN0000005429,2024-06-23T21:54:35,ACC00002623,Transfer,1273.41,-1054913.01,JPY,Walmart
TXN0000005430,2024-01-19T02:40:13,ACC00004737,Credit,1736.79,-1053176.22,EUR,Starbucks
TXN0000005431,2024-05-19T11:31:07,ACC00006940,Transfer,1094.83,-1052081.39,JPY,Online Store
TXN0000005432,2024-02-17T23:38:14,ACC00003130,Payment,1057.6,-1053138.99,USD,Restaurant
TXN0000005433,2024-05-07T13:40:53,ACC00001141,Credit,1894.34,-1051244.65,JPY,Grocery
TXN0000005434,2024-10-05T01:00:25,ACC00009242,Debit,1436.82,-1052681.47,USD,Online Store
TXN0000005435,2024-01-11T18:37:11,ACC00006340,Payment,1026.57,-1053708.04,USD,Grocery
TXN0000005436,2024-06-22T12:13:56,ACC00002456,ATM,1334.04,-1055042.08,GBP,Walmart
TXN0000005437,2024-03-17T18:36:23,ACC00003189,Transfer,392.76,-1054649.32,GBP,Target
TXN0000005438,2024-02-27T04:29:34,ACC00009285,ATM,158.84,-1054808.16,GBP,Online Store
TXN0000005439,2024-04-02T09:50:42,ACC00003600,Payment,325.83,-1055133.99,GBP,Target
TXN0000005440,2024-05-26T02:34:51,ACC00006382,Transfer,372.35,-1054761.64,JPY,Target
TXN0000005441,2024-10-15T00:30:18,ACC00006502,Transfer,609.24,-1054152.4,GBP,Amazon
TXN0000005442,2024-03-28T07:34:12,ACC00002602,Credit,1829.49,-1052322.91,USD,Restaurant
TXN0000005443,2024-04-30T05:41:13,ACC00001686,Transfer,723.53,-1051599.38,GBP,Amazon
TXN0000005444,2024-12-09T02:48:50,ACC00001979,Payment,1272.99,-1052872.37,USD,Online Store
TXN0000005445,2024-03-23T17:23:25,ACC00007448,Credit,959.94,-1051912.43,USD,Restaurant
TXN0000005446,2024-07-14T08:04:13,ACC00008984,Transfer,1160.45,-1050751.98,USD,Shell
TXN0000005447,2024-07-29T17:45:55,ACC00003752,ATM,646.51,-1051398.49,JPY,Walmart
TXN0000005448,2024-12-22T02:54:57,ACC00001113,ATM,1655.32,-1053053.81,USD,Target
TXN0000005449,2024-11-23T01:19:33,ACC00001619,Credit,1199.44,-1051854.37,JPY,Target
TXN0000005450,2024-01-23T00:57:28,ACC00001257,Transfer,163.54,-1051690.83,EUR,Target
TXN0000005451,2024-05-21T12:43:06,ACC00005374,Transfer,1309.15,-1050381.68,EUR,Walmart
TXN0000005452,2024-05-30T21:17:00,ACC00004280,Payment,1807.89,-1052189.57,JPY,Restaurant
TXN0000005453,2024-11-28T19:51:39,ACC00004694,Transfer,429.46,-1051760.11,GBP,Target
TXN0000005454,2024-02-20T21:08:01,ACC00008298,Payment,366.91,-1052127.02,EUR,Walmart
TXN0000005455,2024-04-16T16:26:35,ACC00000790,Credit,680.85,-1051446.17,GBP,Online Store
TXN0000005456,2024-06-06T06:23:48,ACC00005985,Debit,542.99,-1051989.16,EUR,Grocery
TXN0000005457,2024-12-16T17:04:13,ACC00000537,Payment,1511.75,-1053500.91,EUR,Restaurant
TXN0000005458,2024-03-05T10:05:18,ACC00008684,ATM,882.07,-1054382.98,JPY,Walmart
TXN0000005459,2024-06-08T02:41:11,ACC00002823,Debit,550.87,-1054933.85,JPY,Amazon
TXN0000005460,2024-07-22T00:24:47,ACC00007969,Debit,1049.61,-1055983.46,EUR,Grocery
TXN0000005461,2024-09-28T01:24:17,ACC00001969,ATM,1453.69,-1057437.15,GBP,Restaurant
TXN0000005462,2024-12-17T00:39:08,ACC00007277,Debit,468.28,-1057905.43,JPY,Target
TXN0000005463,2024-08-31T22:58:35,ACC00007520,Payment,26.57,-1057932.0,JPY,Shell
TXN0000005464,2024-01-11T21:00:26,ACC00000585,Payment,478.78,-1058410.78,GBP,Amazon
TXN0000005465,2024-08-03T19:39:39,ACC00007562,Payment,996.3,-1059407.08,GBP,Online Store
TXN0000005466,2024-06-30T08:01:23,ACC00005437,Payment,1944.06,-1061351.14,EUR,Online Store
TXN0000005467,2024-04-09T05:11:29,ACC00008474,Credit,1542.25,-1059808.89,JPY,Walmart
TXN0000005468,2024-05-02T23:40:56,ACC00008473,Credit,821.27,-1058987.62,USD,Shell
TXN0000005469,2024-04-02T11:54:35,ACC00008496,Transfer,1088.01,-1057899.61,EUR,Amazon
TXN0000005470,2024-05-02T21:29:39,ACC00002851,Credit,836.54,-1057063.07,JPY,Shell
TXN0000005471,2024-06-17T07:50:22,ACC00006645,Payment,243.53,-1057306.6,GBP,Online Store
TXN0000005472,2024-10-29T12:28:26,ACC00001946,Credit,676.27,-1056630.33,USD,Online Store
TXN0000005473,2024-11-06T06:33:39,ACC00000230,Transfer,431.49,-1056198.84,USD,Amazon
TXN0000005474,2024-04-11T16:54:52,ACC00006852,Credit,1005.63,-1055193.21,GBP,Walmart
TXN0000005475,2024-08-11T03:52:55,ACC00004977,ATM,638.56,-1055831.77,JPY,Amazon
TXN0000005476,2024-06-11T02:08:30,ACC00007528,Debit,1488.61,-1057320.38,JPY,Amazon
TXN0000005477,2024-05-07T00:28:53,ACC00006377,Credit,794.29,-1056526.09,USD,Target
TXN0000005478,2024-04-02T15:12:46,ACC00007009,Credit,798.19,-1055727.9,GBP,Target
TXN0000005479,2024-12-24T23:30:32,ACC00006674,Credit,713.28,-1055014.62,JPY,Walmart
TXN0000005480,2024-02-10T13:33:37,ACC00006000,Debit,1058.07,-1056072.69,GBP,Online Store
TXN0000005481,2024-09-16T14:53:44,ACC00000755,Credit,1441.4,-1054631.29,EUR,Walmart
TXN0000005482,2024-02-14T10:58:36,ACC00007404,Credit,17.04,-1054614.25,EUR,Grocery
TXN0000005483,2024-02-03T22:40:59,ACC00002862,ATM,1918.94,-1056533.19,USD,Target
TXN0000005484,2024-07-05T20:03:21,ACC00005476,Transfer,1407.39,-1055125.8,JPY,Restaurant
TXN0000005485,2024-07-27T14:37:08,ACC00007525,Payment,107.62,-1055233.42,JPY,Starbucks
TXN0000005486,2024-10-25T02:37:24,ACC00004261,Credit,1347.95,-1053885.47,USD,Walmart
TXN0000005487,2024-03-07T06:13:07,ACC00000529,Transfer,1950.74,-1051934.73,JPY,Online Store
TXN0000005488,2024-11-25T22:56:41,ACC00000397,ATM,1056.17,-1052990.9,EUR,Restaurant
TXN0000005489,2024-04-03T18:29:44,ACC00002258,Transfer,851.33,-1052139.57,USD,Amazon
TXN0000005490,2024-03-31T18:04:01,ACC00002070,ATM,961.56,-1053101.13,JPY,Walmart
TXN0000005491,2024-12-09T00:44:47,ACC00002007,Credit,189.6,-1052911.53,GBP,Restaurant
TXN0000005492,2024-02-22T04:55:59,ACC00004039,ATM,1389.64,-1054301.17,USD,Target
TXN0000005493,2024-12-16T00:04:01,ACC00005400,Credit,1870.95,-1052430.22,EUR,Starbucks
TXN0000005494,2024-04-21T01:40:02,ACC00008442,Payment,368.17,-1052798.39,JPY,Grocery
TXN0000005495,2024-02-14T23:38:07,ACC00002177,Debit,1398.93,-1054197.32,JPY,Online Store
TXN0000005496,2024-11-12T09:50:47,ACC00008000,Debit,1227.01,-1055424.33,JPY,Amazon
TXN0000005497,2024-05-08T06:00:47,ACC00006667,Transfer,300.97,-1055123.36,GBP,Amazon
TXN0000005498,2024-12-22T08:48:59,ACC00006513,Credit,495.22,-1054628.14,GBP,Amazon
TXN0000005499,2024-03-25T03:19:11,ACC00003952,Transfer,1758.96,-1052869.18,GBP,Restaurant
TXN0000005500,2024-01-16T08:24:18,ACC00000097,Transfer,106.46,-1052762.72,EUR,Restaurant
TXN0000005501,2024-04-28T12:32:24,ACC00007280,ATM,860.53,-1053623.25,JPY,Target
TXN0000005502,2024-08-12T14:50:26,ACC00002139,Debit,745.85,-1054369.1,EUR,Shell
TXN0000005503,2024-02-04T09:36:24,ACC00005616,Payment,1280.2,-1055649.3,GBP,Starbucks
TXN0000005504,2024-09-21T00:29:00,ACC00005595,Debit,232.79,-1055882.09,JPY,Starbucks
TXN0000005505,2024-02-12T02:45:10,ACC00000227,Debit,1837.12,-1057719.21,JPY,Shell
TXN0000005506,2024-07-02T21:47:37,ACC00009116,Payment,1974.94,-1059694.15,EUR,Target
TXN0000005507,2024-05-15T05:08:02,ACC00002284,Payment,991.86,-1060686.01,EUR,Walmart
TXN0000005508,2024-12-21T01:43:15,ACC00001177,Transfer,84.33,-1060601.68,USD,Starbucks
TXN0000005509,2024-03-21T08:04:00,ACC00004584,ATM,156.75,-1060758.43,USD,Restaurant
TXN0000005510,2024-01-04T15:30:50,ACC00003606,Payment,1137.56,-1061895.99,JPY,Target
TXN0000005511,2024-10-25T03:31:17,ACC00009568,ATM,39.27,-1061935.26,JPY,Restaurant
TXN0000005512,2024-01-28T05:25:02,ACC00006043,Credit,1764.05,-1060171.21,JPY,Online Store
TXN0000005513,2024-06-23T15:53:16,ACC00006650,ATM,861.12,-1061032.33,GBP,Starbucks
TXN0000005514,2024-01-21T05:16:11,ACC00009299,Transfer,602.96,-1060429.37,EUR,Online Store
TXN0000005515,2024-06-13T17:28:51,ACC00005135,Transfer,615.39,-1059813.98,EUR,Online Store
TXN0000005516,2024-09-13T08:04:38,ACC00004491,ATM,270.09,-1060084.07,GBP,Restaurant
TXN0000005517,2024-06-12T22:33:34,ACC00007348,Payment,471.13,-1060555.2,USD,Target
TXN0000005518,2024-02-12T13:56:46,ACC00006086,Debit,1469.52,-1062024.72,USD,Starbucks
TXN0000005519,2024-02-10T22:27:24,ACC00004000,Transfer,416.66,-1061608.06,JPY,Restaurant
TXN0000005520,2024-02-09T20:38:38,ACC00008900,Transfer,107.09,-1061500.97,JPY,Walmart
TXN0000005521,2024-07-08T01:15:14,ACC00009331,Credit,1341.13,-1060159.84,EUR,Amazon
TXN0000005522,2024-02-15T01:16:48,ACC00002250,Credit,211.95,-1059947.89,GBP,Target
TXN0000005523,2024-11-19T01:15:46,ACC00005611,Credit,1993.36,-1057954.53,EUR,Online Store
TXN0000005524,2024-10-30T16:52:23,ACC00002286,Debit,1604.36,-1059558.89,EUR,Starbucks
TXN0000005525,2024-09-12T23:43:47,ACC00009207,Transfer,550.9,-1059007.99,JPY,Shell
TXN0000005526,2024-10-03T09:40:59,ACC00008689,Debit,802.55,-1059810.54,GBP,Shell
TXN0000005527,2024-10-27T23:54:28,ACC00003798,ATM,837.27,-1060647.81,USD,Online Store
TXN0000005528,2024-09-18T05:06:36,ACC00005055,Payment,826.04,-1061473.85,GBP,Target
TXN0000005529,2024-06-06T22:53:31,ACC00002988,Transfer,1217.51,-1060256.34,USD,Target
TXN0000005530,2024-02-06T07:03:00,ACC00003881,Debit,654.13,-1060910.47,USD,Target
TXN0000005531,2024-10-23T00:52:32,ACC00003854,Credit,926.07,-1059984.4,EUR,Starbucks
TXN0000005532,2024-02-14T04:07:15,ACC00001964,ATM,1976.06,-1061960.46,GBP,Amazon
TXN0000005533,2024-03-01T02:50:00,ACC00000539,Credit,1574.5,-1060385.96,EUR,Starbucks
TXN0000005534,2024-10-27T14:10:51,ACC00005850,Credit,161.53,-1060224.43,GBP,Target
TXN0000005535,2024-07-06T18:09:34,ACC00005922,ATM,216.76,-1060441.19,GBP,Shell
TXN0000005536,2024-08-23T05:50:42,ACC00000458,Debit,1659.2,-1062100.39,JPY,Grocery
TXN0000005537,2024-06-12T18:55:36,ACC00008512,Payment,1283.68,-1063384.07,EUR,Target
TXN0000005538,2024-10-26T17:38:27,ACC00006589,Credit,1269.9,-1062114.17,JPY,Starbucks
TXN0000005539,2024-06-09T12:42:45,ACC00004318,Transfer,811.68,-1061302.49,GBP,Restaurant
TXN0000005540,2024-04-08T10:17:25,ACC00006876,Credit,75.23,-1061227.26,EUR,Walmart
TXN0000005541,2024-05-14T08:55:45,ACC00004675,ATM,481.71,-1061708.97,JPY,Amazon
TXN0000005542,2024-01-06T03:17:04,ACC00002666,Transfer,470.29,-1061238.68,JPY,Starbucks
TXN0000005543,2024-01-11T15:57:58,ACC00005316,Transfer,215.36,-1061023.32,USD,Online Store
TXN0000005544,2024-01-03T13:40:06,ACC00009664,Payment,1252.12,-1062275.44,GBP,Starbucks
TXN0000005545,2024-12-08T02:53:48,ACC00005119,Transfer,856.8,-1061418.64,JPY,Walmart
TXN0000005546,2024-09-10T07:11:10,ACC00004419,Payment,972.21,-1062390.85,GBP,Online Store
TXN0000005547,2024-01-03T05:06:23,ACC00009706,ATM,531.1,-1062921.95,USD,Target
TXN0000005548,2024-12-06T18:01:49,ACC00000468,Credit,172.49,-1062749.46,EUR,Restaurant
TXN0000005549,2024-01-10T17:57:53,ACC00003773,Debit,747.31,-1063496.77,JPY,Restaurant
TXN0000005550,2024-05-26T02:02:19,ACC00008929,ATM,749.92,-1064246.69,GBP,Starbucks
TXN0000005551,2024-03-17T09:55:00,ACC00006529,Debit,989.58,-1065236.27,USD,Starbucks
TXN0000005552,2024-12-20T07:51:29,ACC00005192,Transfer,549.01,-1064687.26,GBP,Shell
TXN0000005553,2024-10-24T18:04:15,ACC00004618,Debit,852.35,-1065539.61,JPY,Starbucks
TXN0000005554,2024-07-06T00:44:47,ACC00003065,Payment,1834.12,-1067373.73,JPY,Online Store
TXN0000005555,2024-02-24T03:22:32,ACC00001831,Debit,1717.89,-1069091.62,EUR,Starbucks
TXN0000005556,2024-12-28T04:54:58,ACC00004635,Debit,1386.79,-1070478.41,GBP,Grocery
TXN0000005557,2024-12-08T01:38:44,ACC00007425,Payment,344.61,-1070823.02,JPY,Restaurant
TXN0000005558,2024-07-19T08:15:30,ACC00008920,Payment,1668.77,-1072491.79,JPY,Walmart
TXN0000005559,2024-06-05T21:11:05,ACC00008993,ATM,251.76,-1072743.55,JPY,Starbucks
TXN0000005560,2024-12-22T02:42:12,ACC00002997,Payment,918.8,-1073662.35,EUR,Restaurant
TXN0000005561,2024-06-29T02:14:15,ACC00003297,Credit,1739.26,-1071923.09,USD,Walmart
TXN0000005562,2024-10-30T20:39:37,ACC00008654,Transfer,422.97,-1071500.12,USD,Target
TXN0000005563,2024-06-16T06:47:03,ACC00007102,Transfer,1700.14,-1069799.98,GBP,Amazon
TXN0000005564,2024-05-03T02:44:20,ACC00004652,ATM,650.05,-1070450.03,GBP,Online Store
TXN0000005565,2024-04-26T09:26:54,ACC00004744,Debit,1253.84,-1071703.87,USD,Target
TXN0000005566,2024-01-09T08:51:14,ACC00004206,Transfer,1918.19,-1069785.68,USD,Target
TXN0000005567,2024-03-09T02:54:00,ACC00001285,ATM,1422.32,-1071208.0,GBP,Shell
TXN0000005568,2024-01-18T13:16:01,ACC00003901,Transfer,1560.29,-1069647.71,JPY,Restaurant
TXN0000005569,2024-08-03T10:33:55,ACC00000728,Credit,1534.99,-1068112.72,EUR,Online Store
TXN0000005570,2024-07-31T09:39:16,ACC00003462,Payment,1360.87,-1069473.59,JPY,Target
TXN0000005571,2024-09-05T02:33:13,ACC00006737,Debit,396.65,-1069870.24,JPY,Grocery
TXN0000005572,2024-06-23T02:47:09,ACC00001120,ATM,811.95,-1070682.19,EUR,Shell
TXN0000005573,2024-11-03T03:34:49,ACC00005295,Payment,704.39,-1071386.58,USD,Starbucks
TXN0000005574,2024-06-29T08:29:17,ACC00003100,Transfer,235.18,-1071151.4,JPY,Online Store
TXN0000005575,2024-01-02T11:06:50,ACC00006254,Credit,91.7,-1071059.7,JPY,Amazon
TXN0000005576,2024-10-10T11:26:07,ACC00001120,Payment,1640.52,-1072700.22,JPY,Restaurant
TXN0000005577,2024-03-02T22:31:41,ACC00000356,Debit,1459.21,-1074159.43,GBP,Walmart
TXN0000005578,2024-01-21T02:11:27,ACC00009737,Debit,730.14,-1074889.57,JPY,Target
TXN0000005579,2024-01-02T14:47:12,ACC00008372,ATM,712.59,-1075602.16,GBP,Target
TXN0000005580,2024-06-19T20:11:10,ACC00005490,Transfer,1849.61,-1073752.55,GBP,Walmart
TXN0000005581,2024-12-10T18:59:45,ACC00005451,Credit,1836.8,-1071915.75,EUR,Target
TXN0000005582,2024-01-09T05:10:29,ACC00004674,ATM,183.89,-1072099.64,GBP,Amazon
TXN0000005583,2024-05-30T16:50:12,ACC00008057,Debit,711.55,-1072811.19,EUR,Restaurant
TXN0000005584,2024-10-02T00:22:41,ACC00002611,Payment,81.49,-1072892.68,EUR,Starbucks
TXN0000005585,2024-10-26T01:42:43,ACC00007692,Credit,696.68,-1072196.0,JPY,Amazon
TXN0000005586,2024-08-11T02:58:14,ACC00003962,Transfer,777.26,-1071418.74,EUR,Amazon
TXN0000005587,2024-04-06T09:24:49,ACC00006025,Debit,1358.26,-1072777.0,JPY,Amazon
TXN0000005588,2024-12-13T13:07:58,ACC00006785,ATM,1503.01,-1074280.01,GBP,Online Store
TXN0000005589,2024-02-15T17:02:31,ACC00000171,Credit,474.76,-1073805.25,GBP,Restaurant
TXN0000005590,2024-09-21T20:37:20,ACC00002286,ATM,942.98,-1074748.23,USD,Walmart
TXN0000005591,2024-03-23T16:14:01,ACC00003654,Debit,1723.62,-1076471.85,JPY,Grocery
TXN0000005592,2024-11-29T07:15:52,ACC00001112,Debit,439.99,-1076911.84,GBP,Starbucks
TXN0000005593,2024-05-19T11:32:36,ACC00005241,Payment,316.07,-1077227.91,GBP,Starbucks
TXN0000005594,2024-02-10T14:13:43,ACC00001867,Transfer,639.45,-1076588.46,JPY,Shell
TXN0000005595,2024-05-10T03:43:06,ACC00008953,Credit,1329.47,-1075258.99,EUR,Online Store
TXN0000005596,2024-01-18T14:41:06,ACC00005324,Transfer,1035.2,-1074223.79,USD,Target
TXN0000005597,2024-06-04T13:20:59,ACC00002989,Debit,1369.83,-1075593.62,EUR,Online Store
TXN0000005598,2024-10-07T02:15:13,ACC00002087,ATM,1510.9,-1077104.52,EUR,Target
TXN0000005599,2024-08-22T04:50:52,ACC00002907,Credit,120.55,-1076983.97,GBP,Walmart
TXN0000005600,2024-09-29T04:01:05,ACC00004761,Credit,365.26,-1076618.71,EUR,Starbucks
TXN0000005601,2024-02-28T16:24:01,ACC00001933,Debit,754.97,-1077373.68,JPY,Amazon
TXN0000005602,2024-04-23T09:47:32,ACC00002389,Credit,1503.06,-1075870.62,JPY,Starbucks
TXN0000005603,2024-10-26T04:39:59,ACC00008735,Payment,1084.45,-1076955.07,USD,Amazon
TXN0000005604,2024-11-16T03:43:56,ACC00001104,Credit,226.91,-1076728.16,USD,Online Store
TXN0000005605,2024-06-16T14:04:22,ACC00003730,ATM,1166.62,-1077894.78,USD,Restaurant
TXN0000005606,2024-05-30T01:12:13,ACC00008238,Credit,862.91,-1077031.87,USD,Starbucks
TXN0000005607,2024-11-08T21:53:30,ACC00004654,Transfer,1202.68,-1075829.19,EUR,Restaurant
TXN0000005608,2024-11-17T09:48:38,ACC00002369,ATM,846.99,-1076676.18,GBP,Target
TXN0000005609,2024-02-21T23:49:52,ACC00009256,Debit,724.95,-1077401.13,JPY,Shell
TXN0000005610,2024-06-17T19:21:58,ACC00000081,Transfer,1994.56,-1075406.57,JPY,Restaurant
TXN0000005611,2024-06-10T09:45:00,ACC00005018,Payment,1010.55,-1076417.12,USD,Grocery
TXN0000005612,2024-03-31T17:37:26,ACC00001816,ATM,1274.67,-1077691.79,GBP,Target
TXN0000005613,2024-08-17T12:30:19,ACC00004250,Credit,57.1,-1077634.69,EUR,Amazon
TXN0000005614,2024-09-18T23:51:11,ACC00008264,ATM,1038.88,-1078673.57,USD,Walmart
TXN0000005615,2024-02-18T17:21:13,ACC00003736,Debit,626.96,-1079300.53,EUR,Target
TXN0000005616,2024-09-02T23:39:09,ACC00006502,ATM,196.93,-1079497.46,EUR,Grocery
TXN0000005617,2024-01-05T15:37:57,ACC00004177,Credit,1565.98,-1077931.48,EUR,Walmart
TXN0000005618,2024-06-20T12:33:42,ACC00003559,ATM,1131.06,-1079062.54,JPY,Restaurant
TXN0000005619,2024-08-11T08:21:38,ACC00002144,ATM,287.71,-1079350.25,JPY,Amazon
TXN0000005620,2024-08-29T23:03:00,ACC00008766,ATM,1723.43,-1081073.68,GBP,Grocery
TXN0000005621,2024-08-08T10:47:01,ACC00001451,Transfer,214.64,-1080859.04,GBP,Walmart
TXN0000005622,2024-04-20T22:40:34,ACC00006322,Payment,1107.14,-1081966.18,USD,Amazon
TXN0000005623,2024-12-30T10:41:27,ACC00008283,Transfer,404.07,-1081562.11,USD,Target
TXN0000005624,2024-11-29T23:31:42,ACC00009407,Payment,642.01,-1082204.12,GBP,Online Store
TXN0000005625,2024-06-14T18:46:31,ACC00001834,ATM,414.4,-1082618.52,EUR,Amazon
TXN0000005626,2024-04-16T14:34:02,ACC00007646,Transfer,1973.91,-1080644.61,EUR,Grocery
TXN0000005627,2024-03-16T18:06:29,ACC00008822,Debit,1946.96,-1082591.57,EUR,Grocery
TXN0000005628,2024-02-13T23:00:43,ACC00000649,ATM,1009.2,-1083600.77,JPY,Walmart
TXN0000005629,2024-04-18T11:43:53,ACC00001340,Payment,751.33,-1084352.1,GBP,Shell
TXN0000005630,2024-01-28T20:36:09,ACC00003015,Transfer,1955.56,-1082396.54,USD,Grocery
TXN0000005631,2024-12-09T06:57:32,ACC00001200,Transfer,1217.57,-1081178.97,USD,Online Store
TXN0000005632,2024-09-18T13:44:56,ACC00006637,Transfer,1673.37,-1079505.6,JPY,Walmart
TXN0000005633,2024-05-08T14:08:30,ACC00006118,Credit,92.33,-1079413.27,JPY,Restaurant
TXN0000005634,2024-03-20T03:02:46,ACC00007729,ATM,591.31,-1080004.58,EUR,Amazon
TXN0000005635,2024-09-21T01:04:40,ACC00002152,Transfer,29.99,-1079974.59,GBP,Amazon
TXN0000005636,2024-08-31T17:46:05,ACC00009430,Payment,1063.3,-1081037.89,USD,Shell
TXN0000005637,2024-06-20T12:58:22,ACC00009385,Payment,990.81,-1082028.7,GBP,Restaurant
TXN0000005638,2024-06-10T08:19:32,ACC00006184,Credit,167.94,-1081860.76,USD,Grocery
TXN0000005639,2024-09-21T13:46:48,ACC00001242,Payment,414.7,-1082275.46,USD,Walmart
TXN0000005640,2024-11-02T07:38:13,ACC00004333,Transfer,1831.1,-1080444.36,JPY,Grocery
TXN0000005641,2024-08-28T08:12:04,ACC00001415,Transfer,795.47,-1079648.89,JPY,Target
TXN0000005642,2024-05-07T21:22:15,ACC00009015,Transfer,854.58,-1078794.31,GBP,Target
TXN0000005643,2024-02-28T06:12:09,ACC00006861,Payment,47.83,-1078842.14,EUR,Online Store
TXN0000005644,2024-12-06T07:59:28,ACC00009153,Debit,1310.78,-1080152.92,USD,Walmart
TXN0000005645,2024-01-08T22:08:26,ACC00002386,Payment,1861.05,-1082013.97,GBP,Grocery
TXN0000005646,2024-01-17T15:10:58,ACC00007559,Transfer,150.53,-1081863.44,GBP,Starbucks
TXN0000005647,2024-07-30T12:19:06,ACC00006921,Payment,1392.02,-1083255.46,JPY,Amazon
TXN0000005648,2024-02-17T11:34:46,ACC00000523,ATM,723.63,-1083979.09,USD,Amazon
TXN0000005649,2024-03-02T03:46:59,ACC00008283,Payment,1064.32,-1085043.41,GBP,Shell
TXN0000005650,2024-06-24T18:51:29,ACC00003981,ATM,1695.62,-1086739.03,EUR,Restaurant
TXN0000005651,2024-11-11T13:07:27,ACC00002958,Debit,28.3,-1086767.33,JPY,Online Store
TXN0000005652,2024-05-18T22:06:47,ACC00006878,Transfer,1744.91,-1085022.42,USD,Restaurant
TXN0000005653,2024-11-08T03:45:35,ACC00001546,ATM,171.97,-1085194.39,EUR,Restaurant
TXN0000005654,2024-05-08T01:17:50,ACC00003115,Credit,1754.54,-1083439.85,JPY,Restaurant
TXN0000005655,2024-08-29T04:08:53,ACC00004210,Payment,1743.93,-1085183.78,GBP,Starbucks
TXN0000005656,2024-09-18T09:22:07,ACC00003759,ATM,1801.81,-1086985.59,GBP,Online Store
TXN0000005657,2024-09-13T10:58:34,ACC00006548,Payment,726.45,-1087712.04,JPY,Online Store
TXN0000005658,2024-12-24T09:21:08,ACC00000575,Transfer,887.93,-1086824.11,GBP,Starbucks
TXN0000005659,2024-10-14T02:13:44,ACC00002875,Credit,453.94,-1086370.17,EUR,Starbucks
TXN0000005660,2024-12-15T08:23:18,ACC00003606,Debit,645.05,-1087015.22,EUR,Starbucks
TXN0000005661,2024-08-18T20:42:15,ACC00008176,Debit,572.69,-1087587.91,USD,Target
TXN0000005662,2024-10-17T11:12:34,ACC00007829,Transfer,631.72,-1086956.19,EUR,Walmart
TXN0000005663,2024-10-11T18:09:10,ACC00009442,Transfer,155.57,-1086800.62,JPY,Grocery
TXN0000005664,2024-06-25T04:33:00,ACC00003821,Debit,485.99,-1087286.61,GBP,Target
TXN0000005665,2024-10-04T20:19:27,ACC00006692,Transfer,433.91,-1086852.7,EUR,Online Store
TXN0000005666,2024-09-14T13:57:15,ACC00003253,Transfer,1850.18,-1085002.52,EUR,Walmart
TXN0000005667,2024-10-26T18:02:20,ACC00005582,Credit,126.67,-1084875.85,JPY,Grocery
TXN0000005668,2024-06-06T22:25:42,ACC00001226,Credit,1066.34,-1083809.51,GBP,Starbucks
TXN0000005669,2024-09-28T17:47:20,ACC00006374,Credit,1059.17,-1082750.34,JPY,Shell
TXN0000005670,2024-05-08T14:19:01,ACC00009890,Payment,1504.57,-1084254.91,USD,Target
TXN0000005671,2024-01-22T03:08:49,ACC00007621,Credit,216.99,-1084037.92,JPY,Shell
TXN0000005672,2024-08-02T10:10:19,ACC00005950,Transfer,1841.68,-1082196.24,USD,Starbucks
TXN0000005673,2024-01-11T13:28:44,ACC00004824,Credit,1521.59,-1080674.65,USD,Grocery
TXN0000005674,2024-05-15T16:06:39,ACC00005223,Credit,139.83,-1080534.82,USD,Target
TXN0000005675,2024-01-17T14:06:44,ACC00002038,Transfer,842.15,-1079692.67,GBP,Online Store
TXN0000005676,2024-10-01T08:15:33,ACC00001757,Debit,1034.75,-1080727.42,GBP,Restaurant
TXN0000005677,2024-12-19T18:45:41,ACC00000885,Payment,113.43,-1080840.85,USD,Restaurant
TXN0000005678,2024-03-23T23:19:26,ACC00009916,ATM,1876.36,-1082717.21,JPY,Walmart
TXN0000005679,2024-07-20T18:54:47,ACC00001586,ATM,361.87,-1083079.08,GBP,Shell
TXN0000005680,2024-08-15T20:38:05,ACC00006521,Transfer,1558.72,-1081520.36,JPY,Amazon
TXN0000005681,2024-01-10T12:36:25,ACC00009094,Payment,745.62,-1082265.98,USD,Starbucks
TXN0000005682,2024-11-11T21:16:36,ACC00007715,Credit,807.44,-1081458.54,EUR,Starbucks
TXN0000005683,2024-12-06T12:06:57,ACC00006343,Debit,572.95,-1082031.49,JPY,Walmart
TXN0000005684,2024-06-04T18:05:54,ACC00007672,ATM,1612.59,-1083644.08,USD,Walmart
TXN0000005685,2024-07-02T02:59:41,ACC00008861,Credit,1248.3,-1082395.78,EUR,Grocery
TXN0000005686,2024-01-31T11:31:37,ACC00000073,Transfer,674.76,-1081721.02,USD,Restaurant
TXN0000005687,2024-06-21T06:47:13,ACC00007259,ATM,1482.27,-1083203.29,JPY,Online Store
TXN0000005688,2024-02-13T18:41:07,ACC00001660,Transfer,1510.48,-1081692.81,GBP,Shell
TXN0000005689,2024-10-30T22:30:40,ACC00006234,Debit,228.9,-1081921.71,EUR,Online Store
TXN0000005690,2024-01-02T10:39:38,ACC00008340,Credit,1011.79,-1080909.92,JPY,Restaurant
TXN0000005691,2024-03-18T03:30:38,ACC00008426,ATM,829.63,-1081739.55,JPY,Restaurant
TXN0000005692,2024-02-18T16:55:22,ACC00008179,Credit,371.75,-1081367.8,EUR,Walmart
TXN0000005693,2024-09-12T15:29:30,ACC00007222,Transfer,729.84,-1080637.96,JPY,Target
TXN0000005694,2024-03-28T18:02:03,ACC00007839,ATM,1255.22,-1081893.18,GBP,Restaurant
TXN0000005695,2024-02-01T19:02:33,ACC00006978,ATM,1560.35,-1083453.53,GBP,Target
TXN0000005696,2024-07-20T20:13:21,ACC00004191,ATM,799.82,-1084253.35,JPY,Target
TXN0000005697,2024-07-28T17:04:46,ACC00002926,Payment,1123.35,-1085376.7,EUR,Restaurant
TXN0000005698,2024-04-24T21:58:33,ACC00001271,ATM,1297.02,-1086673.72,USD,Restaurant
TXN0000005699,2024-12-10T07:07:39,ACC00008311,Credit,936.88,-1085736.84,EUR,Shell
TXN0000005700,2024-08-30T03:57:05,ACC00005951,Debit,86.08,-1085822.92,JPY,Target
TXN0000005701,2024-06-13T22:53:24,ACC00002190,Debit,1100.65,-1086923.57,GBP,Target
TXN0000005702,2024-09-05T09:08:19,ACC00008484,Credit,1211.83,-1085711.74,USD,Walmart
TXN0000005703,2024-03-21T22:55:38,ACC00009526,ATM,1028.91,-1086740.65,GBP,Online Store
TXN0000005704,2024-02-10T00:32:52,ACC00008646,Transfer,926.15,-1085814.5,GBP,Walmart
TXN0000005705,2024-04-09T08:51:24,ACC00008160,ATM,276.01,-1086090.51,GBP,Walmart
TXN0000005706,2024-03-17T05:05:12,ACC00009507,Payment,1372.34,-1087462.85,USD,Walmart
TXN0000005707,2024-12-06T09:09:04,ACC00006585,Payment,1403.45,-1088866.3,JPY,Restaurant
TXN0000005708,2024-02-19T01:53:55,ACC00009318,Debit,654.23,-1089520.53,JPY,Walmart
TXN0000005709,2024-09-24T07:26:49,ACC00005161,Debit,1678.01,-1091198.54,JPY,Restaurant
TXN0000005710,2024-09-11T04:12:47,ACC00004144,ATM,1553.29,-1092751.83,USD,Starbucks
TXN0000005711,2024-01-04T03:28:57,ACC00009126,Debit,868.41,-1093620.24,GBP,Online Store
TXN0000005712,2024-04-03T13:56:21,ACC00007381,ATM,1777.07,-1095397.31,JPY,Target
TXN0000005713,2024-10-23T10:23:09,ACC00007500,Transfer,1507.16,-1093890.15,JPY,Amazon
TXN0000005714,2024-04-15T17:34:18,ACC00000191,Payment,1233.5,-1095123.65,GBP,Shell
TXN0000005715,2024-11-02T21:01:46,ACC00002818,Transfer,338.3,-1094785.35,USD,Starbucks
TXN0000005716,2024-06-26T23:21:00,ACC00007247,Debit,116.94,-1094902.29,EUR,Target
TXN0000005717,2024-12-17T09:16:05,ACC00005215,Debit,1835.84,-1096738.13,EUR,Amazon
TXN0000005718,2024-08-13T18:02:12,ACC00007760,Transfer,1661.14,-1095076.99,USD,Restaurant
TXN0000005719,2024-05-29T14:36:39,ACC00006192,ATM,365.94,-1095442.93,GBP,Restaurant
TXN0000005720,2024-04-09T02:44:42,ACC00001660,ATM,1502.3,-1096945.23,JPY,Amazon
TXN0000005721,2024-03-06T17:11:58,ACC00003122,Debit,1220.55,-1098165.78,GBP,Shell
TXN0000005722,2024-08-30T17:17:11,ACC00002617,Transfer,1973.27,-1096192.51,GBP,Starbucks
TXN0000005723,2024-10-18T23:43:21,ACC00005891,Debit,1851.04,-1098043.55,GBP,Walmart
TXN0000005724,2024-09-06T17:28:40,ACC00004456,ATM,62.8,-1098106.35,JPY,Restaurant
TXN0000005725,2024-03-15T08:58:15,ACC00004886,Credit,1162.13,-1096944.22,GBP,Walmart
TXN0000005726,2024-02-06T01:50:09,ACC00009186,Credit,859.23,-1096084.99,GBP,Target
TXN0000005727,2024-10-16T04:00:26,ACC00009871,Debit,1171.01,-1097256.0,USD,Restaurant
TXN0000005728,2024-03-19T23:03:03,ACC00007078,Credit,755.09,-1096500.91,JPY,Walmart
TXN0000005729,2024-05-29T14:36:14,ACC00007674,Payment,230.14,-1096731.05,JPY,Amazon
TXN0000005730,2024-01-20T02:34:41,ACC00009240,Transfer,777.11,-1095953.94,USD,Target
TXN0000005731,2024-07-16T16:24:41,ACC00006675,Payment,942.82,-1096896.76,USD,Restaurant
TXN0000005732,2024-03-17T16:52:28,ACC00001356,ATM,260.99,-1097157.75,USD,Starbucks
TXN0000005733,2024-04-05T07:40:28,ACC00009223,Debit,1434.76,-1098592.51,USD,Online Store
TXN0000005734,2024-01-08T04:43:36,ACC00003715,Transfer,815.28,-1097777.23,GBP,Walmart
TXN0000005735,2024-01-31T05:28:37,ACC00000676,Debit,1814.25,-1099591.48,GBP,Grocery
TXN0000005736,2024-01-17T14:14:37,ACC00006111,Debit,1956.62,-1101548.1,EUR,Shell
TXN0000005737,2024-03-09T02:30:24,ACC00008007,Debit,362.86,-1101910.96,EUR,Shell
TXN0000005738,2024-12-22T02:42:28,ACC00009941,Credit,462.74,-1101448.22,GBP,Shell
TXN0000005739,2024-10-02T14:02:38,ACC00005140,ATM,1340.7,-1102788.92,JPY,Online Store
TXN0000005740,2024-01-03T16:13:41,ACC00007324,Payment,120.67,-1102909.59,GBP,Online Store
TXN0000005741,2024-05-01T19:55:31,ACC00001914,Transfer,908.84,-1102000.75,USD,Grocery
TXN0000005742,2024-12-18T08:28:05,ACC00005790,Credit,1652.16,-1100348.59,JPY,Amazon
TXN0000005743,2024-03-17T14:43:09,ACC00004192,ATM,718.08,-1101066.67,JPY,Walmart
TXN0000005744,2024-05-10T02:03:55,ACC00003086,Credit,452.01,-1100614.66,EUR,Restaurant
TXN0000005745,2024-08-23T03:06:36,ACC00003201,Credit,563.11,-1100051.55,GBP,Starbucks
TXN0000005746,2024-02-10T06:09:32,ACC00001562,Debit,1232.35,-1101283.9,JPY,Target
TXN0000005747,2024-05-07T09:54:13,ACC00005536,Transfer,1118.57,-1100165.33,GBP,Target
TXN0000005748,2024-02-27T02:24:29,ACC00004245,ATM,1832.37,-1101997.7,USD,Walmart
TXN0000005749,2024-04-22T23:32:00,ACC00009287,ATM,307.01,-1102304.71,EUR,Grocery
TXN0000005750,2024-06-27T11:59:22,ACC00000222,Credit,1947.7,-1100357.01,USD,Grocery
TXN0000005751,2024-12-29T01:59:50,ACC00001479,Payment,961.19,-1101318.2,USD,Grocery
TXN0000005752,2024-08-30T06:19:16,ACC00004775,ATM,783.18,-1102101.38,USD,Restaurant
TXN0000005753,2024-01-27T15:56:32,ACC00001647,Debit,541.18,-1102642.56,USD,Restaurant
TXN0000005754,2024-01-27T21:08:24,ACC00009044,Payment,608.88,-1103251.44,EUR,Target
TXN0000005755,2024-10-01T19:44:29,ACC00009489,Credit,683.96,-1102567.48,EUR,Restaurant
TXN0000005756,2024-02-13T04:16:34,ACC00001289,Credit,652.25,-1101915.23,EUR,Shell
TXN0000005757,2024-12-08T19:54:21,ACC00007427,Credit,1768.73,-1100146.5,EUR,Target
TXN0000005758,2024-06-21T03:07:26,ACC00002432,Transfer,707.67,-1099438.83,EUR,Walmart
TXN0000005759,2024-06-24T19:21:54,ACC00003074,ATM,1477.85,-1100916.68,JPY,Walmart
TXN0000005760,2024-05-06T13:38:22,ACC00001486,ATM,1663.67,-1102580.35,JPY,Walmart
TXN0000005761,2024-11-10T19:41:07,ACC00001370,Payment,141.36,-1102721.71,JPY,Online Store
TXN0000005762,2024-04-29T07:16:33,ACC00000161,Credit,375.63,-1102346.08,JPY,Shell
TXN0000005763,2024-12-13T05:36:45,ACC00007975,Debit,177.86,-1102523.94,EUR,Online Store
TXN0000005764,2024-09-07T17:05:22,ACC00006803,Debit,1143.03,-1103666.97,EUR,Online Store
TXN0000005765,2024-10-05T21:04:54,ACC00009679,Payment,854.82,-1104521.79,JPY,Amazon
TXN0000005766,2024-10-08T08:42:06,ACC00003623,Payment,317.02,-1104838.81,USD,Grocery
TXN0000005767,2024-01-10T19:57:12,ACC00008241,Debit,359.28,-1105198.09,EUR,Amazon
TXN0000005768,2024-05-29T09:31:06,ACC00006100,Payment,1058.8,-1106256.89,JPY,Amazon
TXN0000005769,2024-09-23T18:36:48,ACC00008540,Payment,1844.29,-1108101.18,USD,Amazon
TXN0000005770,2024-06-17T11:27:26,ACC00006428,Credit,313.32,-1107787.86,USD,Restaurant
TXN0000005771,2024-06-16T03:47:56,ACC00005863,ATM,1825.35,-1109613.21,GBP,Amazon
TXN0000005772,2024-01-30T04:11:49,ACC00004490,Credit,1471.01,-1108142.2,EUR,Walmart
TXN0000005773,2024-12-10T01:55:01,ACC00004988,Credit,913.58,-1107228.62,EUR,Amazon
TXN0000005774,2024-06-16T11:55:21,ACC00003980,ATM,687.92,-1107916.54,EUR,Starbucks
TXN0000005775,2024-08-26T04:52:03,ACC00004151,ATM,26.9,-1107943.44,USD,Shell
TXN0000005776,2024-04-22T00:57:45,ACC00004563,ATM,181.78,-1108125.22,USD,Walmart
TXN0000005777,2024-12-02T15:23:26,ACC00004318,Credit,672.41,-1107452.81,EUR,Online Store
TXN0000005778,2024-09-10T22:36:52,ACC00001050,Credit,592.95,-1106859.86,JPY,Starbucks
TXN0000005779,2024-03-24T18:02:28,ACC00004096,ATM,221.88,-1107081.74,GBP,Shell
TXN0000005780,2024-03-13T00:28:35,ACC00005218,Credit,1670.21,-1105411.53,JPY,Restaurant
TXN0000005781,2024-02-03T22:00:07,ACC00006543,Transfer,1114.35,-1104297.18,JPY,Restaurant
TXN0000005782,2024-10-22T11:13:58,ACC00009487,Debit,1709.85,-1106007.03,JPY,Shell
TXN0000005783,2024-05-02T22:01:46,ACC00001766,Payment,723.33,-1106730.36,EUR,Amazon
TXN0000005784,2024-08-15T22:00:47,ACC00000850,ATM,1338.71,-1108069.07,GBP,Amazon
TXN0000005785,2024-09-20T11:36:27,ACC00006399,Transfer,1916.03,-1106153.04,JPY,Target
TXN0000005786,2024-05-11T01:28:12,ACC00007676,ATM,603.62,-1106756.66,JPY,Grocery
TXN0000005787,2024-02-18T03:38:15,ACC00007881,ATM,934.93,-1107691.59,USD,Walmart
TXN0000005788,2024-07-06T20:21:07,ACC00007599,Credit,1351.71,-1106339.88,USD,Grocery
TXN0000005789,2024-06-20T04:06:23,ACC00001342,Transfer,54.32,-1106285.56,GBP,Online Store
TXN0000005790,2024-06-20T04:31:25,ACC00001850,ATM,784.41,-1107069.97,JPY,Online Store
TXN0000005791,2024-04-20T07:47:04,ACC00008857,Debit,1393.18,-1108463.15,GBP,Grocery
TXN0000005792,2024-08-29T19:00:47,ACC00005313,Credit,1329.07,-1107134.08,GBP,Grocery
TXN0000005793,2024-06-20T17:49:33,ACC00004774,Debit,1133.95,-1108268.03,USD,Online Store
TXN0000005794,2024-08-31T08:15:07,ACC00003101,Payment,1910.2,-1110178.23,JPY,Shell
TXN0000005795,2024-03-02T13:15:45,ACC00006420,Credit,856.48,-1109321.75,JPY,Restaurant
TXN0000005796,2024-01-16T20:24:58,ACC00007443,Credit,570.81,-1108750.94,EUR,Walmart
TXN0000005797,2024-01-28T12:03:07,ACC00001510,Transfer,1310.52,-1107440.42,EUR,Shell
TXN0000005798,2024-03-09T05:35:48,ACC00002452,ATM,1689.46,-1109129.88,JPY,Target
TXN0000005799,2024-02-17T05:52:09,ACC00008029,Transfer,1926.19,-1107203.69,GBP,Walmart
TXN0000005800,2024-01-18T18:31:20,ACC00003661,Payment,1449.71,-1108653.4,EUR,Starbucks
TXN0000005801,2024-12-09T02:24:26,ACC00001095,Transfer,1271.76,-1107381.64,USD,Restaurant
TXN0000005802,2024-07-12T20:10:30,ACC00006001,Transfer,960.06,-1106421.58,GBP,Shell
TXN0000005803,2024-08-02T15:57:51,ACC00006797,Credit,1492.94,-1104928.64,EUR,Online Store
TXN0000005804,2024-04-22T00:09:08,ACC00007548,Transfer,439.17,-1104489.47,JPY,Walmart
TXN0000005805,2024-09-13T06:41:07,ACC00002425,Debit,267.94,-1104757.41,EUR,Restaurant
TXN0000005806,2024-04-03T04:06:47,ACC00008493,Debit,1828.01,-1106585.42,JPY,Restaurant
TXN0000005807,2024-04-16T23:41:37,ACC00006429,Debit,629.86,-1107215.28,GBP,Restaurant
TXN0000005808,2024-06-23T14:00:11,ACC00000384,Credit,1243.51,-1105971.77,USD,Amazon
TXN0000005809,2024-06-27T20:44:56,ACC00005254,Credit,1669.52,-1104302.25,JPY,Amazon
TXN0000005810,2024-06-10T13:09:19,ACC00006842,ATM,1727.06,-1106029.31,USD,Grocery
TXN0000005811,2024-07-29T16:43:56,ACC00004964,Payment,1573.43,-1107602.74,GBP,Target
TXN0000005812,2024-03-15T12:29:33,ACC00009644,Debit,1918.2,-1109520.94,EUR,Online Store
TXN0000005813,2024-05-12T03:11:12,ACC00007310,Debit,1557.2,-1111078.14,EUR,Restaurant
TXN0000005814,2024-07-19T11:53:21,ACC00001560,ATM,406.63,-1111484.77,USD,Grocery
TXN0000005815,2024-01-04T10:34:24,ACC00004421,Credit,734.19,-1110750.58,EUR,Restaurant
TXN0000005816,2024-10-29T03:46:37,ACC00002489,Transfer,1710.54,-1109040.04,USD,Grocery
TXN0000005817,2024-04-15T17:42:26,ACC00002735,Debit,454.26,-1109494.3,USD,Restaurant
TXN0000005818,2024-03-18T04:48:51,ACC00001889,Credit,495.85,-1108998.45,JPY,Starbucks
TXN0000005819,2024-03-15T15:48:54,ACC00009111,Transfer,1404.41,-1107594.04,JPY,Target
TXN0000005820,2024-01-07T07:25:03,ACC00005977,Credit,1747.08,-1105846.96,JPY,Starbucks
TXN0000005821,2024-12-16T04:46:54,ACC00007134,Credit,1168.43,-1104678.53,GBP,Walmart
TXN0000005822,2024-05-25T11:56:36,ACC00006917,Payment,525.94,-1105204.47,GBP,Target
TXN0000005823,2024-01-06T03:13:49,ACC00001762,ATM,349.97,-1105554.44,JPY,Starbucks
TXN0000005824,2024-01-19T18:51:47,ACC00004606,Credit,318.83,-1105235.61,USD,Grocery
TXN0000005825,2024-02-18T15:38:46,ACC00000207,Credit,1105.69,-1104129.92,GBP,Starbucks
TXN0000005826,2024-01-06T21:54:20,ACC00009934,Debit,1250.26,-1105380.18,EUR,Shell
TXN0000005827,2024-06-27T17:16:09,ACC00005207,ATM,12.31,-1105392.49,JPY,Shell
TXN0000005828,2024-12-15T11:32:47,ACC00008521,ATM,1969.73,-1107362.22,JPY,Online Store
TXN0000005829,2024-03-03T06:28:02,ACC00004449,Debit,81.61,-1107443.83,GBP,Online Store
TXN0000005830,2024-12-05T18:12:49,ACC00007001,Credit,1092.82,-1106351.01,EUR,Starbucks
TXN0000005831,2024-06-05T19:27:03,ACC00009822,Debit,1049.04,-1107400.05,USD,Shell
TXN0000005832,2024-11-26T02:16:48,ACC00008413,Debit,677.03,-1108077.08,GBP,Starbucks
TXN0000005833,2024-07-05T01:27:31,ACC00004759,Transfer,1761.37,-1106315.71,EUR,Starbucks
TXN0000005834,2024-06-05T01:42:25,ACC00008222,Credit,678.77,-1105636.94,EUR,Shell
TXN0000005835,2024-04-24T14:52:17,ACC00009746,ATM,1534.52,-1107171.46,GBP,Restaurant
TXN0000005836,2024-04-28T05:05:59,ACC00000628,ATM,637.14,-1107808.6,GBP,Online Store
TXN0000005837,2024-01-05T22:41:52,ACC00005114,Payment,856.82,-1108665.42,USD,Restaurant
TXN0000005838,2024-06-22T22:13:08,ACC00003684,Debit,1563.45,-1110228.87,JPY,Walmart
TXN0000005839,2024-12-14T10:29:12,ACC00007887,Transfer,244.56,-1109984.31,GBP,Starbucks
TXN0000005840,2024-12-27T11:59:07,ACC00008863,Payment,405.95,-1110390.26,GBP,Grocery
TXN0000005841,2024-09-02T08:22:51,ACC00002566,Transfer,1451.74,-1108938.52,GBP,Restaurant
TXN0000005842,2024-09-16T15:55:33,ACC00001506,Payment,1639.15,-1110577.67,EUR,Starbucks
TXN0000005843,2024-04-25T00:34:13,ACC00005876,Transfer,1272.77,-1109304.9,GBP,Shell
TXN0000005844,2024-12-09T23:01:50,ACC00001277,Transfer,549.43,-1108755.47,GBP,Restaurant
TXN0000005845,2024-10-08T08:38:27,ACC00007321,ATM,881.2,-1109636.67,GBP,Shell
TXN0000005846,2024-05-11T00:12:21,ACC00006147,Payment,105.87,-1109742.54,USD,Shell
TXN0000005847,2024-02-26T20:58:06,ACC00008178,Credit,492.0,-1109250.54,GBP,Amazon
TXN0000005848,2024-03-09T06:53:39,ACC00004232,Transfer,871.97,-1108378.57,GBP,Starbucks
TXN0000005849,2024-11-02T09:36:10,ACC00004949,Transfer,1507.66,-1106870.91,GBP,Shell
TXN0000005850,2024-06-07T22:03:46,ACC00003559,Payment,284.8,-1107155.71,JPY,Online Store
TXN0000005851,2024-03-22T13:44:00,ACC00008939,Transfer,1938.51,-1105217.2,GBP,Restaurant
TXN0000005852,2024-09-01T09:10:29,ACC00009941,Payment,1622.76,-1106839.96,GBP,Starbucks
TXN0000005853,2024-02-21T11:55:05,ACC00007321,Credit,1524.06,-1105315.9,GBP,Amazon
TXN0000005854,2024-10-10T19:16:56,ACC00000943,ATM,1401.19,-1106717.09,JPY,Shell
TXN0000005855,2024-02-23T23:38:28,ACC00008037,Transfer,370.61,-1106346.48,JPY,Target
TXN0000005856,2024-08-08T16:14:32,ACC00009290,Debit,893.53,-1107240.01,EUR,Grocery
TXN0000005857,2024-07-04T00:10:39,ACC00002242,ATM,1908.39,-1109148.4,JPY,Starbucks
TXN0000005858,2024-06-07T15:42:29,ACC00009542,Transfer,1016.54,-1108131.86,EUR,Shell
TXN0000005859,2024-09-10T22:34:10,ACC00005661,Credit,995.25,-1107136.61,EUR,Walmart
TXN0000005860,2024-05-16T04:05:22,ACC00009379,Credit,644.09,-1106492.52,JPY,Walmart
TXN0000005861,2024-05-07T23:43:04,ACC00005291,ATM,915.48,-1107408.0,USD,Grocery
TXN0000005862,2024-01-26T21:31:11,ACC00006962,Payment,495.99,-1107903.99,JPY,Target
TXN0000005863,2024-08-17T22:47:29,ACC00008639,Payment,294.18,-1108198.17,EUR,Starbucks
TXN0000005864,2024-05-11T03:18:22,ACC00004498,Debit,1292.78,-1109490.95,USD,Amazon
TXN0000005865,2024-10-11T22:15:58,ACC00000402,ATM,634.19,-1110125.14,GBP,Restaurant
TXN0000005866,2024-04-20T18:21:03,ACC00005244,Payment,1711.69,-1111836.83,GBP,Restaurant
TXN0000005867,2024-05-24T08:30:34,ACC00008390,Transfer,266.63,-1111570.2,USD,Amazon
TXN0000005868,2024-02-12T12:53:05,ACC00005271,Credit,1556.54,-1110013.66,GBP,Walmart
TXN0000005869,2024-10-09T10:23:46,ACC00007679,ATM,610.83,-1110624.49,USD,Grocery
TXN0000005870,2024-08-19T11:34:05,ACC00000738,Transfer,1750.46,-1108874.03,GBP,Starbucks
TXN0000005871,2024-10-16T03:40:11,ACC00006619,Payment,42.61,-1108916.64,EUR,Starbucks
TXN0000005872,2024-09-09T04:15:29,ACC00003351,ATM,44.91,-1108961.55,USD,Walmart
TXN0000005873,2024-05-23T03:02:02,ACC00007062,Payment,1739.98,-1110701.53,JPY,Grocery
TXN0000005874,2024-04-12T04:23:31,ACC00004307,Credit,391.16,-1110310.37,JPY,Target
TXN0000005875,2024-10-04T17:32:54,ACC00000786,Debit,1950.21,-1112260.58,USD,Walmart
TXN0000005876,2024-01-08T11:49:16,ACC00003128,Transfer,1138.18,-1111122.4,GBP,Walmart
TXN0000005877,2024-10-25T09:22:10,ACC00008894,Debit,380.6,-1111503.0,USD,Shell
TXN0000005878,2024-09-30T15:19:40,ACC00003348,Credit,277.24,-1111225.76,USD,Amazon
TXN0000005879,2024-05-21T21:48:26,ACC00009156,Transfer,1517.67,-1109708.09,GBP,Starbucks
TXN0000005880,2024-01-25T10:31:55,ACC00005538,Debit,1671.0,-1111379.09,USD,Target
TXN0000005881,2024-08-24T13:45:24,ACC00001456,Credit,1506.51,-1109872.58,JPY,Restaurant
TXN0000005882,2024-01-07T22:50:13,ACC00000033,Payment,1118.4,-1110990.98,JPY,Shell
TXN0000005883,2024-11-18T16:32:49,ACC00002237,ATM,909.72,-1111900.7,EUR,Shell
TXN0000005884,2024-04-06T01:44:42,ACC00001746,Payment,1467.17,-1113367.87,EUR,Starbucks
TXN0000005885,2024-05-19T12:28:49,ACC00008214,Credit,216.28,-1113151.59,USD,Target
TXN0000005886,2024-09-19T23:46:14,ACC00004058,Payment,574.26,-1113725.85,USD,Shell
TXN0000005887,2024-01-08T07:26:02,ACC00001939,Credit,985.56,-1112740.29,JPY,Amazon
TXN0000005888,2024-06-11T17:47:43,ACC00004869,Debit,176.36,-1112916.65,JPY,Walmart
TXN0000005889,2024-12-06T22:09:51,ACC00006212,Payment,1672.79,-1114589.44,JPY,Starbucks
TXN0000005890,2024-10-09T09:15:26,ACC00002366,Credit,1952.16,-1112637.28,USD,Restaurant
TXN0000005891,2024-03-06T16:22:46,ACC00004009,Payment,801.74,-1113439.02,JPY,Grocery
TXN0000005892,2024-03-31T23:15:04,ACC00004331,Transfer,1149.93,-1112289.09,USD,Grocery
TXN0000005893,2024-11-10T07:35:31,ACC00005377,Payment,557.38,-1112846.47,USD,Grocery
TXN0000005894,2024-10-25T10:19:34,ACC00007318,Payment,1809.2,-1114655.67,USD,Amazon
TXN0000005895,2024-04-22T15:26:59,ACC00001624,Transfer,1877.52,-1112778.15,USD,Grocery
TXN0000005896,2024-02-12T08:34:19,ACC00009008,Debit,1889.42,-1114667.57,GBP,Restaurant
TXN0000005897,2024-07-06T13:13:02,ACC00007112,Payment,1947.32,-1116614.89,GBP,Online Store
TXN0000005898,2024-08-04T07:39:13,ACC00005145,Credit,1239.13,-1115375.76,GBP,Starbucks
TXN0000005899,2024-04-21T18:08:18,ACC00006590,Debit,810.97,-1116186.73,EUR,Online Store
TXN0000005900,2024-09-25T12:49:29,ACC00006332,Payment,366.14,-1116552.87,GBP,Grocery
TXN0000005901,2024-09-25T17:00:55,ACC00003967,ATM,242.02,-1116794.89,JPY,Shell
TXN0000005902,2024-10-15T14:25:34,ACC00005737,ATM,969.32,-1117764.21,GBP,Online Store
TXN0000005903,2024-07-01T21:23:04,ACC00006925,ATM,1543.61,-1119307.82,GBP,Starbucks
TXN0000005904,2024-03-21T11:33:49,ACC00007892,ATM,1754.32,-1121062.14,USD,Restaurant
TXN0000005905,2024-10-08T03:36:00,ACC00005594,Transfer,1923.55,-1119138.59,GBP,Restaurant
TXN0000005906,2024-01-16T02:27:52,ACC00004964,ATM,1956.55,-1121095.14,USD,Starbucks
TXN0000005907,2024-04-29T02:14:02,ACC00006798,Payment,1000.08,-1122095.22,EUR,Shell
TXN0000005908,2024-12-24T17:36:08,ACC00003450,Payment,1416.9,-1123512.12,JPY,Amazon
TXN0000005909,2024-03-16T10:01:43,ACC00005578,ATM,754.08,-1124266.2,GBP,Online Store
TXN0000005910,2024-12-04T13:39:42,ACC00000535,Payment,1153.16,-1125419.36,USD,Restaurant
TXN0000005911,2024-03-10T19:44:35,ACC00006536,Transfer,1122.81,-1124296.55,EUR,Target
TXN0000005912,2024-11-19T13:17:26,ACC00002397,ATM,598.79,-1124895.34,JPY,Starbucks
TXN0000005913,2024-02-16T13:48:34,ACC00006843,Debit,1891.95,-1126787.29,JPY,Starbucks
TXN0000005914,2024-07-15T04:27:17,ACC00005174,Transfer,1740.66,-1125046.63,USD,Shell
TXN0000005915,2024-06-14T07:03:40,ACC00008902,Transfer,286.12,-1124760.51,EUR,Walmart
TXN0000005916,2024-05-24T02:43:24,ACC00006408,Credit,1198.0,-1123562.51,GBP,Online Store
TXN0000005917,2024-05-27T19:43:37,ACC00007377,Debit,1730.44,-1125292.95,USD,Restaurant
TXN0000005918,2024-08-12T04:04:18,ACC00007355,Debit,410.34,-1125703.29,GBP,Grocery
TXN0000005919,2024-03-01T02:13:06,ACC00002403,Transfer,1244.14,-1124459.15,EUR,Restaurant
TXN0000005920,2024-12-05T13:09:18,ACC00004113,Payment,1925.09,-1126384.24,GBP,Shell
TXN0000005921,2024-10-03T19:03:34,ACC00000494,Credit,155.86,-1126228.38,GBP,Restaurant
TXN0000005922,2024-01-16T05:42:22,ACC00009194,ATM,277.46,-1126505.84,JPY,Target
TXN0000005923,2024-01-18T02:20:24,ACC00005567,Credit,1752.44,-1124753.4,JPY,Walmart
TXN0000005924,2024-04-07T03:10:25,ACC00003437,Transfer,1583.32,-1123170.08,JPY,Online Store
TXN0000005925,2024-10-17T19:40:50,ACC00004493,Debit,1435.57,-1124605.65,GBP,Amazon
TXN0000005926,2024-03-22T21:29:24,ACC00002309,Debit,1757.4,-1126363.05,USD,Online Store
TXN0000005927,2024-06-12T02:45:47,ACC00005923,ATM,724.25,-1127087.3,GBP,Amazon
TXN0000005928,2024-09-02T00:17:09,ACC00008944,Transfer,854.94,-1126232.36,USD,Restaurant
TXN0000005929,2024-04-12T01:33:44,ACC00006793,Payment,1592.71,-1127825.07,USD,Grocery
TXN0000005930,2024-12-16T14:03:51,ACC00008529,Credit,229.28,-1127595.79,USD,Walmart
TXN0000005931,2024-02-01T13:16:34,ACC00004963,Transfer,628.94,-1126966.85,JPY,Restaurant
TXN0000005932,2024-07-14T03:41:10,ACC00007203,Debit,243.43,-1127210.28,JPY,Amazon
TXN0000005933,2024-11-14T06:51:08,ACC00004387,Credit,1853.94,-1125356.34,USD,Walmart
TXN0000005934,2024-06-29T22:48:21,ACC00005193,ATM,652.32,-1126008.66,EUR,Starbucks
TXN0000005935,2024-10-05T14:23:10,ACC00009734,Credit,1109.55,-1124899.11,GBP,Amazon
TXN0000005936,2024-10-11T16:59:56,ACC00008681,Credit,595.34,-1124303.77,GBP,Target
TXN0000005937,2024-01-14T17:44:24,ACC00006958,Transfer,1121.35,-1123182.42,JPY,Walmart
TXN0000005938,2024-07-25T18:23:38,ACC00007492,ATM,28.8,-1123211.22,EUR,Shell
TXN0000005939,2024-01-11T10:58:32,ACC00001997,Payment,1288.94,-1124500.16,USD,Shell
TXN0000005940,2024-04-05T12:58:28,ACC00007402,Credit,327.36,-1124172.8,EUR,Target
TXN0000005941,2024-01-08T01:35:45,ACC00003554,Payment,961.27,-1125134.07,GBP,Online Store
TXN0000005942,2024-07-31T17:55:27,ACC00009003,ATM,1851.44,-1126985.51,USD,Grocery
TXN0000005943,2024-09-13T16:22:46,ACC00007988,ATM,1354.86,-1128340.37,GBP,Amazon
TXN0000005944,2024-03-27T04:49:06,ACC00009108,Debit,500.08,-1128840.45,JPY,Shell
TXN0000005945,2024-02-28T23:24:47,ACC00009724,Debit,351.59,-1129192.04,USD,Grocery
TXN0000005946,2024-11-28T23:02:23,ACC00007601,Credit,16.0,-1129176.04,GBP,Starbucks
TXN0000005947,2024-06-28T21:50:00,ACC00001678,Transfer,411.99,-1128764.05,GBP,Online Store
TXN0000005948,2024-10-28T18:32:58,ACC00001136,Transfer,1518.56,-1127245.49,EUR,Walmart
TXN0000005949,2024-08-25T23:11:12,ACC00009744,Debit,1173.97,-1128419.46,JPY,Restaurant
TXN0000005950,2024-02-12T23:27:35,ACC00000720,Transfer,1736.65,-1126682.81,JPY,Walmart
TXN0000005951,2024-06-01T20:51:21,ACC00005207,ATM,1468.35,-1128151.16,USD,Starbucks
TXN0000005952,2024-06-12T15:04:55,ACC00005571,ATM,45.01,-1128196.17,GBP,Online Store
TXN0000005953,2024-02-09T19:01:14,ACC00008787,ATM,1743.26,-1129939.43,EUR,Starbucks
TXN0000005954,2024-04-30T14:49:19,ACC00008659,Debit,1919.78,-1131859.21,GBP,Shell
TXN0000005955,2024-08-28T13:07:04,ACC00003246,Credit,1379.8,-1130479.41,GBP,Walmart
TXN0000005956,2024-11-09T14:29:07,ACC00005131,Debit,1262.33,-1131741.74,USD,Target
TXN0000005957,2024-03-13T06:44:23,ACC00005984,Transfer,1317.8,-1130423.94,GBP,Walmart
TXN0000005958,2024-05-20T02:08:00,ACC00000563,ATM,1719.29,-1132143.23,GBP,Amazon
TXN0000005959,2024-11-08T08:13:56,ACC00004648,ATM,56.49,-1132199.72,USD,Grocery
TXN0000005960,2024-12-01T23:55:43,ACC00003842,ATM,1646.35,-1133846.07,EUR,Starbucks
TXN0000005961,2024-09-22T10:15:17,ACC00000039,ATM,720.82,-1134566.89,EUR,Online Store
TXN0000005962,2024-10-14T08:25:19,ACC00000015,ATM,1959.35,-1136526.24,GBP,Online Store
TXN0000005963,2024-01-21T00:29:14,ACC00007857,ATM,894.14,-1137420.38,EUR,Walmart
TXN0000005964,2024-07-14T02:28:53,ACC00008934,Payment,28.58,-1137448.96,EUR,Grocery
TXN0000005965,2024-02-25T02:53:54,ACC00004340,ATM,549.16,-1137998.12,GBP,Grocery
TXN0000005966,2024-05-06T09:12:36,ACC00002183,ATM,179.15,-1138177.27,JPY,Walmart
TXN0000005967,2024-12-03T16:56:38,ACC00005396,Payment,1392.01,-1139569.28,EUR,Walmart
TXN0000005968,2024-06-20T07:27:50,ACC00005737,Payment,59.0,-1139628.28,JPY,Target
TXN0000005969,2024-08-25T21:36:36,ACC00002021,ATM,1761.22,-1141389.5,USD,Starbucks
TXN0000005970,2024-10-26T09:34:43,ACC00001515,Debit,753.66,-1142143.16,GBP,Restaurant
TXN0000005971,2024-09-19T06:25:07,ACC00005679,Payment,1846.33,-1143989.49,USD,Walmart
TXN0000005972,2024-07-06T07:15:32,ACC00009460,ATM,1585.07,-1145574.56,JPY,Amazon
TXN0000005973,2024-10-31T19:21:05,ACC00006904,Payment,632.8,-1146207.36,USD,Walmart
TXN0000005974,2024-07-17T21:56:03,ACC00004668,Debit,923.65,-1147131.01,GBP,Online Store
TXN0000005975,2024-07-18T23:45:58,ACC00008042,Debit,632.13,-1147763.14,USD,Online Store
TXN0000005976,2024-11-29T02:56:29,ACC00003556,Credit,1592.81,-1146170.33,GBP,Restaurant
TXN0000005977,2024-03-02T21:12:29,ACC00002956,Credit,566.35,-1145603.98,EUR,Restaurant
TXN0000005978,2024-10-20T16:55:23,ACC00007811,Transfer,703.92,-1144900.06,USD,Restaurant
TXN0000005979,2024-06-26T15:23:05,ACC00003788,ATM,1472.33,-1146372.39,EUR,Shell
TXN0000005980,2024-05-15T07:22:14,ACC00004667,Debit,1773.47,-1148145.86,USD,Shell
TXN0000005981,2024-04-20T01:50:23,ACC00008650,Debit,1512.87,-1149658.73,EUR,Shell
TXN0000005982,2024-11-10T06:35:06,ACC00007489,Debit,620.21,-1150278.94,JPY,Shell
TXN0000005983,2024-08-13T10:56:13,ACC00000704,Debit,1770.01,-1152048.95,USD,Starbucks
TXN0000005984,2024-01-03T06:59:28,ACC00003710,Credit,1112.04,-1150936.91,GBP,Amazon
TXN0000005985,2024-03-09T14:43:28,ACC00003859,Transfer,1933.44,-1149003.47,USD,Grocery
TXN0000005986,2024-08-15T02:40:16,ACC00008860,Payment,1143.07,-1150146.54,EUR,Shell
TXN0000005987,2024-05-22T13:31:09,ACC00007499,Payment,1315.03,-1151461.57,USD,Shell
TXN0000005988,2024-01-21T00:33:21,ACC00006036,Credit,263.39,-1151198.18,USD,Target
TXN0000005989,2024-03-01T15:36:37,ACC00003168,Debit,462.0,-1151660.18,EUR,Target
TXN0000005990,2024-08-31T20:18:32,ACC00000545,Credit,445.39,-1151214.79,USD,Target
TXN0000005991,2024-05-04T04:03:48,ACC00000863,Transfer,478.61,-1150736.18,JPY,Grocery
TXN0000005992,2024-03-15T17:40:01,ACC00006738,Credit,1323.49,-1149412.69,GBP,Shell
TXN0000005993,2024-10-23T02:58:47,ACC00008190,Transfer,1826.38,-1147586.31,GBP,Grocery
TXN0000005994,2024-01-08T11:18:27,ACC00003820,Transfer,206.42,-1147379.89,GBP,Walmart
TXN0000005995,2024-07-13T11:28:42,ACC00002721,Debit,1689.78,-1149069.67,GBP,Starbucks
TXN0000005996,2024-07-17T06:48:07,ACC00005546,Debit,89.66,-1149159.33,GBP,Walmart
TXN0000005997,2024-02-11T15:57:15,ACC00006393,Credit,1663.1,-1147496.23,JPY,Target
TXN0000005998,2024-04-24T01:07:29,ACC00009572,ATM,955.7,-1148451.93,GBP,Shell
TXN0000005999,2024-10-18T01:13:18,ACC00009807,Payment,406.69,-1148858.62,JPY,Online Store
TXN0000006000,2024-07-13T13:16:25,ACC00001180,ATM,610.93,-1149469.55,JPY,Target
TXN0000006001,2024-05-15T01:19:31,ACC00005883,Payment,486.62,-1149956.17,EUR,Restaurant
TXN0000006002,2024-08-08T10:24:47,ACC00006096,Debit,665.24,-1150621.41,JPY,Starbucks
TXN0000006003,2024-09-25T08:41:46,ACC00003539,Debit,458.91,-1151080.32,JPY,Online Store
TXN0000006004,2024-08-09T04:00:39,ACC00004345,Debit,1407.94,-1152488.26,GBP,Starbucks
TXN0000006005,2024-10-27T18:09:39,ACC00005689,Debit,1842.18,-1154330.44,EUR,Grocery
TXN0000006006,2024-01-24T06:46:06,ACC00001020,Debit,1553.04,-1155883.48,USD,Starbucks
TXN0000006007,2024-04-30T02:31:28,ACC00001704,Payment,1819.98,-1157703.46,GBP,Starbucks
TXN0000006008,2024-11-25T00:23:54,ACC00006718,Debit,1100.0,-1158803.46,USD,Amazon
TXN0000006009,2024-09-28T22:51:34,ACC00003337,Debit,273.93,-1159077.39,JPY,Walmart
TXN0000006010,2024-08-11T12:05:11,ACC00002467,Transfer,1414.88,-1157662.51,GBP,Starbucks
TXN0000006011,2024-12-03T21:54:50,ACC00007236,Payment,1489.96,-1159152.47,USD,Starbucks
TXN0000006012,2024-02-15T16:28:22,ACC00003953,Payment,29.54,-1159182.01,EUR,Amazon
TXN0000006013,2024-03-16T00:52:42,ACC00006774,Debit,627.05,-1159809.06,USD,Starbucks
TXN0000006014,2024-04-19T09:12:19,ACC00009210,Payment,102.6,-1159911.66,JPY,Grocery
TXN0000006015,2024-11-04T18:10:06,ACC00006347,Credit,164.45,-1159747.21,EUR,Grocery
TXN0000006016,2024-10-23T21:53:54,ACC00004135,Transfer,862.15,-1158885.06,GBP,Shell
TXN0000006017,2024-02-06T23:13:21,ACC00004740,Credit,1819.11,-1157065.95,JPY,Starbucks
TXN0000006018,2024-07-30T23:25:22,ACC00009872,Transfer,1712.85,-1155353.1,EUR,Online Store
TXN0000006019,2024-11-05T21:55:25,ACC00000045,Transfer,1565.36,-1153787.74,GBP,Walmart
TXN0000006020,2024-10-31T14:06:51,ACC00005742,Payment,627.47,-1154415.21,JPY,Shell
TXN0000006021,2024-06-18T01:25:11,ACC00003311,Debit,1325.68,-1155740.89,EUR,Walmart
TXN0000006022,2024-01-08T02:29:34,ACC00002821,Transfer,1363.59,-1154377.3,EUR,Grocery
TXN0000006023,2024-12-12T21:09:38,ACC00007362,Credit,529.94,-1153847.36,EUR,Starbucks
TXN0000006024,2024-07-09T09:53:06,ACC00007205,Debit,595.13,-1154442.49,JPY,Amazon
TXN0000006025,2024-06-01T04:20:02,ACC00002164,Transfer,1877.63,-1152564.86,EUR,Target
TXN0000006026,2024-02-16T04:58:23,ACC00004076,Credit,1086.41,-1151478.45,EUR,Starbucks
TXN0000006027,2024-04-23T01:04:48,ACC00002432,ATM,1238.41,-1152716.86,EUR,Grocery
TXN0000006028,2024-01-24T02:41:20,ACC00006061,ATM,1704.74,-1154421.6,USD,Restaurant
TXN0000006029,2024-10-17T07:53:57,ACC00008479,Credit,750.94,-1153670.66,GBP,Grocery
TXN0000006030,2024-03-31T23:19:11,ACC00007609,Payment,248.03,-1153918.69,GBP,Online Store
TXN0000006031,2024-10-23T02:54:21,ACC00008820,Transfer,479.81,-1153438.88,USD,Restaurant
TXN0000006032,2024-05-10T13:04:26,ACC00000548,Debit,701.83,-1154140.71,GBP,Online Store
TXN0000006033,2024-11-11T20:34:42,ACC00001875,ATM,1278.57,-1155419.28,GBP,Target
TXN0000006034,2024-02-12T11:43:39,ACC00003630,ATM,521.59,-1155940.87,EUR,Shell
TXN0000006035,2024-10-02T20:19:27,ACC00002563,ATM,1918.55,-1157859.42,EUR,Restaurant
TXN0000006036,2024-08-19T13:32:09,ACC00009510,ATM,613.55,-1158472.97,JPY,Online Store
TXN0000006037,2024-08-14T01:16:15,ACC00006870,ATM,1542.75,-1160015.72,USD,Walmart
TXN0000006038,2024-06-14T06:14:24,ACC00001446,Credit,1936.82,-1158078.9,GBP,Starbucks
TXN0000006039,2024-02-26T09:41:04,ACC00006603,Debit,1149.98,-1159228.88,EUR,Walmart
TXN0000006040,2024-02-24T17:54:38,ACC00006810,Credit,170.03,-1159058.85,USD,Walmart
TXN0000006041,2024-02-26T09:27:32,ACC00005675,Credit,1796.45,-1157262.4,GBP,Amazon
TXN0000006042,2024-11-10T09:39:41,ACC00002870,Credit,630.05,-1156632.35,JPY,Starbucks
TXN0000006043,2024-09-27T00:18:45,ACC00009767,Payment,1591.55,-1158223.9,USD,Target
TXN0000006044,2024-06-20T21:08:54,ACC00008205,Transfer,1735.53,-1156488.37,USD,Online Store
TXN0000006045,2024-08-13T12:37:57,ACC00008062,Debit,1989.13,-1158477.5,JPY,Online Store
TXN0000006046,2024-12-02T05:21:38,ACC00005819,Credit,1938.55,-1156538.95,USD,Amazon
TXN0000006047,2024-04-17T00:57:59,ACC00000438,Debit,369.29,-1156908.24,GBP,Starbucks
TXN0000006048,2024-06-26T17:42:09,ACC00001196,Transfer,1279.04,-1155629.2,EUR,Grocery
TXN0000006049,2024-03-05T17:19:56,ACC00006153,ATM,1115.62,-1156744.82,EUR,Shell
TXN0000006050,2024-09-23T20:03:55,ACC00000129,Transfer,827.06,-1155917.76,JPY,Target
TXN0000006051,2024-07-04T17:36:36,ACC00003504,Payment,1172.88,-1157090.64,USD,Grocery
TXN0000006052,2024-01-10T13:24:47,ACC00002135,Debit,710.65,-1157801.29,EUR,Online Store
TXN0000006053,2024-12-13T12:37:19,ACC00003630,Debit,1460.92,-1159262.21,USD,Online Store
TXN0000006054,2024-06-06T23:21:19,ACC00003954,Transfer,1906.77,-1157355.44,GBP,Shell
TXN0000006055,2024-07-21T09:30:27,ACC00001921,Payment,1747.61,-1159103.05,JPY,Amazon
TXN0000006056,2024-08-11T07:09:43,ACC00007508,Credit,276.24,-1158826.81,EUR,Shell
TXN0000006057,2024-06-13T09:37:12,ACC00001240,Credit,1278.91,-1157547.9,EUR,Amazon
TXN0000006058,2024-04-12T22:15:15,ACC00009020,Transfer,1188.25,-1156359.65,JPY,Walmart
TXN0000006059,2024-12-21T09:01:07,ACC00002357,Credit,65.0,-1156294.65,JPY,Grocery
TXN0000006060,2024-02-29T04:28:04,ACC00000233,ATM,1223.27,-1157517.92,EUR,Restaurant
TXN0000006061,2024-05-17T00:49:29,ACC00000248,Payment,1594.81,-1159112.73,JPY,Restaurant
TXN0000006062,2024-07-22T13:11:55,ACC00009427,Transfer,543.02,-1158569.71,EUR,Starbucks
TXN0000006063,2024-01-31T09:29:52,ACC00009497,Credit,291.11,-1158278.6,JPY,Online Store
TXN0000006064,2024-11-12T08:34:31,ACC00002397,Payment,32.97,-1158311.57,GBP,Restaurant
TXN0000006065,2024-06-09T15:36:04,ACC00002960,Transfer,779.4,-1157532.17,EUR,Target
TXN0000006066,2024-10-22T16:24:20,ACC00000203,Credit,900.88,-1156631.29,EUR,Starbucks
TXN0000006067,2024-09-17T03:03:21,ACC00006675,Credit,1759.9,-1154871.39,USD,Restaurant
TXN0000006068,2024-05-14T07:11:36,ACC00000998,Payment,421.52,-1155292.91,JPY,Walmart
TXN0000006069,2024-08-02T08:40:43,ACC00008501,Credit,656.69,-1154636.22,USD,Restaurant
TXN0000006070,2024-04-15T10:55:32,ACC00005066,Payment,518.75,-1155154.97,GBP,Amazon
TXN0000006071,2024-12-30T00:48:56,ACC00007853,Debit,1078.69,-1156233.66,GBP,Target
TXN0000006072,2024-03-17T19:59:53,ACC00004959,ATM,942.88,-1157176.54,USD,Online Store
TXN0000006073,2024-06-03T08:39:46,ACC00007886,ATM,1983.16,-1159159.7,GBP,Online Store
TXN0000006074,2024-09-12T18:39:50,ACC00005554,ATM,1360.64,-1160520.34,JPY,Online Store
TXN0000006075,2024-10-12T10:39:46,ACC00007537,Credit,317.98,-1160202.36,EUR,Shell
TXN0000006076,2024-05-28T13:18:32,ACC00002911,Credit,1275.18,-1158927.18,JPY,Restaurant
TXN0000006077,2024-01-24T14:09:40,ACC00003661,Credit,150.85,-1158776.33,EUR,Amazon
TXN0000006078,2024-11-29T21:44:11,ACC00003692,Credit,500.71,-1158275.62,USD,Restaurant
TXN0000006079,2024-06-28T14:45:08,ACC00006752,Payment,103.03,-1158378.65,EUR,Grocery
TXN0000006080,2024-05-22T12:18:03,ACC00006803,Payment,320.55,-1158699.2,GBP,Walmart
TXN0000006081,2024-12-06T16:42:18,ACC00009845,Transfer,675.74,-1158023.46,EUR,Starbucks
TXN0000006082,2024-08-07T18:01:55,ACC00000550,Credit,1346.88,-1156676.58,GBP,Online Store
TXN0000006083,2024-08-28T05:36:56,ACC00009477,ATM,335.99,-1157012.57,EUR,Amazon
TXN0000006084,2024-10-15T01:24:54,ACC00008075,ATM,1125.72,-1158138.29,GBP,Walmart
TXN0000006085,2024-05-05T20:59:25,ACC00001532,Credit,1349.81,-1156788.48,JPY,Starbucks
TXN0000006086,2024-07-06T12:09:58,ACC00000241,Credit,1268.09,-1155520.39,EUR,Walmart
TXN0000006087,2024-05-23T18:28:40,ACC00007741,Credit,283.19,-1155237.2,EUR,Amazon
TXN0000006088,2024-08-27T15:28:06,ACC00004371,Credit,1401.65,-1153835.55,USD,Walmart
TXN0000006089,2024-04-29T18:48:06,ACC00003671,Transfer,585.96,-1153249.59,GBP,Restaurant
TXN0000006090,2024-03-30T06:17:23,ACC00008478,Payment,1538.69,-1154788.28,USD,Target
TXN0000006091,2024-05-01T02:05:19,ACC00008997,Payment,1270.45,-1156058.73,GBP,Target
TXN0000006092,2024-02-29T07:14:29,ACC00008579,Debit,1074.25,-1157132.98,GBP,Target
TXN0000006093,2024-03-15T00:18:56,ACC00000614,Payment,1598.77,-1158731.75,GBP,Restaurant
TXN0000006094,2024-12-30T00:16:55,ACC00007990,Payment,1159.59,-1159891.34,GBP,Grocery
TXN0000006095,2024-11-24T19:27:01,ACC00006317,Debit,1762.17,-1161653.51,USD,Amazon
TXN0000006096,2024-03-28T04:26:26,ACC00002940,Credit,650.86,-1161002.65,EUR,Online Store
TXN0000006097,2024-02-20T13:32:57,ACC00008974,Debit,1913.71,-1162916.36,EUR,Walmart
TXN0000006098,2024-06-30T09:30:01,ACC00007039,Payment,1460.03,-1164376.39,JPY,Grocery
TXN0000006099,2024-02-21T19:07:01,ACC00002362,Credit,928.43,-1163447.96,JPY,Grocery
TXN0000006100,2024-03-01T13:11:37,ACC00008665,Transfer,656.59,-1162791.37,EUR,Target
TXN0000006101,2024-07-17T19:42:43,ACC00000372,ATM,611.31,-1163402.68,JPY,Online Store
TXN0000006102,2024-10-28T03:28:22,ACC00000580,Payment,872.2,-1164274.88,JPY,Starbucks
TXN0000006103,2024-12-21T22:11:12,ACC00005230,Payment,387.66,-1164662.54,EUR,Restaurant
TXN0000006104,2024-04-13T02:46:39,ACC00000865,Transfer,1114.79,-1163547.75,USD,Online Store
TXN0000006105,2024-02-29T12:08:08,ACC00000253,Credit,345.87,-1163201.88,USD,Walmart
TXN0000006106,2024-06-13T17:26:53,ACC00000397,Payment,1561.35,-1164763.23,USD,Grocery
TXN0000006107,2024-09-18T19:00:26,ACC00000408,Payment,107.61,-1164870.84,EUR,Restaurant
TXN0000006108,2024-10-08T17:22:58,ACC00009218,ATM,677.83,-1165548.67,USD,Amazon
TXN0000006109,2024-12-14T03:56:19,ACC00004939,Debit,1890.85,-1167439.52,USD,Grocery
TXN0000006110,2024-08-08T19:33:15,ACC00007331,Credit,1432.07,-1166007.45,GBP,Walmart
TXN0000006111,2024-04-10T20:48:10,ACC00000024,Credit,172.38,-1165835.07,GBP,Online Store
TXN0000006112,2024-05-29T08:30:24,ACC00009615,Debit,1259.43,-1167094.5,USD,Target
TXN0000006113,2024-03-16T06:08:26,ACC00006235,Credit,415.09,-1166679.41,EUR,Online Store
TXN0000006114,2024-09-06T14:54:11,ACC00008169,Transfer,1906.13,-1164773.28,GBP,Walmart
TXN0000006115,2024-04-01T05:32:33,ACC00001892,ATM,180.54,-1164953.82,GBP,Target
TXN0000006116,2024-12-28T15:55:48,ACC00004624,Payment,831.11,-1165784.93,GBP,Amazon
TXN0000006117,2024-08-08T17:44:55,ACC00004670,Transfer,1275.42,-1164509.51,USD,Online Store
TXN0000006118,2024-03-01T17:17:03,ACC00003278,Payment,1736.59,-1166246.1,USD,Restaurant
TXN0000006119,2024-04-25T07:53:19,ACC00009969,Credit,1572.64,-1164673.46,USD,Grocery
TXN0000006120,2024-12-26T23:29:52,ACC00001053,Debit,759.68,-1165433.14,USD,Grocery
TXN0000006121,2024-10-17T01:52:42,ACC00008023,Transfer,1956.64,-1163476.5,EUR,Amazon
TXN0000006122,2024-02-22T22:59:32,ACC00005358,Credit,1816.6,-1161659.9,EUR,Grocery
TXN0000006123,2024-07-14T20:38:08,ACC00003945,Debit,1781.76,-1163441.66,EUR,Amazon
TXN0000006124,2024-08-20T16:32:07,ACC00005748,Transfer,1382.01,-1162059.65,USD,Online Store
TXN0000006125,2024-09-28T03:33:32,ACC00005141,Debit,286.44,-1162346.09,JPY,Online Store
TXN0000006126,2024-03-19T02:57:53,ACC00004716,Credit,1362.64,-1160983.45,EUR,Restaurant
TXN0000006127,2024-07-24T11:50:12,ACC00005847,Payment,44.57,-1161028.02,EUR,Restaurant
TXN0000006128,2024-01-15T06:05:30,ACC00003702,Credit,1116.69,-1159911.33,JPY,Grocery
TXN0000006129,2024-03-06T14:12:39,ACC00000999,Debit,1771.82,-1161683.15,GBP,Starbucks
TXN0000006130,2024-09-07T23:09:19,ACC00006026,Credit,1232.91,-1160450.24,EUR,Online Store
TXN0000006131,2024-02-08T05:53:43,ACC00000998,ATM,728.35,-1161178.59,EUR,Grocery
TXN0000006132,2024-03-10T01:32:33,ACC00003842,Credit,782.38,-1160396.21,EUR,Walmart
TXN0000006133,2024-04-22T21:19:00,ACC00004109,Payment,1865.66,-1162261.87,EUR,Starbucks
TXN0000006134,2024-12-14T01:39:36,ACC00008810,Payment,1986.48,-1164248.35,EUR,Amazon
TXN0000006135,2024-08-21T17:10:59,ACC00009004,ATM,1659.27,-1165907.62,JPY,Target
TXN0000006136,2024-10-11T17:31:31,ACC00008515,Credit,724.21,-1165183.41,USD,Restaurant
TXN0000006137,2024-05-24T22:10:27,ACC00001411,Credit,662.02,-1164521.39,JPY,Grocery
TXN0000006138,2024-02-05T17:07:34,ACC00005853,Transfer,1999.28,-1162522.11,EUR,Target
TXN0000006139,2024-10-11T08:20:46,ACC00005683,Debit,26.51,-1162548.62,USD,Target
TXN0000006140,2024-02-20T15:52:36,ACC00008191,Payment,293.6,-1162842.22,USD,Amazon
TXN0000006141,2024-05-08T03:10:18,ACC00009814,Credit,1273.66,-1161568.56,USD,Amazon
TXN0000006142,2024-02-01T13:20:58,ACC00005425,Debit,1061.21,-1162629.77,USD,Restaurant
TXN0000006143,2024-02-29T10:03:22,ACC00007794,Payment,999.79,-1163629.56,GBP,Restaurant
TXN0000006144,2024-05-16T07:20:10,ACC00005699,Credit,1769.17,-1161860.39,USD,Target
TXN0000006145,2024-11-08T15:53:17,ACC00006111,Credit,582.2,-1161278.19,JPY,Restaurant
TXN0000006146,2024-12-04T05:19:30,ACC00005694,Payment,1426.28,-1162704.47,USD,Shell
TXN0000006147,2024-02-01T03:12:33,ACC00006744,Payment,1279.82,-1163984.29,GBP,Amazon
TXN0000006148,2024-05-27T04:37:34,ACC00002067,Payment,1588.5,-1165572.79,USD,Starbucks
TXN0000006149,2024-03-20T00:18:11,ACC00000408,Transfer,266.18,-1165306.61,USD,Target
TXN0000006150,2024-06-05T04:08:11,ACC00008909,Transfer,192.12,-1165114.49,USD,Starbucks
TXN0000006151,2024-09-13T04:09:14,ACC00007243,ATM,263.65,-1165378.14,GBP,Walmart
TXN0000006152,2024-02-25T05:27:15,ACC00006163,ATM,1348.16,-1166726.3,JPY,Starbucks
TXN0000006153,2024-02-17T09:52:00,ACC00008514,Debit,1542.81,-1168269.11,EUR,Online Store
TXN0000006154,2024-03-23T20:19:27,ACC00001696,Credit,1916.72,-1166352.39,EUR,Target
TXN0000006155,2024-12-28T13:20:47,ACC00001318,Debit,1219.82,-1167572.21,USD,Restaurant
TXN0000006156,2024-09-24T03:16:50,ACC00002193,Transfer,1408.29,-1166163.92,GBP,Starbucks
TXN0000006157,2024-09-16T07:17:08,ACC00003552,Payment,378.77,-1166542.69,GBP,Shell
TXN0000006158,2024-12-21T11:31:57,ACC00003823,Debit,1764.11,-1168306.8,EUR,Online Store
TXN0000006159,2024-04-16T18:20:26,ACC00003396,Transfer,476.95,-1167829.85,GBP,Online Store
TXN0000006160,2024-03-20T12:05:55,ACC00002330,ATM,422.16,-1168252.01,EUR,Target
TXN0000006161,2024-02-21T08:06:18,ACC00002853,Credit,1817.57,-1166434.44,USD,Starbucks
TXN0000006162,2024-02-06T06:46:50,ACC00004742,Transfer,816.37,-1165618.07,JPY,Walmart
TXN0000006163,2024-05-24T12:47:14,ACC00000439,Credit,1845.21,-1163772.86,USD,Amazon
TXN0000006164,2024-10-11T09:09:30,ACC00009494,Debit,1259.91,-1165032.77,USD,Target
TXN0000006165,2024-02-08T04:07:47,ACC00001687,Transfer,1191.28,-1163841.49,EUR,Restaurant
TXN0000006166,2024-05-07T07:49:39,ACC00009872,Debit,1336.72,-1165178.21,JPY,Target
TXN0000006167,2024-01-28T08:27:49,ACC00008528,Debit,66.31,-1165244.52,USD,Shell
TXN0000006168,2024-07-17T07:57:38,ACC00007908,ATM,991.22,-1166235.74,USD,Online Store
TXN0000006169,2024-04-23T23:55:54,ACC00004651,Debit,1433.71,-1167669.45,USD,Walmart
TXN0000006170,2024-10-24T23:36:42,ACC00004299,Debit,1856.22,-1169525.67,JPY,Target
TXN0000006171,2024-10-30T16:07:50,ACC00002964,Transfer,349.6,-1169176.07,EUR,Grocery
TXN0000006172,2024-08-26T03:27:35,ACC00006415,Payment,1653.0,-1170829.07,JPY,Starbucks
TXN0000006173,2024-01-29T14:42:24,ACC00008044,ATM,735.82,-1171564.89,USD,Walmart
TXN0000006174,2024-04-27T11:44:30,ACC00005328,ATM,1734.84,-1173299.73,JPY,Restaurant
TXN0000006175,2024-03-04T18:25:28,ACC00001735,Payment,875.36,-1174175.09,JPY,Restaurant
TXN0000006176,2024-05-25T11:43:10,ACC00007816,Payment,1985.73,-1176160.82,GBP,Starbucks
TXN0000006177,2024-09-23T05:33:52,ACC00002458,Debit,215.36,-1176376.18,GBP,Grocery
TXN0000006178,2024-11-22T11:34:54,ACC00002754,Payment,1171.11,-1177547.29,EUR,Amazon
TXN0000006179,2024-11-04T13:49:36,ACC00005661,ATM,423.55,-1177970.84,GBP,Restaurant
TXN0000006180,2024-04-14T11:57:17,ACC00008691,Credit,538.79,-1177432.05,GBP,Starbucks
TXN0000006181,2024-12-06T09:41:53,ACC00005286,Credit,1215.69,-1176216.36,USD,Target
TXN0000006182,2024-06-24T01:54:24,ACC00005597,Payment,1664.2,-1177880.56,JPY,Restaurant
TXN0000006183,2024-02-20T15:36:08,ACC00001953,Credit,781.39,-1177099.17,GBP,Grocery
TXN0000006184,2024-06-01T19:40:38,ACC00004693,ATM,1265.77,-1178364.94,USD,Grocery
TXN0000006185,2024-05-03T02:46:43,ACC00003572,Payment,1231.59,-1179596.53,USD,Target
TXN0000006186,2024-04-17T18:20:39,ACC00000865,Transfer,898.03,-1178698.5,JPY,Grocery
TXN0000006187,2024-07-17T14:46:40,ACC00007818,ATM,1114.6,-1179813.1,USD,Grocery
TXN0000006188,2024-10-15T16:11:06,ACC00002517,ATM,1279.19,-1181092.29,GBP,Walmart
TXN0000006189,2024-11-07T00:26:03,ACC00002354,Credit,1497.1,-1179595.19,JPY,Restaurant
TXN0000006190,2024-11-26T18:16:29,ACC00003038,Payment,559.96,-1180155.15,USD,Grocery
TXN0000006191,2024-07-06T13:05:12,ACC00001982,Payment,64.03,-1180219.18,EUR,Amazon
TXN0000006192,2024-09-21T14:21:15,ACC00009558,Transfer,870.96,-1179348.22,EUR,Walmart
TXN0000006193,2024-09-11T08:29:58,ACC00002623,ATM,1578.8,-1180927.02,EUR,Shell
TXN0000006194,2024-03-26T13:00:01,ACC00000708,Transfer,292.98,-1180634.04,USD,Amazon
TXN0000006195,2024-02-03T15:15:55,ACC00006701,Transfer,733.93,-1179900.11,JPY,Walmart
TXN0000006196,2024-10-11T08:05:52,ACC00001064,Payment,1158.27,-1181058.38,USD,Online Store
TXN0000006197,2024-07-02T13:19:35,ACC00002197,ATM,1098.48,-1182156.86,USD,Amazon
TXN0000006198,2024-10-01T11:44:36,ACC00000297,Payment,439.85,-1182596.71,EUR,Restaurant
TXN0000006199,2024-07-10T14:39:35,ACC00003923,Payment,1452.05,-1184048.76,GBP,Starbucks
TXN0000006200,2024-06-11T18:45:11,ACC00003586,Payment,1184.07,-1185232.83,EUR,Shell
TXN0000006201,2024-04-17T14:59:54,ACC00002802,Payment,1422.71,-1186655.54,EUR,Online Store
TXN0000006202,2024-01-05T05:24:28,ACC00000897,Transfer,896.38,-1185759.16,JPY,Walmart
TXN0000006203,2024-11-28T23:25:05,ACC00000884,ATM,1365.51,-1187124.67,GBP,Amazon
TXN0000006204,2024-06-09T12:27:05,ACC00009046,Payment,1864.0,-1188988.67,EUR,Restaurant
TXN0000006205,2024-10-19T03:54:55,ACC00009760,Payment,1223.2,-1190211.87,JPY,Walmart
TXN0000006206,2024-01-03T08:54:54,ACC00007838,Credit,1772.29,-1188439.58,GBP,Target
TXN0000006207,2024-09-30T06:48:19,ACC00000016,Credit,28.83,-1188410.75,GBP,Shell
TXN0000006208,2024-03-23T16:58:10,ACC00007687,Transfer,624.54,-1187786.21,JPY,Starbucks
TXN0000006209,2024-01-19T13:03:43,ACC00002373,Credit,1313.95,-1186472.26,USD,Grocery
TXN0000006210,2024-02-24T02:12:16,ACC00003784,Credit,1964.36,-1184507.9,EUR,Target
TXN0000006211,2024-07-07T17:58:54,ACC00004257,Debit,1647.23,-1186155.13,EUR,Grocery
TXN0000006212,2024-06-07T15:54:40,ACC00007331,Credit,679.83,-1185475.3,EUR,Amazon
TXN0000006213,2024-06-17T17:59:34,ACC00008554,Payment,1474.0,-1186949.3,GBP,Restaurant
TXN0000006214,2024-12-11T05:52:57,ACC00009674,ATM,722.8,-1187672.1,JPY,Shell
TXN0000006215,2024-10-21T19:57:14,ACC00004702,Transfer,873.75,-1186798.35,USD,Walmart
TXN0000006216,2024-10-23T15:16:35,ACC00008399,Transfer,1353.77,-1185444.58,JPY,Online Store
TXN0000006217,2024-04-20T19:28:27,ACC00005017,Debit,548.99,-1185993.57,EUR,Grocery
TXN0000006218,2024-09-07T17:53:41,ACC00002470,ATM,848.7,-1186842.27,GBP,Online Store
TXN0000006219,2024-09-23T21:07:00,ACC00005146,ATM,737.6,-1187579.87,USD,Shell
TXN0000006220,2024-10-27T18:22:50,ACC00008340,Transfer,1001.56,-1186578.31,GBP,Target
TXN0000006221,2024-07-25T08:42:06,ACC00005188,ATM,49.55,-1186627.86,USD,Walmart
TXN0000006222,2024-09-28T14:01:29,ACC00005980,Payment,1027.07,-1187654.93,EUR,Walmart
TXN0000006223,2024-07-10T06:56:23,ACC00008646,Credit,1238.56,-1186416.37,EUR,Restaurant
TXN0000006224,2024-10-31T06:19:52,ACC00004587,Payment,543.29,-1186959.66,EUR,Restaurant
TXN0000006225,2024-03-28T05:09:03,ACC00003667,Payment,502.43,-1187462.09,JPY,Online Store
TXN0000006226,2024-09-03T16:24:40,ACC00001305,Payment,321.98,-1187784.07,USD,Restaurant
TXN0000006227,2024-03-02T07:46:55,ACC00000379,Transfer,1028.46,-1186755.61,GBP,Target
TXN0000006228,2024-06-06T07:52:21,ACC00001329,Credit,1311.43,-1185444.18,USD,Walmart
TXN0000006229,2024-07-06T00:10:12,ACC00004094,ATM,177.21,-1185621.39,JPY,Shell
TXN0000006230,2024-11-08T23:40:36,ACC00006699,Transfer,1836.92,-1183784.47,EUR,Grocery
TXN0000006231,2024-08-08T14:58:16,ACC00004712,Payment,861.69,-1184646.16,USD,Walmart
TXN0000006232,2024-02-25T11:23:33,ACC00009032,Debit,1897.94,-1186544.1,GBP,Amazon
TXN0000006233,2024-09-22T04:16:03,ACC00000410,Debit,1768.24,-1188312.34,EUR,Online Store
TXN0000006234,2024-12-16T15:06:00,ACC00002787,ATM,1049.24,-1189361.58,USD,Grocery
TXN0000006235,2024-03-02T06:48:26,ACC00006515,Credit,1127.64,-1188233.94,EUR,Restaurant
TXN0000006236,2024-04-08T19:22:42,ACC00008581,Debit,1810.54,-1190044.48,USD,Starbucks
TXN0000006237,2024-07-04T22:14:07,ACC00005539,Payment,1692.54,-1191737.02,JPY,Online Store
TXN0000006238,2024-05-22T03:49:35,ACC00001757,Transfer,1361.27,-1190375.75,USD,Walmart
TXN0000006239,2024-10-30T15:55:59,ACC00003973,Payment,1322.01,-1191697.76,JPY,Restaurant
TXN0000006240,2024-11-27T08:43:54,ACC00005190,Debit,880.38,-1192578.14,JPY,Grocery
TXN0000006241,2024-10-08T00:29:32,ACC00002089,Credit,1890.36,-1190687.78,GBP,Grocery
TXN0000006242,2024-07-01T08:59:25,ACC00008794,Payment,1985.67,-1192673.45,USD,Grocery
TXN0000006243,2024-04-19T11:15:53,ACC00000461,Payment,423.94,-1193097.39,USD,Walmart
TXN0000006244,2024-06-18T04:53:32,ACC00007955,ATM,1334.46,-1194431.85,JPY,Walmart
TXN0000006245,2024-09-11T16:21:13,ACC00009886,Credit,1746.73,-1192685.12,JPY,Amazon
TXN0000006246,2024-02-01T20:15:50,ACC00004099,ATM,689.16,-1193374.28,JPY,Shell
TXN0000006247,2024-12-23T18:44:22,ACC00009154,Payment,161.41,-1193535.69,USD,Shell
TXN0000006248,2024-08-28T22:12:28,ACC00006293,Payment,993.36,-1194529.05,USD,Amazon
TXN0000006249,2024-07-13T09:42:33,ACC00001110,Debit,475.44,-1195004.49,JPY,Walmart
TXN0000006250,2024-11-05T00:11:28,ACC00001875,Credit,1646.23,-1193358.26,GBP,Online Store
TXN0000006251,2024-11-10T15:53:16,ACC00004483,Payment,1541.21,-1194899.47,USD,Shell
TXN0000006252,2024-04-11T00:06:25,ACC00004816,Credit,117.87,-1194781.6,USD,Starbucks
TXN0000006253,2024-04-24T15:21:05,ACC00001696,Credit,1593.16,-1193188.44,GBP,Shell
TXN0000006254,2024-04-22T19:16:47,ACC00006860,ATM,666.71,-1193855.15,EUR,Online Store
TXN0000006255,2024-07-29T06:26:11,ACC00004347,Debit,1946.14,-1195801.29,EUR,Walmart
TXN0000006256,2024-11-21T05:02:33,ACC00002291,Debit,1785.17,-1197586.46,EUR,Target
TXN0000006257,2024-07-11T12:07:12,ACC00007156,Payment,1858.72,-1199445.18,EUR,Grocery
TXN0000006258,2024-01-14T14:10:00,ACC00003594,Debit,1006.31,-1200451.49,EUR,Walmart
TXN0000006259,2024-03-31T00:59:42,ACC00003854,Debit,1222.53,-1201674.02,GBP,Online Store
TXN0000006260,2024-08-17T04:34:31,ACC00009464,ATM,1335.5,-1203009.52,GBP,Amazon
TXN0000006261,2024-12-10T16:40:49,ACC00006586,Payment,904.46,-1203913.98,EUR,Online Store
TXN0000006262,2024-03-31T01:01:51,ACC00002322,ATM,1879.29,-1205793.27,EUR,Grocery
TXN0000006263,2024-01-12T00:49:30,ACC00006485,Credit,1344.57,-1204448.7,USD,Online Store
TXN0000006264,2024-12-03T16:18:47,ACC00006992,ATM,107.14,-1204555.84,JPY,Restaurant
TXN0000006265,2024-08-12T09:21:54,ACC00002718,ATM,126.06,-1204681.9,USD,Target
TXN0000006266,2024-08-21T01:58:12,ACC00007099,Transfer,1362.59,-1203319.31,USD,Walmart
TXN0000006267,2024-01-25T05:16:36,ACC00008283,Debit,292.65,-1203611.96,GBP,Grocery
TXN0000006268,2024-10-01T13:03:03,ACC00002016,Payment,1438.12,-1205050.08,JPY,Walmart
TXN0000006269,2024-12-04T17:10:54,ACC00003817,ATM,1083.87,-1206133.95,JPY,Restaurant
TXN0000006270,2024-05-11T13:22:47,ACC00009176,Credit,1755.9,-1204378.05,JPY,Restaurant
TXN0000006271,2024-04-29T23:29:15,ACC00001518,ATM,94.53,-1204472.58,GBP,Starbucks
TXN0000006272,2024-12-06T06:42:44,ACC00009412,Debit,632.28,-1205104.86,EUR,Walmart
TXN0000006273,2024-04-22T01:19:42,ACC00003511,ATM,1694.6,-1206799.46,GBP,Target
TXN0000006274,2024-05-31T07:56:31,ACC00005586,Transfer,1799.27,-1205000.19,EUR,Shell
TXN0000006275,2024-04-13T05:48:13,ACC00007667,Transfer,1472.63,-1203527.56,EUR,Walmart
TXN0000006276,2024-10-16T10:27:15,ACC00003175,Debit,1010.25,-1204537.81,USD,Shell
TXN0000006277,2024-11-07T06:07:41,ACC00003482,Debit,1862.59,-1206400.4,USD,Amazon
TXN0000006278,2024-12-28T02:03:25,ACC00009159,Credit,585.01,-1205815.39,GBP,Grocery
TXN0000006279,2024-03-09T20:25:31,ACC00001555,ATM,1741.27,-1207556.66,GBP,Restaurant
TXN0000006280,2024-11-22T03:00:50,ACC00007285,Payment,1954.77,-1209511.43,GBP,Amazon
TXN0000006281,2024-04-09T19:57:57,ACC00009329,ATM,1765.98,-1211277.41,USD,Walmart
TXN0000006282,2024-05-17T12:25:02,ACC00008942,Debit,1538.47,-1212815.88,EUR,Amazon
TXN0000006283,2024-06-26T07:55:29,ACC00009612,ATM,420.71,-1213236.59,EUR,Walmart
TXN0000006284,2024-07-28T11:16:28,ACC00003442,Payment,1522.23,-1214758.82,USD,Shell
TXN0000006285,2024-06-16T01:30:25,ACC00000515,Transfer,1751.31,-1213007.51,JPY,Grocery
TXN0000006286,2024-10-12T11:27:08,ACC00004196,Transfer,427.86,-1212579.65,EUR,Grocery
TXN0000006287,2024-06-20T05:51:45,ACC00008965,ATM,451.29,-1213030.94,GBP,Amazon
TXN0000006288,2024-06-26T11:09:41,ACC00005216,Payment,1104.88,-1214135.82,GBP,Online Store
TXN0000006289,2024-05-06T05:43:13,ACC00005585,Credit,1695.37,-1212440.45,JPY,Walmart
TXN0000006290,2024-03-31T16:06:56,ACC00006572,ATM,155.42,-1212595.87,GBP,Restaurant
TXN0000006291,2024-12-07T22:07:18,ACC00000378,Credit,318.11,-1212277.76,JPY,Restaurant
TXN0000006292,2024-12-17T04:25:35,ACC00008075,Credit,781.89,-1211495.87,USD,Walmart
TXN0000006293,2024-12-01T05:53:00,ACC00002394,ATM,176.67,-1211672.54,JPY,Restaurant
TXN0000006294,2024-08-23T21:15:05,ACC00009569,Transfer,1216.62,-1210455.92,GBP,Shell
TXN0000006295,2024-03-04T18:59:53,ACC00003293,ATM,736.06,-1211191.98,GBP,Grocery
TXN0000006296,2024-01-28T11:58:28,ACC00004217,Debit,1079.47,-1212271.45,EUR,Grocery
TXN0000006297,2024-08-10T06:53:50,ACC00000152,ATM,785.34,-1213056.79,JPY,Grocery
TXN0000006298,2024-02-08T14:51:17,ACC00002066,Payment,802.77,-1213859.56,USD,Online Store
TXN0000006299,2024-10-07T06:25:40,ACC00004987,Credit,1742.3,-1212117.26,USD,Starbucks
TXN0000006300,2024-03-27T22:41:34,ACC00000237,Payment,1900.77,-1214018.03,USD,Restaurant
TXN0000006301,2024-08-11T02:55:11,ACC00007354,Credit,1740.41,-1212277.62,EUR,Amazon
TXN0000006302,2024-02-29T20:48:13,ACC00004284,Transfer,519.67,-1211757.95,GBP,Starbucks
TXN0000006303,2024-01-14T15:18:19,ACC00005145,Debit,1124.08,-1212882.03,EUR,Online Store
TXN0000006304,2024-10-28T05:13:28,ACC00000038,Credit,1613.03,-1211269.0,USD,Starbucks
TXN0000006305,2024-01-27T09:56:23,ACC00009195,Transfer,1494.67,-1209774.33,JPY,Online Store
TXN0000006306,2024-06-01T09:10:49,ACC00006739,ATM,1888.75,-1211663.08,USD,Shell
TXN0000006307,2024-04-30T22:49:25,ACC00007057,Credit,220.4,-1211442.68,JPY,Online Store
TXN0000006308,2024-05-03T18:21:26,ACC00001031,ATM,1230.75,-1212673.43,USD,Shell
TXN0000006309,2024-05-13T17:31:54,ACC00007789,ATM,157.22,-1212830.65,JPY,Shell
TXN0000006310,2024-12-04T21:23:31,ACC00005480,Payment,1824.34,-1214654.99,GBP,Grocery
TXN0000006311,2024-07-18T22:45:01,ACC00003657,Transfer,507.87,-1214147.12,EUR,Starbucks
TXN0000006312,2024-06-14T07:09:22,ACC00009578,Debit,681.1,-1214828.22,USD,Starbucks
TXN0000006313,2024-08-15T15:21:34,ACC00000753,Debit,307.05,-1215135.27,USD,Grocery
TXN0000006314,2024-08-08T16:14:07,ACC00007548,Payment,1655.47,-1216790.74,GBP,Walmart
TXN0000006315,2024-06-10T16:52:22,ACC00009571,Transfer,1166.06,-1215624.68,EUR,Target
TXN0000006316,2024-02-12T11:11:52,ACC00004252,ATM,1934.5,-1217559.18,GBP,Shell
TXN0000006317,2024-01-20T15:30:17,ACC00002767,Payment,547.96,-1218107.14,EUR,Online Store
TXN0000006318,2024-06-04T19:55:13,ACC00005299,Credit,137.4,-1217969.74,EUR,Walmart
TXN0000006319,2024-11-15T23:34:24,ACC00005376,Credit,1845.86,-1216123.88,GBP,Grocery
TXN0000006320,2024-10-17T21:02:47,ACC00007457,Payment,1882.46,-1218006.34,EUR,Grocery
TXN0000006321,2024-06-04T09:07:10,ACC00007156,ATM,969.44,-1218975.78,GBP,Restaurant
TXN0000006322,2024-05-07T21:34:05,ACC00004040,Credit,233.87,-1218741.91,USD,Walmart
TXN0000006323,2024-09-17T14:45:23,ACC00003540,ATM,560.12,-1219302.03,EUR,Walmart
TXN0000006324,2024-09-15T22:25:04,ACC00009708,Transfer,1015.41,-1218286.62,GBP,Amazon
TXN0000006325,2024-09-10T09:22:40,ACC00005864,Credit,904.7,-1217381.92,JPY,Shell
TXN0000006326,2024-07-29T22:05:52,ACC00007009,ATM,691.54,-1218073.46,USD,Restaurant
TXN0000006327,2024-06-19T08:24:40,ACC00009491,Transfer,189.56,-1217883.9,USD,Grocery
TXN0000006328,2024-09-09T20:17:32,ACC00003423,Credit,1263.88,-1216620.02,JPY,Grocery
TXN0000006329,2024-05-09T01:13:12,ACC00001171,Transfer,596.72,-1216023.3,GBP,Restaurant
TXN0000006330,2024-06-10T05:18:27,ACC00007769,Debit,551.58,-1216574.88,EUR,Target
TXN0000006331,2024-08-07T07:03:34,ACC00004473,Payment,449.81,-1217024.69,EUR,Restaurant
TXN0000006332,2024-11-11T05:50:53,ACC00006548,Transfer,635.5,-1216389.19,EUR,Shell
TXN0000006333,2024-06-10T05:26:39,ACC00003709,Credit,34.43,-1216354.76,JPY,Walmart
TXN0000006334,2024-02-04T13:08:26,ACC00002482,ATM,1601.9,-1217956.66,USD,Starbucks
TXN0000006335,2024-05-28T00:52:38,ACC00005548,Credit,519.83,-1217436.83,EUR,Grocery
TXN0000006336,2024-08-01T08:06:22,ACC00000257,ATM,36.41,-1217473.24,USD,Shell
TXN0000006337,2024-03-23T22:13:38,ACC00004521,Payment,1875.29,-1219348.53,JPY,Grocery
TXN0000006338,2024-11-17T07:31:58,ACC00006862,Debit,1290.5,-1220639.03,USD,Restaurant
TXN0000006339,2024-12-06T23:35:47,ACC00003199,Payment,1659.26,-1222298.29,USD,Amazon
TXN0000006340,2024-11-16T14:27:44,ACC00002535,Credit,1503.98,-1220794.31,EUR,Grocery
TXN0000006341,2024-07-08T20:27:17,ACC00006486,Transfer,1743.56,-1219050.75,EUR,Amazon
TXN0000006342,2024-10-17T03:17:42,ACC00002892,Payment,126.65,-1219177.4,USD,Target
TXN0000006343,2024-12-28T04:25:40,ACC00007005,Debit,1762.86,-1220940.26,GBP,Restaurant
TXN0000006344,2024-08-01T02:22:07,ACC00003959,Transfer,69.61,-1220870.65,USD,Starbucks
TXN0000006345,2024-12-26T23:43:43,ACC00004000,ATM,13.23,-1220883.88,JPY,Shell
TXN0000006346,2024-07-27T23:34:53,ACC00009320,Credit,229.18,-1220654.7,JPY,Target
TXN0000006347,2024-03-25T23:31:46,ACC00006426,Payment,888.98,-1221543.68,USD,Shell
TXN0000006348,2024-08-28T21:36:47,ACC00009112,Debit,1902.87,-1223446.55,JPY,Starbucks
TXN0000006349,2024-06-14T15:05:53,ACC00005280,Transfer,1522.93,-1221923.62,JPY,Grocery
TXN0000006350,2024-02-12T12:47:19,ACC00006816,Credit,1475.34,-1220448.28,GBP,Grocery
TXN0000006351,2024-05-17T12:59:34,ACC00000438,Debit,1767.42,-1222215.7,JPY,Amazon
TXN0000006352,2024-09-01T02:03:19,ACC00000313,Credit,901.75,-1221313.95,USD,Starbucks
TXN0000006353,2024-01-18T10:44:51,ACC00004267,Credit,1913.15,-1219400.8,EUR,Walmart
TXN0000006354,2024-05-27T12:37:54,ACC00006357,Credit,674.24,-1218726.56,EUR,Online Store
TXN0000006355,2024-02-23T14:25:28,ACC00007980,Transfer,1539.3,-1217187.26,GBP,Restaurant
TXN0000006356,2024-04-06T00:25:26,ACC00001915,ATM,1187.28,-1218374.54,GBP,Restaurant
TXN0000006357,2024-10-06T20:02:18,ACC00000920,Transfer,1852.97,-1216521.57,USD,Shell
TXN0000006358,2024-10-14T08:10:58,ACC00002268,ATM,1511.34,-1218032.91,USD,Walmart
TXN0000006359,2024-03-02T15:17:09,ACC00000108,Payment,1642.92,-1219675.83,USD,Shell
TXN0000006360,2024-10-14T01:01:02,ACC00008638,Debit,694.51,-1220370.34,USD,Restaurant
TXN0000006361,2024-10-09T15:16:42,ACC00005533,ATM,780.26,-1221150.6,EUR,Online Store
TXN0000006362,2024-02-26T10:03:19,ACC00006186,Payment,1157.25,-1222307.85,GBP,Target
TXN0000006363,2024-08-15T07:26:31,ACC00001275,Payment,1780.35,-1224088.2,EUR,Walmart
TXN0000006364,2024-02-13T05:50:03,ACC00007356,Payment,14.91,-1224103.11,GBP,Target
TXN0000006365,2024-08-23T12:49:13,ACC00000324,ATM,98.34,-1224201.45,EUR,Amazon
TXN0000006366,2024-05-04T19:28:07,ACC00006692,Payment,665.4,-1224866.85,EUR,Restaurant
TXN0000006367,2024-04-23T00:43:42,ACC00002961,Transfer,1229.98,-1223636.87,JPY,Online Store
TXN0000006368,2024-06-09T13:40:21,ACC00005638,Transfer,465.83,-1223171.04,GBP,Walmart
TXN0000006369,2024-07-20T17:28:34,ACC00004991,Credit,210.53,-1222960.51,EUR,Amazon
TXN0000006370,2024-12-07T08:05:44,ACC00000281,ATM,1871.39,-1224831.9,GBP,Online Store
TXN0000006371,2024-12-07T13:16:29,ACC00004007,Credit,986.73,-1223845.17,JPY,Walmart
TXN0000006372,2024-09-03T21:40:44,ACC00009536,Debit,73.21,-1223918.38,JPY,Amazon
TXN0000006373,2024-03-04T17:56:55,ACC00008412,Debit,1339.07,-1225257.45,EUR,Target
TXN0000006374,2024-03-22T00:26:09,ACC00001678,Payment,1806.57,-1227064.02,JPY,Restaurant
TXN0000006375,2024-03-03T10:05:48,ACC00003121,Credit,1052.46,-1226011.56,GBP,Starbucks
TXN0000006376,2024-01-03T22:05:18,ACC00004106,Transfer,1277.28,-1224734.28,JPY,Starbucks
TXN0000006377,2024-02-11T21:43:09,ACC00001607,Debit,20.82,-1224755.1,JPY,Starbucks
TXN0000006378,2024-08-18T16:53:41,ACC00001960,Credit,675.98,-1224079.12,JPY,Online Store
TXN0000006379,2024-11-03T03:03:48,ACC00005128,Transfer,794.42,-1223284.7,GBP,Restaurant
TXN0000006380,2024-04-20T17:27:59,ACC00002486,Transfer,1288.92,-1221995.78,EUR,Starbucks
TXN0000006381,2024-02-20T09:57:05,ACC00004091,ATM,1756.3,-1223752.08,JPY,Shell
TXN0000006382,2024-08-27T16:00:56,ACC00001558,Debit,1014.17,-1224766.25,JPY,Restaurant
TXN0000006383,2024-05-25T19:44:54,ACC00007487,Debit,1504.33,-1226270.58,JPY,Shell
TXN0000006384,2024-07-14T08:37:14,ACC00007767,Debit,391.61,-1226662.19,USD,Shell
TXN0000006385,2024-10-19T19:36:38,ACC00002211,Debit,664.45,-1227326.64,JPY,Target
TXN0000006386,2024-01-19T00:23:56,ACC00004414,Credit,418.92,-1226907.72,GBP,Online Store
TXN0000006387,2024-09-14T22:02:24,ACC00009843,Transfer,193.59,-1226714.13,JPY,Target
TXN0000006388,2024-08-24T09:36:22,ACC00008633,Debit,916.9,-1227631.03,GBP,Shell
TXN0000006389,2024-12-25T03:50:48,ACC00002580,ATM,250.04,-1227881.07,USD,Restaurant
TXN0000006390,2024-02-26T08:43:33,ACC00008846,Payment,18.43,-1227899.5,USD,Restaurant
TXN0000006391,2024-07-23T11:22:51,ACC00005583,ATM,675.02,-1228574.52,GBP,Online Store
TXN0000006392,2024-12-04T19:34:40,ACC00003689,Debit,1058.7,-1229633.22,JPY,Walmart
TXN0000006393,2024-08-01T01:25:38,ACC00008857,ATM,839.45,-1230472.67,JPY,Shell
TXN0000006394,2024-07-29T18:17:49,ACC00000039,ATM,1096.19,-1231568.86,USD,Online Store
TXN0000006395,2024-12-06T19:37:42,ACC00004010,ATM,1933.41,-1233502.27,EUR,Restaurant
TXN0000006396,2024-08-27T00:21:21,ACC00007183,Transfer,297.82,-1233204.45,JPY,Walmart
TXN0000006397,2024-02-17T21:15:48,ACC00004019,ATM,472.46,-1233676.91,JPY,Amazon
TXN0000006398,2024-02-12T20:51:33,ACC00007233,Debit,1689.5,-1235366.41,EUR,Target
TXN0000006399,2024-12-24T22:57:19,ACC00000738,ATM,1931.28,-1237297.69,USD,Walmart
TXN0000006400,2024-10-28T14:38:48,ACC00003033,Credit,77.16,-1237220.53,USD,Grocery
TXN0000006401,2024-06-19T02:36:21,ACC00009600,ATM,1509.33,-1238729.86,USD,Shell
TXN0000006402,2024-08-28T08:19:40,ACC00009193,Transfer,1881.28,-1236848.58,JPY,Shell
TXN0000006403,2024-11-01T01:33:25,ACC00003398,Transfer,1797.9,-1235050.68,GBP,Target
TXN0000006404,2024-03-06T07:12:46,ACC00007362,Debit,515.25,-1235565.93,GBP,Walmart
TXN0000006405,2024-02-08T08:41:08,ACC00004684,Debit,1473.23,-1237039.16,GBP,Online Store
TXN0000006406,2024-03-19T02:05:39,ACC00001207,ATM,1101.45,-1238140.61,GBP,Shell
TXN0000006407,2024-02-25T13:41:23,ACC00008980,Transfer,1890.38,-1236250.23,JPY,Target
TXN0000006408,2024-01-11T23:34:48,ACC00000110,Debit,584.92,-1236835.15,EUR,Starbucks
TXN0000006409,2024-04-17T06:47:01,ACC00005832,Debit,95.74,-1236930.89,USD,Target
TXN0000006410,2024-06-21T18:38:31,ACC00001843,Credit,1783.3,-1235147.59,USD,Starbucks
TXN0000006411,2024-08-25T22:00:54,ACC00006951,ATM,1925.62,-1237073.21,GBP,Walmart
TXN0000006412,2024-11-22T09:29:39,ACC00008882,Transfer,639.97,-1236433.24,JPY,Grocery
TXN0000006413,2024-11-03T07:07:25,ACC00002110,Transfer,982.15,-1235451.09,JPY,Online Store
TXN0000006414,2024-07-28T04:04:44,ACC00009594,Transfer,1500.0,-1233951.09,EUR,Amazon
TXN0000006415,2024-03-23T23:10:32,ACC00003133,Transfer,542.68,-1233408.41,JPY,Amazon
TXN0000006416,2024-10-22T22:16:26,ACC00007470,ATM,1380.23,-1234788.64,USD,Online Store
TXN0000006417,2024-09-27T21:25:05,ACC00002013,Payment,745.45,-1235534.09,GBP,Amazon
TXN0000006418,2024-11-26T02:04:19,ACC00006158,ATM,1554.89,-1237088.98,USD,Online Store
TXN0000006419,2024-07-29T17:57:08,ACC00000727,Credit,685.75,-1236403.23,JPY,Shell
TXN0000006420,2024-06-12T06:58:07,ACC00001592,Payment,913.51,-1237316.74,EUR,Grocery
TXN0000006421,2024-06-14T02:36:48,ACC00000693,Transfer,390.54,-1236926.2,EUR,Starbucks
TXN0000006422,2024-02-15T00:54:29,ACC00006291,Transfer,1592.84,-1235333.36,GBP,Target
TXN0000006423,2024-04-06T01:30:09,ACC00008340,ATM,758.95,-1236092.31,JPY,Grocery
TXN0000006424,2024-07-07T20:40:46,ACC00008584,Debit,840.18,-1236932.49,JPY,Grocery
TXN0000006425,2024-10-21T07:22:18,ACC00009926,Transfer,1998.79,-1234933.7,JPY,Grocery
TXN0000006426,2024-10-04T00:18:02,ACC00006444,Payment,1706.58,-1236640.28,EUR,Restaurant
TXN0000006427,2024-09-12T12:03:40,ACC00006549,Debit,1647.58,-1238287.86,USD,Restaurant
TXN0000006428,2024-01-02T03:29:09,ACC00000898,Credit,1031.22,-1237256.64,JPY,Amazon
TXN0000006429,2024-01-20T09:00:22,ACC00003011,Transfer,1237.58,-1236019.06,GBP,Starbucks
TXN0000006430,2024-11-02T12:56:48,ACC00004805,ATM,323.21,-1236342.27,GBP,Target
TXN0000006431,2024-05-07T20:08:01,ACC00000432,Debit,790.81,-1237133.08,GBP,Walmart
TXN0000006432,2024-05-11T19:02:56,ACC00001773,Credit,487.64,-1236645.44,GBP,Online Store
TXN0000006433,2024-03-22T10:33:19,ACC00000403,Payment,617.77,-1237263.21,USD,Target
TXN0000006434,2024-12-01T08:02:48,ACC00001342,Debit,1819.49,-1239082.7,EUR,Walmart
TXN0000006435,2024-01-27T08:42:46,ACC00007635,Payment,1576.92,-1240659.62,EUR,Amazon
TXN0000006436,2024-06-17T21:47:06,ACC00005650,ATM,799.34,-1241458.96,JPY,Amazon
TXN0000006437,2024-05-30T17:34:34,ACC00006479,Payment,1372.56,-1242831.52,EUR,Walmart
TXN0000006438,2024-02-16T23:21:11,ACC00003233,ATM,913.29,-1243744.81,EUR,Target
TXN0000006439,2024-12-10T20:46:30,ACC00002727,Payment,1930.35,-1245675.16,GBP,Online Store
TXN0000006440,2024-10-14T11:26:20,ACC00008469,Transfer,1740.94,-1243934.22,GBP,Target
TXN0000006441,2024-06-02T05:45:33,ACC00006996,Payment,1755.76,-1245689.98,GBP,Restaurant
TXN0000006442,2024-01-05T20:08:45,ACC00005252,Debit,892.95,-1246582.93,EUR,Target
TXN0000006443,2024-04-16T15:30:22,ACC00008169,ATM,151.84,-1246734.77,EUR,Restaurant
TXN0000006444,2024-12-03T03:30:38,ACC00009198,Credit,1649.47,-1245085.3,USD,Restaurant
TXN0000006445,2024-06-09T10:36:51,ACC00002336,Payment,829.18,-1245914.48,USD,Amazon
TXN0000006446,2024-07-11T09:26:55,ACC00006250,ATM,19.89,-1245934.37,JPY,Grocery
TXN0000006447,2024-06-04T16:30:40,ACC00003810,ATM,1912.79,-1247847.16,GBP,Target
TXN0000006448,2024-03-02T17:49:53,ACC00003154,Debit,1002.49,-1248849.65,USD,Target
TXN0000006449,2024-07-23T07:11:03,ACC00000536,Debit,1746.43,-1250596.08,GBP,Restaurant
TXN0000006450,2024-09-11T12:00:25,ACC00008264,Credit,1745.78,-1248850.3,EUR,Walmart
TXN0000006451,2024-11-06T05:51:18,ACC00002355,Payment,185.84,-1249036.14,USD,Online Store
TXN0000006452,2024-01-24T02:36:26,ACC00006790,Transfer,577.85,-1248458.29,USD,Walmart
TXN0000006453,2024-07-03T02:36:36,ACC00007503,Debit,757.39,-1249215.68,USD,Restaurant
TXN0000006454,2024-01-18T14:20:45,ACC00001169,Credit,87.76,-1249127.92,JPY,Online Store
TXN0000006455,2024-01-23T11:01:52,ACC00000651,Debit,1244.54,-1250372.46,GBP,Walmart
TXN0000006456,2024-02-22T13:16:42,ACC00005724,Credit,1464.28,-1248908.18,USD,Shell
TXN0000006457,2024-08-21T05:32:06,ACC00007469,Transfer,1619.55,-1247288.63,EUR,Restaurant
TXN0000006458,2024-03-16T00:19:51,ACC00003387,ATM,662.03,-1247950.66,GBP,Online Store
TXN0000006459,2024-08-17T07:08:16,ACC00000968,ATM,1635.16,-1249585.82,EUR,Grocery
TXN0000006460,2024-05-28T17:53:19,ACC00001706,Transfer,1499.58,-1248086.24,USD,Walmart
TXN0000006461,2024-02-20T20:01:14,ACC00003994,ATM,267.23,-1248353.47,USD,Starbucks
TXN0000006462,2024-10-20T10:52:28,ACC00007465,Credit,1018.91,-1247334.56,JPY,Amazon
TXN0000006463,2024-11-05T08:03:23,ACC00002871,Debit,548.05,-1247882.61,JPY,Online Store
TXN0000006464,2024-07-30T07:23:41,ACC00008466,ATM,1627.98,-1249510.59,EUR,Grocery
TXN0000006465,2024-06-24T15:48:44,ACC00009856,Credit,1401.88,-1248108.71,EUR,Online Store
TXN0000006466,2024-06-20T01:37:24,ACC00000283,Debit,1696.4,-1249805.11,USD,Walmart
TXN0000006467,2024-10-21T05:09:58,ACC00002253,Debit,1103.12,-1250908.23,EUR,Grocery
TXN0000006468,2024-02-04T07:24:41,ACC00001095,Transfer,1052.83,-1249855.4,EUR,Shell
TXN0000006469,2024-01-06T13:45:23,ACC00004390,ATM,1688.76,-1251544.16,USD,Online Store
TXN0000006470,2024-12-08T02:49:55,ACC00005712,Transfer,1008.08,-1250536.08,EUR,Target
TXN0000006471,2024-07-05T12:05:37,ACC00000956,Debit,1848.43,-1252384.51,JPY,Target
TXN0000006472,2024-06-21T11:05:30,ACC00002040,Payment,1121.42,-1253505.93,JPY,Starbucks
TXN0000006473,2024-10-10T21:08:34,ACC00007064,Credit,849.29,-1252656.64,USD,Target
TXN0000006474,2024-10-09T20:50:58,ACC00008286,Transfer,317.48,-1252339.16,USD,Shell
TXN0000006475,2024-02-14T12:54:22,ACC00006707,Debit,1067.87,-1253407.03,JPY,Restaurant
TXN0000006476,2024-07-06T09:07:24,ACC00000707,ATM,20.35,-1253427.38,USD,Grocery
TXN0000006477,2024-03-25T02:35:44,ACC00007505,Transfer,1416.34,-1252011.04,JPY,Walmart
TXN0000006478,2024-11-23T00:49:59,ACC00000195,Credit,558.29,-1251452.75,JPY,Online Store
TXN0000006479,2024-07-15T03:18:23,ACC00007390,Transfer,548.36,-1250904.39,JPY,Restaurant
TXN0000006480,2024-12-27T15:33:04,ACC00008733,Debit,1823.98,-1252728.37,USD,Target
TXN0000006481,2024-05-07T13:32:45,ACC00006218,ATM,442.61,-1253170.98,EUR,Amazon
TXN0000006482,2024-02-04T21:56:26,ACC00000553,Debit,1610.13,-1254781.11,JPY,Amazon
TXN0000006483,2024-12-12T09:48:22,ACC00001003,Debit,69.84,-1254850.95,EUR,Shell
TXN0000006484,2024-02-16T08:56:52,ACC00006899,Debit,1750.77,-1256601.72,GBP,Online Store
TXN0000006485,2024-05-07T11:05:43,ACC00001053,ATM,1215.48,-1257817.2,USD,Target
TXN0000006486,2024-02-01T21:29:11,ACC00006625,Debit,872.15,-1258689.35,JPY,Online Store
TXN0000006487,2024-06-03T14:46:43,ACC00002858,Debit,1663.46,-1260352.81,GBP,Target
TXN0000006488,2024-01-02T11:50:34,ACC00002174,Transfer,428.31,-1259924.5,USD,Starbucks
TXN0000006489,2024-03-31T03:33:59,ACC00009797,Transfer,1336.57,-1258587.93,EUR,Grocery
TXN0000006490,2024-04-14T08:35:54,ACC00006118,Payment,1022.83,-1259610.76,JPY,Amazon
TXN0000006491,2024-08-01T11:14:48,ACC00007102,Debit,1170.36,-1260781.12,EUR,Amazon
TXN0000006492,2024-12-06T21:39:32,ACC00001365,Credit,1810.54,-1258970.58,USD,Shell
TXN0000006493,2024-05-06T01:32:55,ACC00003647,ATM,87.41,-1259057.99,JPY,Shell
TXN0000006494,2024-01-16T06:15:04,ACC00005716,Credit,1930.9,-1257127.09,EUR,Online Store
TXN0000006495,2024-12-07T11:11:51,ACC00006414,Credit,998.21,-1256128.88,EUR,Target
TXN0000006496,2024-01-29T03:56:50,ACC00004375,ATM,1281.2,-1257410.08,JPY,Amazon
TXN0000006497,2024-10-21T00:58:48,ACC00004810,Payment,1322.08,-1258732.16,JPY,Target
TXN0000006498,2024-04-14T23:20:58,ACC00001183,Credit,1469.37,-1257262.79,USD,Shell
TXN0000006499,2024-07-04T17:55:03,ACC00000831,Credit,712.01,-1256550.78,GBP,Shell
TXN0000006500,2024-10-22T03:42:30,ACC00007632,Payment,1031.98,-1257582.76,USD,Walmart
TXN0000006501,2024-08-11T12:57:16,ACC00006561,Debit,1161.81,-1258744.57,EUR,Shell
TXN0000006502,2024-02-27T19:37:44,ACC00008120,ATM,381.76,-1259126.33,GBP,Walmart
TXN0000006503,2024-06-23T09:16:53,ACC00004626,ATM,55.77,-1259182.1,USD,Starbucks
TXN0000006504,2024-03-20T11:31:34,ACC00007605,Payment,1137.56,-1260319.66,GBP,Grocery
TXN0000006505,2024-01-10T02:51:14,ACC00003940,Transfer,376.81,-1259942.85,GBP,Target
TXN0000006506,2024-11-19T09:38:25,ACC00005357,Transfer,927.6,-1259015.25,EUR,Online Store
TXN0000006507,2024-07-24T03:42:18,ACC00005114,Payment,584.28,-1259599.53,JPY,Grocery
TXN0000006508,2024-01-19T11:44:17,ACC00005569,ATM,1276.5,-1260876.03,GBP,Restaurant
TXN0000006509,2024-09-20T12:11:04,ACC00009534,Payment,715.81,-1261591.84,JPY,Online Store
TXN0000006510,2024-02-19T11:52:06,ACC00008172,Credit,701.74,-1260890.1,GBP,Shell
TXN0000006511,2024-09-01T05:15:18,ACC00002792,Credit,17.93,-1260872.17,USD,Target
TXN0000006512,2024-01-12T21:01:19,ACC00008641,Transfer,370.69,-1260501.48,USD,Online Store
TXN0000006513,2024-01-01T03:07:29,ACC00000209,Credit,214.38,-1260287.1,GBP,Shell
TXN0000006514,2024-07-29T13:00:33,ACC00002215,Payment,1810.29,-1262097.39,GBP,Online Store
TXN0000006515,2024-04-29T20:41:41,ACC00006439,Transfer,1885.13,-1260212.26,USD,Online Store
TXN0000006516,2024-01-02T07:35:29,ACC00009933,Payment,81.68,-1260293.94,GBP,Shell
TXN0000006517,2024-07-23T23:28:28,ACC00004592,Credit,834.78,-1259459.16,JPY,Grocery
TXN0000006518,2024-07-06T23:42:03,ACC00001151,ATM,1040.91,-1260500.07,USD,Amazon
TXN0000006519,2024-09-09T05:43:14,ACC00000381,Credit,1654.8,-1258845.27,USD,Amazon
TXN0000006520,2024-12-26T16:56:38,ACC00001481,Payment,160.68,-1259005.95,USD,Starbucks
TXN0000006521,2024-10-15T14:38:15,ACC00007427,ATM,69.05,-1259075.0,USD,Walmart
TXN0000006522,2024-08-26T22:32:03,ACC00005564,Credit,868.46,-1258206.54,GBP,Grocery
TXN0000006523,2024-02-12T01:32:52,ACC00007138,Payment,1386.62,-1259593.16,JPY,Walmart
TXN0000006524,2024-05-17T00:00:03,ACC00005606,Credit,1906.67,-1257686.49,JPY,Online Store
TXN0000006525,2024-12-22T15:08:16,ACC00005955,ATM,389.87,-1258076.36,GBP,Target
TXN0000006526,2024-04-13T07:58:53,ACC00000739,Credit,161.15,-1257915.21,USD,Restaurant
TXN0000006527,2024-02-22T03:43:09,ACC00009593,ATM,933.69,-1258848.9,GBP,Walmart
TXN0000006528,2024-03-14T12:04:30,ACC00009910,Credit,1826.15,-1257022.75,GBP,Starbucks
TXN0000006529,2024-06-10T07:30:35,ACC00008312,Payment,1190.11,-1258212.86,USD,Walmart
TXN0000006530,2024-08-16T19:23:27,ACC00000235,Transfer,753.88,-1257458.98,JPY,Shell
TXN0000006531,2024-05-29T01:39:48,ACC00006505,Transfer,63.75,-1257395.23,USD,Shell
TXN0000006532,2024-09-04T02:21:38,ACC00005920,Debit,789.43,-1258184.66,GBP,Grocery
TXN0000006533,2024-01-01T05:25:34,ACC00002612,Transfer,1832.45,-1256352.21,JPY,Amazon
TXN0000006534,2024-04-17T14:31:39,ACC00002405,Debit,1233.38,-1257585.59,GBP,Online Store
TXN0000006535,2024-03-04T13:22:22,ACC00001259,Debit,508.11,-1258093.7,USD,Shell
TXN0000006536,2024-06-08T15:03:56,ACC00003448,Debit,1537.59,-1259631.29,GBP,Walmart
TXN0000006537,2024-08-14T09:58:29,ACC00001627,Debit,181.21,-1259812.5,JPY,Shell
TXN0000006538,2024-07-10T04:18:37,ACC00001086,ATM,1322.06,-1261134.56,EUR,Walmart
TXN0000006539,2024-05-13T03:54:47,ACC00003415,Debit,1949.17,-1263083.73,JPY,Grocery
TXN0000006540,2024-04-18T23:55:09,ACC00006598,Payment,350.93,-1263434.66,GBP,Grocery
TXN0000006541,2024-01-12T19:23:36,ACC00000284,Debit,1531.42,-1264966.08,USD,Grocery
TXN0000006542,2024-08-07T18:30:59,ACC00004409,Payment,330.26,-1265296.34,EUR,Restaurant
TXN0000006543,2024-03-16T11:30:58,ACC00000120,Debit,593.65,-1265889.99,JPY,Amazon
TXN0000006544,2024-01-18T06:17:48,ACC00007675,ATM,802.01,-1266692.0,EUR,Shell
TXN0000006545,2024-02-28T12:14:06,ACC00001145,Credit,1948.42,-1264743.58,GBP,Online Store
TXN0000006546,2024-04-04T04:07:44,ACC00002053,ATM,510.23,-1265253.81,GBP,Walmart
TXN0000006547,2024-05-04T19:48:09,ACC00002694,Payment,1089.14,-1266342.95,EUR,Starbucks
TXN0000006548,2024-11-16T01:36:13,ACC00006208,Credit,853.93,-1265489.02,EUR,Grocery
TXN0000006549,2024-11-06T04:00:11,ACC00005335,Credit,861.68,-1264627.34,EUR,Starbucks
TXN0000006550,2024-04-09T08:14:50,ACC00006181,Payment,270.74,-1264898.08,JPY,Grocery
TXN0000006551,2024-02-06T06:31:10,ACC00004532,Transfer,925.2,-1263972.88,GBP,Target
TXN0000006552,2024-12-05T01:09:23,ACC00000154,Credit,1548.61,-1262424.27,USD,Online Store
TXN0000006553,2024-11-01T05:09:57,ACC00004138,Payment,1487.7,-1263911.97,JPY,Amazon
TXN0000006554,2024-05-15T19:19:35,ACC00003157,Credit,725.57,-1263186.4,EUR,Grocery
TXN0000006555,2024-08-02T12:43:53,ACC00000801,ATM,1376.45,-1264562.85,JPY,Restaurant
TXN0000006556,2024-12-24T07:40:09,ACC00001578,Debit,577.38,-1265140.23,USD,Target
TXN0000006557,2024-09-07T16:39:29,ACC00000082,Credit,520.62,-1264619.61,USD,Amazon
TXN0000006558,2024-12-18T00:21:55,ACC00002577,ATM,825.78,-1265445.39,EUR,Starbucks
TXN0000006559,2024-03-23T08:27:10,ACC00000770,ATM,542.47,-1265987.86,GBP,Restaurant
TXN0000006560,2024-10-13T03:09:32,ACC00000656,Payment,1637.66,-1267625.52,JPY,Restaurant
TXN0000006561,2024-04-14T06:41:57,ACC00001880,ATM,927.41,-1268552.93,JPY,Restaurant
TXN0000006562,2024-04-18T00:15:34,ACC00000770,ATM,1394.12,-1269947.05,USD,Target
TXN0000006563,2024-06-07T08:18:10,ACC00000140,Payment,1743.9,-1271690.95,EUR,Restaurant
TXN0000006564,2024-05-08T15:17:41,ACC00008775,ATM,106.94,-1271797.89,EUR,Grocery
TXN0000006565,2024-03-09T10:28:44,ACC00000220,Transfer,88.9,-1271708.99,JPY,Starbucks
TXN0000006566,2024-06-07T06:52:46,ACC00003114,ATM,1004.1,-1272713.09,EUR,Restaurant
TXN0000006567,2024-10-18T16:22:39,ACC00002083,ATM,1897.92,-1274611.01,JPY,Grocery
TXN0000006568,2024-08-15T21:00:19,ACC00005871,Debit,16.8,-1274627.81,JPY,Target
TXN0000006569,2024-01-06T06:56:05,ACC00001327,Transfer,1512.16,-1273115.65,USD,Amazon
TXN0000006570,2024-03-16T16:37:25,ACC00005387,Debit,1138.03,-1274253.68,GBP,Grocery
TXN0000006571,2024-03-03T07:44:46,ACC00000957,Payment,402.12,-1274655.8,USD,Online Store
TXN0000006572,2024-09-18T20:16:28,ACC00003556,Payment,708.8,-1275364.6,GBP,Grocery
TXN0000006573,2024-10-10T15:20:23,ACC00008996,Debit,1968.52,-1277333.12,USD,Amazon
TXN0000006574,2024-02-02T14:02:44,ACC00006951,ATM,1664.55,-1278997.67,GBP,Shell
TXN0000006575,2024-09-19T20:23:18,ACC00005953,Debit,1550.2,-1280547.87,JPY,Grocery
TXN0000006576,2024-03-08T08:48:55,ACC00002902,Payment,1024.37,-1281572.24,JPY,Online Store
TXN0000006577,2024-01-12T23:28:56,ACC00003469,Transfer,486.68,-1281085.56,EUR,Amazon
TXN0000006578,2024-06-02T18:12:03,ACC00005045,ATM,978.51,-1282064.07,EUR,Target
TXN0000006579,2024-10-12T07:52:07,ACC00009949,Transfer,273.49,-1281790.58,EUR,Restaurant
TXN0000006580,2024-08-08T17:59:07,ACC00006201,Credit,457.45,-1281333.13,EUR,Starbucks
TXN0000006581,2024-04-14T08:28:09,ACC00000479,Transfer,948.57,-1280384.56,EUR,Amazon
TXN0000006582,2024-04-14T20:11:17,ACC00002079,Transfer,257.84,-1280126.72,USD,Online Store
TXN0000006583,2024-03-15T10:36:55,ACC00009309,ATM,1917.47,-1282044.19,USD,Amazon
TXN0000006584,2024-01-10T14:42:22,ACC00008867,Transfer,1707.29,-1280336.9,GBP,Target
TXN0000006585,2024-08-29T10:16:11,ACC00001866,Transfer,1476.07,-1278860.83,USD,Restaurant
TXN0000006586,2024-04-15T19:43:49,ACC00006602,Credit,380.36,-1278480.47,GBP,Target
TXN0000006587,2024-05-21T12:18:27,ACC00000493,Transfer,1597.54,-1276882.93,USD,Walmart
TXN0000006588,2024-04-14T18:57:37,ACC00002568,Debit,684.17,-1277567.1,EUR,Online Store
TXN0000006589,2024-01-29T03:40:12,ACC00008563,ATM,627.9,-1278195.0,GBP,Target
TXN0000006590,2024-12-21T15:26:55,ACC00007832,Credit,732.54,-1277462.46,USD,Target
TXN0000006591,2024-04-06T03:11:44,ACC00001276,Payment,139.48,-1277601.94,USD,Starbucks
TXN0000006592,2024-12-14T03:53:19,ACC00007350,ATM,582.23,-1278184.17,USD,Amazon
TXN0000006593,2024-03-23T02:22:32,ACC00000383,Debit,1340.54,-1279524.71,JPY,Online Store
TXN0000006594,2024-08-05T06:48:14,ACC00003298,Credit,1845.79,-1277678.92,EUR,Restaurant
TXN0000006595,2024-08-21T11:57:03,ACC00007040,Credit,886.17,-1276792.75,USD,Shell
TXN0000006596,2024-07-04T07:33:24,ACC00006155,Payment,699.74,-1277492.49,EUR,Amazon
TXN0000006597,2024-09-25T18:00:18,ACC00007113,Debit,94.77,-1277587.26,GBP,Walmart
TXN0000006598,2024-08-03T17:25:14,ACC00001964,Credit,664.36,-1276922.9,EUR,Walmart
TXN0000006599,2024-10-08T22:56:12,ACC00007101,Transfer,682.83,-1276240.07,EUR,Shell
TXN0000006600,2024-12-17T06:06:38,ACC00009923,Payment,459.52,-1276699.59,JPY,Restaurant
TXN0000006601,2024-01-10T03:25:14,ACC00003964,Transfer,1888.82,-1274810.77,JPY,Walmart
TXN0000006602,2024-10-05T11:54:23,ACC00004295,Transfer,1500.02,-1273310.75,GBP,Online Store
TXN0000006603,2024-07-10T18:30:29,ACC00005285,Credit,893.7,-1272417.05,USD,Starbucks
TXN0000006604,2024-10-16T21:34:22,ACC00005782,Debit,704.79,-1273121.84,JPY,Amazon
TXN0000006605,2024-02-26T12:27:32,ACC00001435,Transfer,1985.5,-1271136.34,GBP,Target
TXN0000006606,2024-10-03T11:03:42,ACC00003946,Credit,560.76,-1270575.58,EUR,Amazon
TXN0000006607,2024-03-19T19:57:01,ACC00005944,Credit,956.5,-1269619.08,USD,Restaurant
TXN0000006608,2024-11-09T21:50:33,ACC00009863,ATM,1370.07,-1270989.15,USD,Target
TXN0000006609,2024-11-15T16:43:54,ACC00007697,Payment,257.6,-1271246.75,USD,Walmart
TXN0000006610,2024-01-11T22:13:25,ACC00009076,Debit,353.82,-1271600.57,GBP,Walmart
TXN0000006611,2024-07-28T18:56:13,ACC00000006,ATM,1632.85,-1273233.42,JPY,Shell
TXN0000006612,2024-07-04T00:01:32,ACC00001087,Debit,1172.05,-1274405.47,JPY,Restaurant
TXN0000006613,2024-05-23T20:06:45,ACC00004403,Credit,1938.27,-1272467.2,JPY,Grocery
TXN0000006614,2024-02-05T03:22:29,ACC00007293,Debit,219.1,-1272686.3,JPY,Walmart
TXN0000006615,2024-12-24T17:30:47,ACC00004363,Transfer,1647.75,-1271038.55,GBP,Grocery
TXN0000006616,2024-12-03T16:03:17,ACC00005167,Credit,1074.99,-1269963.56,USD,Grocery
TXN0000006617,2024-11-12T01:02:11,ACC00000344,Transfer,660.68,-1269302.88,JPY,Target
TXN0000006618,2024-06-29T22:47:11,ACC00007820,ATM,189.97,-1269492.85,GBP,Amazon
TXN0000006619,2024-04-03T04:37:56,ACC00006109,Transfer,802.13,-1268690.72,USD,Target
TXN0000006620,2024-01-02T15:15:35,ACC00003209,Payment,1168.09,-1269858.81,USD,Starbucks
TXN0000006621,2024-09-11T20:03:25,ACC00004407,ATM,1066.9,-1270925.71,JPY,Target
TXN0000006622,2024-08-02T05:14:39,ACC00007830,Credit,660.55,-1270265.16,USD,Shell
TXN0000006623,2024-02-12T06:51:32,ACC00009417,Payment,1058.6,-1271323.76,EUR,Target
TXN0000006624,2024-02-02T00:40:31,ACC00004793,Credit,1126.01,-1270197.75,JPY,Online Store
TXN0000006625,2024-08-01T18:00:11,ACC00005539,Payment,402.28,-1270600.03,EUR,Amazon
TXN0000006626,2024-02-01T07:03:52,ACC00006330,Transfer,1631.11,-1268968.92,EUR,Amazon
TXN0000006627,2024-09-14T03:16:05,ACC00009752,Transfer,1278.67,-1267690.25,USD,Shell
TXN0000006628,2024-06-14T20:13:16,ACC00000015,ATM,1492.9,-1269183.15,EUR,Grocery
TXN0000006629,2024-09-29T07:09:04,ACC00001340,Payment,462.7,-1269645.85,USD,Target
TXN0000006630,2024-12-13T19:00:56,ACC00005754,Payment,869.65,-1270515.5,GBP,Amazon
TXN0000006631,2024-01-30T20:37:17,ACC00004326,ATM,686.34,-1271201.84,EUR,Restaurant
TXN0000006632,2024-05-30T07:08:36,ACC00004397,Credit,1014.06,-1270187.78,JPY,Target
TXN0000006633,2024-03-29T02:54:21,ACC00009077,Debit,1080.92,-1271268.7,USD,Grocery
TXN0000006634,2024-10-29T10:02:03,ACC00000982,Transfer,1917.46,-1269351.24,JPY,Online Store
TXN0000006635,2024-10-16T04:03:10,ACC00001658,Transfer,1994.5,-1267356.74,JPY,Walmart
TXN0000006636,2024-11-02T22:57:25,ACC00008355,Payment,989.14,-1268345.88,USD,Walmart
TXN0000006637,2024-05-23T01:33:20,ACC00006502,ATM,1826.94,-1270172.82,USD,Target
TXN0000006638,2024-09-11T22:09:05,ACC00003977,Payment,362.02,-1270534.84,USD,Restaurant
TXN0000006639,2024-12-14T20:19:43,ACC00009203,Credit,1770.26,-1268764.58,USD,Amazon
TXN0000006640,2024-10-28T16:49:50,ACC00004927,Transfer,944.86,-1267819.72,EUR,Amazon
TXN0000006641,2024-06-18T19:46:29,ACC00004657,Credit,833.03,-1266986.69,JPY,Amazon
TXN0000006642,2024-04-14T11:31:44,ACC00001259,ATM,236.5,-1267223.19,EUR,Amazon
TXN0000006643,2024-06-05T23:20:26,ACC00008227,Transfer,23.05,-1267200.14,GBP,Starbucks
TXN0000006644,2024-11-13T22:02:23,ACC00009820,Payment,951.33,-1268151.47,USD,Amazon
TXN0000006645,2024-11-10T03:52:33,ACC00003253,Transfer,424.98,-1267726.49,EUR,Walmart
TXN0000006646,2024-10-19T23:26:42,ACC00000931,Debit,699.09,-1268425.58,JPY,Shell
TXN0000006647,2024-12-10T16:05:05,ACC00005156,Payment,1127.49,-1269553.07,GBP,Grocery
TXN0000006648,2024-05-14T15:55:43,ACC00008052,Payment,773.2,-1270326.27,JPY,Walmart
TXN0000006649,2024-07-21T15:34:10,ACC00005297,Transfer,370.89,-1269955.38,GBP,Online Store
TXN0000006650,2024-04-12T13:53:02,ACC00002293,Credit,1712.74,-1268242.64,GBP,Grocery
TXN0000006651,2024-06-10T02:32:23,ACC00003145,Credit,883.59,-1267359.05,EUR,Restaurant
TXN0000006652,2024-11-06T09:37:08,ACC00001018,Payment,1861.68,-1269220.73,JPY,Grocery
TXN0000006653,2024-03-30T17:49:21,ACC00002930,Debit,474.99,-1269695.72,USD,Amazon
TXN0000006654,2024-06-02T16:35:32,ACC00008498,Debit,978.54,-1270674.26,EUR,Grocery
TXN0000006655,2024-03-24T16:13:53,ACC00008399,Transfer,152.96,-1270521.3,EUR,Restaurant
TXN0000006656,2024-11-12T18:29:18,ACC00009098,Credit,1692.12,-1268829.18,GBP,Grocery
TXN0000006657,2024-10-30T11:33:49,ACC00007136,Debit,1240.51,-1270069.69,JPY,Walmart
TXN0000006658,2024-09-18T03:50:03,ACC00001797,ATM,499.34,-1270569.03,EUR,Restaurant
TXN0000006659,2024-06-03T08:44:37,ACC00001588,Credit,1482.7,-1269086.33,EUR,Walmart
TXN0000006660,2024-10-14T01:15:04,ACC00007657,ATM,928.11,-1270014.44,GBP,Restaurant
TXN0000006661,2024-09-13T11:02:29,ACC00003922,Transfer,1138.53,-1268875.91,GBP,Shell
TXN0000006662,2024-06-04T06:03:00,ACC00002203,ATM,1144.42,-1270020.33,USD,Shell
TXN0000006663,2024-12-09T04:04:03,ACC00001479,Debit,1107.24,-1271127.57,JPY,Starbucks
TXN0000006664,2024-09-26T13:41:38,ACC00007147,Debit,1052.63,-1272180.2,GBP,Amazon
TXN0000006665,2024-05-16T04:19:07,ACC00009619,Credit,1452.9,-1270727.3,USD,Shell
TXN0000006666,2024-08-29T07:16:07,ACC00006884,Transfer,1561.04,-1269166.26,USD,Online Store
TXN0000006667,2024-08-05T12:34:42,ACC00004996,Credit,1230.17,-1267936.09,EUR,Shell
TXN0000006668,2024-08-11T12:58:21,ACC00004505,Payment,187.01,-1268123.1,USD,Shell
TXN0000006669,2024-10-28T07:39:03,ACC00000852,Debit,1335.78,-1269458.88,JPY,Shell
TXN0000006670,2024-02-17T14:41:15,ACC00001351,Debit,1505.29,-1270964.17,JPY,Amazon
TXN0000006671,2024-06-18T02:51:48,ACC00003774,Payment,454.56,-1271418.73,JPY,Amazon
TXN0000006672,2024-03-12T07:51:40,ACC00001241,Credit,197.3,-1271221.43,USD,Walmart
TXN0000006673,2024-08-28T08:59:15,ACC00006443,Debit,1786.79,-1273008.22,GBP,Walmart
TXN0000006674,2024-04-04T22:27:10,ACC00006497,Debit,1267.77,-1274275.99,JPY,Amazon
TXN0000006675,2024-10-11T00:51:24,ACC00007244,Transfer,993.29,-1273282.7,USD,Grocery
TXN0000006676,2024-10-27T11:16:06,ACC00000666,Payment,464.65,-1273747.35,GBP,Shell
TXN0000006677,2024-11-26T15:49:15,ACC00004147,Payment,1126.57,-1274873.92,EUR,Online Store
TXN0000006678,2024-12-09T02:17:45,ACC00004922,Credit,415.24,-1274458.68,USD,Restaurant
TXN0000006679,2024-05-07T08:15:29,ACC00005705,Transfer,1075.93,-1273382.75,USD,Starbucks
TXN0000006680,2024-01-13T23:09:14,ACC00000097,Payment,472.75,-1273855.5,EUR,Target
TXN0000006681,2024-01-25T17:35:15,ACC00003593,ATM,1250.6,-1275106.1,EUR,Starbucks
TXN0000006682,2024-01-04T18:42:09,ACC00008551,Credit,1622.55,-1273483.55,JPY,Amazon
TXN0000006683,2024-02-24T02:17:44,ACC00000604,Debit,217.31,-1273700.86,USD,Target
TXN0000006684,2024-03-02T22:07:43,ACC00000393,Transfer,985.72,-1272715.14,USD,Starbucks
TXN0000006685,2024-04-14T16:01:00,ACC00002055,Debit,1045.41,-1273760.55,EUR,Online Store
TXN0000006686,2024-10-09T01:56:36,ACC00001878,Credit,1173.31,-1272587.24,USD,Target
TXN0000006687,2024-09-18T00:07:48,ACC00004000,ATM,774.41,-1273361.65,GBP,Restaurant
TXN0000006688,2024-01-27T14:53:58,ACC00005774,Transfer,1875.09,-1271486.56,EUR,Online Store
TXN0000006689,2024-05-16T08:18:55,ACC00008630,Payment,1533.63,-1273020.19,JPY,Target
TXN0000006690,2024-11-08T03:45:51,ACC00005581,ATM,672.8,-1273692.99,JPY,Target
TXN0000006691,2024-07-04T08:14:11,ACC00000474,Debit,149.03,-1273842.02,JPY,Grocery
TXN0000006692,2024-06-02T08:40:00,ACC00007276,Transfer,680.48,-1273161.54,USD,Amazon
TXN0000006693,2024-11-06T19:21:00,ACC00009870,ATM,465.48,-1273627.02,GBP,Amazon
TXN0000006694,2024-08-24T21:00:09,ACC00008351,ATM,174.83,-1273801.85,EUR,Target
TXN0000006695,2024-11-18T00:57:11,ACC00000844,ATM,442.48,-1274244.33,USD,Shell
TXN0000006696,2024-02-23T17:53:28,ACC00009649,ATM,1492.27,-1275736.6,GBP,Shell
TXN0000006697,2024-03-22T20:19:54,ACC00000840,Debit,145.43,-1275882.03,GBP,Walmart
TXN0000006698,2024-07-12T07:14:11,ACC00006683,Transfer,1723.39,-1274158.64,EUR,Online Store
TXN0000006699,2024-11-05T20:37:31,ACC00000022,Credit,1363.13,-1272795.51,GBP,Online Store
TXN0000006700,2024-11-27T22:20:58,ACC00006575,Payment,1251.4,-1274046.91,GBP,Walmart
TXN0000006701,2024-01-11T13:53:20,ACC00001561,Payment,1166.13,-1275213.04,JPY,Online Store
TXN0000006702,2024-11-16T01:04:38,ACC00006828,ATM,1351.93,-1276564.97,JPY,Starbucks
TXN0000006703,2024-10-26T05:04:33,ACC00007456,Transfer,1173.66,-1275391.31,USD,Walmart
TXN0000006704,2024-01-25T11:46:33,ACC00002394,ATM,1687.53,-1277078.84,GBP,Amazon
TXN0000006705,2024-05-25T20:09:02,ACC00001850,Payment,1674.01,-1278752.85,USD,Grocery
TXN0000006706,2024-10-17T03:05:01,ACC00007382,Credit,1077.64,-1277675.21,GBP,Shell
TXN0000006707,2024-03-21T19:34:38,ACC00002692,Debit,424.96,-1278100.17,EUR,Target
TXN0000006708,2024-07-28T07:52:14,ACC00006744,Transfer,963.95,-1277136.22,GBP,Online Store
TXN0000006709,2024-06-01T00:20:00,ACC00004981,Transfer,797.68,-1276338.54,JPY,Walmart
TXN0000006710,2024-04-28T22:40:41,ACC00001229,Debit,947.56,-1277286.1,GBP,Online Store
TXN0000006711,2024-09-16T19:24:10,ACC00009645,Transfer,649.04,-1276637.06,EUR,Restaurant
TXN0000006712,2024-04-04T05:04:01,ACC00001418,Payment,1923.07,-1278560.13,JPY,Target
TXN0000006713,2024-02-24T07:14:13,ACC00000806,Credit,1145.73,-1277414.4,GBP,Online Store
TXN0000006714,2024-10-08T20:57:00,ACC00006192,Transfer,667.2,-1276747.2,GBP,Amazon
TXN0000006715,2024-08-15T10:47:22,ACC00005325,Debit,392.51,-1277139.71,GBP,Grocery
TXN0000006716,2024-06-06T19:52:34,ACC00007600,Debit,1641.48,-1278781.19,USD,Shell
TXN0000006717,2024-01-16T04:14:36,ACC00001902,Transfer,1836.18,-1276945.01,GBP,Walmart
TXN0000006718,2024-04-16T08:55:01,ACC00007871,Credit,748.88,-1276196.13,GBP,Grocery
TXN0000006719,2024-07-01T15:14:25,ACC00003622,Debit,204.07,-1276400.2,GBP,Starbucks
TXN0000006720,2024-01-23T12:36:49,ACC00002381,ATM,310.91,-1276711.11,GBP,Restaurant
TXN0000006721,2024-05-08T21:01:59,ACC00001055,Debit,1459.66,-1278170.77,JPY,Grocery
TXN0000006722,2024-03-26T07:11:47,ACC00004964,Credit,1002.57,-1277168.2,GBP,Shell
TXN0000006723,2024-09-12T17:49:16,ACC00009526,Payment,1884.57,-1279052.77,EUR,Online Store
TXN0000006724,2024-09-26T21:23:17,ACC00005393,Transfer,719.54,-1278333.23,JPY,Online Store
TXN0000006725,2024-01-20T19:25:03,ACC00008842,ATM,1948.07,-1280281.3,JPY,Amazon
TXN0000006726,2024-03-10T08:52:00,ACC00003926,ATM,91.59,-1280372.89,EUR,Grocery
TXN0000006727,2024-08-27T08:46:04,ACC00004046,Debit,63.56,-1280436.45,GBP,Grocery
TXN0000006728,2024-06-05T07:52:39,ACC00002722,Debit,1361.19,-1281797.64,GBP,Amazon
TXN0000006729,2024-06-06T11:19:11,ACC00008246,Transfer,956.35,-1280841.29,GBP,Target
TXN0000006730,2024-09-19T05:30:45,ACC00002594,Transfer,1263.44,-1279577.85,EUR,Target
TXN0000006731,2024-10-04T03:14:46,ACC00008074,Debit,1065.77,-1280643.62,USD,Restaurant
TXN0000006732,2024-06-05T08:09:25,ACC00006119,Transfer,768.03,-1279875.59,USD,Online Store
TXN0000006733,2024-10-02T03:35:52,ACC00003416,Debit,212.99,-1280088.58,JPY,Shell
TXN0000006734,2024-12-11T02:02:30,ACC00008932,ATM,1964.73,-1282053.31,USD,Online Store
TXN0000006735,2024-03-14T11:41:18,ACC00001106,Debit,1793.37,-1283846.68,EUR,Amazon
TXN0000006736,2024-05-29T01:42:38,ACC00002875,Debit,732.45,-1284579.13,GBP,Target
TXN0000006737,2024-08-09T21:15:06,ACC00004155,Transfer,1211.63,-1283367.5,GBP,Amazon
TXN0000006738,2024-07-06T00:30:01,ACC00004684,Transfer,1271.44,-1282096.06,JPY,Amazon
TXN0000006739,2024-01-03T13:03:16,ACC00007423,Debit,1460.91,-1283556.97,GBP,Walmart
TXN0000006740,2024-06-23T20:21:52,ACC00009501,Credit,1284.37,-1282272.6,JPY,Walmart
TXN0000006741,2024-01-04T20:00:42,ACC00008888,Credit,1384.18,-1280888.42,EUR,Walmart
TXN0000006742,2024-06-11T06:54:03,ACC00005336,Credit,529.82,-1280358.6,JPY,Grocery
TXN0000006743,2024-01-12T06:06:36,ACC00003489,Debit,1241.31,-1281599.91,GBP,Walmart
TXN0000006744,2024-10-10T09:36:15,ACC00006149,ATM,1879.68,-1283479.59,JPY,Restaurant
TXN0000006745,2024-10-19T06:32:16,ACC00007323,ATM,726.35,-1284205.94,JPY,Grocery
TXN0000006746,2024-02-07T22:54:09,ACC00007517,Transfer,507.91,-1283698.03,GBP,Shell
TXN0000006747,2024-09-17T00:13:27,ACC00003311,Credit,918.68,-1282779.35,EUR,Online Store
TXN0000006748,2024-03-02T09:13:22,ACC00003911,Transfer,1155.28,-1281624.07,GBP,Amazon
TXN0000006749,2024-03-05T17:36:25,ACC00006849,Transfer,1309.59,-1280314.48,EUR,Starbucks
TXN0000006750,2024-08-23T18:23:39,ACC00000544,ATM,1505.94,-1281820.42,JPY,Restaurant
TXN0000006751,2024-08-12T22:24:28,ACC00006121,Payment,763.91,-1282584.33,GBP,Shell
TXN0000006752,2024-11-21T10:36:45,ACC00003809,Credit,545.71,-1282038.62,GBP,Target
TXN0000006753,2024-07-09T16:35:46,ACC00000293,Transfer,862.43,-1281176.19,GBP,Shell
TXN0000006754,2024-03-26T11:47:57,ACC00002038,ATM,633.94,-1281810.13,GBP,Target
TXN0000006755,2024-09-14T12:13:14,ACC00004690,Credit,69.86,-1281740.27,JPY,Starbucks
TXN0000006756,2024-06-07T07:54:24,ACC00005928,Payment,37.1,-1281777.37,JPY,Restaurant
TXN0000006757,2024-04-23T10:18:31,ACC00006038,Payment,1572.81,-1283350.18,GBP,Amazon
TXN0000006758,2024-05-11T10:34:35,ACC00007080,Credit,860.15,-1282490.03,USD,Amazon
TXN0000006759,2024-05-25T04:59:32,ACC00000752,Credit,1630.66,-1280859.37,EUR,Restaurant
TXN0000006760,2024-12-15T05:23:24,ACC00001372,Debit,561.94,-1281421.31,GBP,Target
TXN0000006761,2024-01-27T04:36:21,ACC00007619,Payment,1241.5,-1282662.81,JPY,Amazon
TXN0000006762,2024-06-03T11:35:09,ACC00008003,Transfer,1204.84,-1281457.97,JPY,Starbucks
TXN0000006763,2024-10-02T04:36:48,ACC00008864,Transfer,1534.02,-1279923.95,USD,Amazon
TXN0000006764,2024-07-22T14:01:32,ACC00008823,Credit,1468.73,-1278455.22,JPY,Restaurant
TXN0000006765,2024-09-25T15:09:44,ACC00005413,Credit,559.39,-1277895.83,GBP,Online Store
TXN0000006766,2024-04-27T08:36:03,ACC00000485,Transfer,927.03,-1276968.8,JPY,Shell
TXN0000006767,2024-01-16T03:25:04,ACC00009494,Payment,875.77,-1277844.57,EUR,Target
TXN0000006768,2024-03-19T14:26:32,ACC00004936,Credit,1018.33,-1276826.24,USD,Online Store
TXN0000006769,2024-06-30T03:38:42,ACC00005300,Credit,1246.26,-1275579.98,GBP,Restaurant
TXN0000006770,2024-05-12T20:34:40,ACC00005590,Credit,1807.16,-1273772.82,GBP,Shell
TXN0000006771,2024-12-25T03:25:25,ACC00006174,Credit,528.39,-1273244.43,EUR,Target
TXN0000006772,2024-02-24T05:10:53,ACC00004041,Credit,1971.22,-1271273.21,JPY,Target
TXN0000006773,2024-04-02T05:10:53,ACC00004861,Payment,1115.28,-1272388.49,GBP,Walmart
TXN0000006774,2024-04-01T11:56:06,ACC00006206,ATM,78.95,-1272467.44,EUR,Grocery
TXN0000006775,2024-05-16T07:50:35,ACC00003138,ATM,998.3,-1273465.74,USD,Target
TXN0000006776,2024-06-10T04:40:00,ACC00007386,Payment,512.1,-1273977.84,USD,Restaurant
TXN0000006777,2024-12-19T14:10:05,ACC00007014,ATM,848.93,-1274826.77,JPY,Walmart
TXN0000006778,2024-02-16T09:38:44,ACC00002650,Payment,652.4,-1275479.17,EUR,Online Store
TXN0000006779,2024-09-03T08:05:00,ACC00009789,Transfer,659.18,-1274819.99,EUR,Target
TXN0000006780,2024-04-03T07:37:46,ACC00008298,Payment,512.73,-1275332.72,GBP,Target
TXN0000006781,2024-02-17T02:43:46,ACC00000671,Credit,1972.12,-1273360.6,EUR,Amazon
TXN0000006782,2024-02-17T09:48:41,ACC00005810,ATM,838.22,-1274198.82,JPY,Restaurant
TXN0000006783,2024-03-03T01:09:05,ACC00007604,Transfer,913.06,-1273285.76,EUR,Starbucks
TXN0000006784,2024-09-12T11:11:21,ACC00004095,Payment,909.75,-1274195.51,GBP,Walmart
TXN0000006785,2024-06-15T03:58:09,ACC00005772,Transfer,116.63,-1274078.88,GBP,Restaurant
TXN0000006786,2024-09-02T14:05:22,ACC00006768,Debit,160.48,-1274239.36,JPY,Online Store
TXN0000006787,2024-03-31T13:06:14,ACC00000313,Payment,1058.47,-1275297.83,JPY,Online Store
TXN0000006788,2024-11-24T22:19:15,ACC00000907,Credit,1166.19,-1274131.64,JPY,Starbucks
TXN0000006789,2024-12-14T12:20:08,ACC00006511,Debit,602.6,-1274734.24,GBP,Online Store
TXN0000006790,2024-06-20T19:31:20,ACC00000878,Transfer,456.91,-1274277.33,GBP,Restaurant
TXN0000006791,2024-09-11T04:06:41,ACC00002574,Credit,1418.52,-1272858.81,USD,Starbucks
TXN0000006792,2024-05-11T00:36:42,ACC00004337,Payment,1764.17,-1274622.98,GBP,Starbucks
TXN0000006793,2024-09-10T17:56:05,ACC00004579,Transfer,1794.45,-1272828.53,USD,Target
TXN0000006794,2024-01-19T20:40:59,ACC00002811,Debit,1635.66,-1274464.19,EUR,Grocery
TXN0000006795,2024-12-12T17:32:06,ACC00001653,Credit,847.31,-1273616.88,EUR,Amazon
TXN0000006796,2024-10-12T08:42:20,ACC00001639,Payment,650.55,-1274267.43,USD,Grocery
TXN0000006797,2024-05-02T13:58:48,ACC00004567,Transfer,508.7,-1273758.73,GBP,Online Store
TXN0000006798,2024-08-05T04:31:18,ACC00004626,Payment,1134.21,-1274892.94,EUR,Target
TXN0000006799,2024-12-28T22:40:24,ACC00003115,Transfer,700.39,-1274192.55,USD,Shell
TXN0000006800,2024-03-31T02:07:18,ACC00008124,Debit,519.73,-1274712.28,EUR,Restaurant
TXN0000006801,2024-04-10T04:47:37,ACC00009536,Transfer,1384.05,-1273328.23,GBP,Restaurant
TXN0000006802,2024-10-31T10:07:54,ACC00006517,Transfer,1048.53,-1272279.7,GBP,Shell
TXN0000006803,2024-07-26T05:01:02,ACC00003869,ATM,643.29,-1272922.99,GBP,Shell
TXN0000006804,2024-07-16T12:00:36,ACC00008353,Transfer,485.56,-1272437.43,USD,Grocery
TXN0000006805,2024-11-04T23:54:43,ACC00004853,Transfer,1611.74,-1270825.69,EUR,Online Store
TXN0000006806,2024-05-18T01:39:41,ACC00005310,ATM,1252.67,-1272078.36,EUR,Shell
TXN0000006807,2024-08-07T23:38:05,ACC00002235,ATM,1211.4,-1273289.76,JPY,Restaurant
TXN0000006808,2024-04-26T21:29:29,ACC00004481,Debit,438.1,-1273727.86,GBP,Grocery
TXN0000006809,2024-09-21T17:20:34,ACC00008480,Payment,1929.22,-1275657.08,GBP,Walmart
TXN0000006810,2024-10-29T23:53:45,ACC00007096,Payment,310.54,-1275967.62,USD,Grocery
TXN0000006811,2024-08-06T04:35:20,ACC00001655,Transfer,1006.83,-1274960.79,EUR,Amazon
TXN0000006812,2024-12-18T21:24:48,ACC00004691,Debit,610.7,-1275571.49,USD,Target
TXN0000006813,2024-01-11T15:28:04,ACC00001646,Transfer,911.44,-1274660.05,GBP,Grocery
TXN0000006814,2024-10-08T04:36:51,ACC00005021,Transfer,381.67,-1274278.38,GBP,Online Store
TXN0000006815,2024-01-20T09:39:59,ACC00006292,Transfer,1665.46,-1272612.92,USD,Target
TXN0000006816,2024-08-06T09:15:38,ACC00003186,Transfer,1872.49,-1270740.43,USD,Online Store
TXN0000006817,2024-11-13T16:52:38,ACC00003384,Payment,1493.84,-1272234.27,GBP,Online Store
TXN0000006818,2024-09-08T21:03:31,ACC00004460,Transfer,642.9,-1271591.37,GBP,Walmart
TXN0000006819,2024-05-28T21:26:25,ACC00005952,Debit,1828.19,-1273419.56,USD,Shell
TXN0000006820,2024-01-20T06:11:51,ACC00001756,Credit,1721.23,-1271698.33,EUR,Online Store
TXN0000006821,2024-09-07T12:29:06,ACC00006274,Credit,1723.69,-1269974.64,GBP,Amazon
TXN0000006822,2024-11-07T17:26:41,ACC00008701,Payment,1931.4,-1271906.04,JPY,Restaurant
TXN0000006823,2024-09-12T17:28:44,ACC00006532,ATM,135.69,-1272041.73,JPY,Walmart
TXN0000006824,2024-06-06T07:33:02,ACC00008882,Debit,765.83,-1272807.56,EUR,Online Store
TXN0000006825,2024-12-26T15:03:26,ACC00004891,Credit,1282.0,-1271525.56,JPY,Restaurant
TXN0000006826,2024-10-11T12:28:57,ACC00000458,Transfer,518.36,-1271007.2,GBP,Shell
TXN0000006827,2024-04-04T14:45:36,ACC00006498,Payment,1985.78,-1272992.98,JPY,Walmart
TXN0000006828,2024-10-31T12:40:12,ACC00001986,ATM,600.31,-1273593.29,JPY,Target
TXN0000006829,2024-11-01T02:09:07,ACC00001688,ATM,85.45,-1273678.74,USD,Shell
TXN0000006830,2024-03-25T15:37:20,ACC00006950,Transfer,537.4,-1273141.34,JPY,Starbucks
TXN0000006831,2024-10-27T22:45:40,ACC00008294,Payment,1244.66,-1274386.0,GBP,Online Store
TXN0000006832,2024-07-05T06:08:50,ACC00005729,Transfer,581.26,-1273804.74,USD,Grocery
TXN0000006833,2024-05-18T07:45:57,ACC00005891,Debit,1365.09,-1275169.83,GBP,Amazon
TXN0000006834,2024-02-14T03:16:16,ACC00001668,Credit,1015.09,-1274154.74,GBP,Walmart
TXN0000006835,2024-10-16T09:02:09,ACC00006812,Credit,416.5,-1273738.24,EUR,Grocery
TXN0000006836,2024-03-02T06:27:28,ACC00000358,Debit,1118.19,-1274856.43,EUR,Grocery
TXN0000006837,2024-05-10T22:23:39,ACC00004666,Payment,1556.53,-1276412.96,USD,Grocery
TXN0000006838,2024-04-30T08:41:59,ACC00005391,Payment,1045.68,-1277458.64,JPY,Walmart
TXN0000006839,2024-12-15T13:11:46,ACC00005650,Credit,82.36,-1277376.28,JPY,Online Store
TXN0000006840,2024-10-18T11:21:01,ACC00004383,Credit,1761.75,-1275614.53,JPY,Shell
TXN0000006841,2024-02-04T06:07:39,ACC00002749,Payment,1932.44,-1277546.97,JPY,Starbucks
TXN0000006842,2024-02-21T18:34:17,ACC00004821,ATM,205.5,-1277752.47,EUR,Target
TXN0000006843,2024-02-15T22:42:31,ACC00006135,Payment,66.12,-1277818.59,USD,Target
TXN0000006844,2024-03-07T02:46:04,ACC00000228,Credit,473.47,-1277345.12,USD,Grocery
TXN0000006845,2024-02-10T04:51:38,ACC00008464,Transfer,1804.95,-1275540.17,EUR,Grocery
TXN0000006846,2024-07-15T00:15:00,ACC00006136,Credit,1269.7,-1274270.47,USD,Online Store
TXN0000006847,2024-12-27T08:09:06,ACC00006341,Debit,841.07,-1275111.54,EUR,Grocery
TXN0000006848,2024-12-03T10:06:00,ACC00002208,Debit,589.08,-1275700.62,GBP,Walmart
TXN0000006849,2024-10-06T18:07:08,ACC00003037,Debit,859.14,-1276559.76,JPY,Grocery
TXN0000006850,2024-04-20T10:28:28,ACC00005373,Transfer,1527.82,-1275031.94,JPY,Amazon
TXN0000006851,2024-05-31T14:53:44,ACC00005927,Debit,1252.5,-1276284.44,GBP,Shell
TXN0000006852,2024-01-12T13:41:55,ACC00007708,Debit,273.85,-1276558.29,JPY,Online Store
TXN0000006853,2024-08-24T13:56:28,ACC00003742,Debit,651.45,-1277209.74,JPY,Restaurant
TXN0000006854,2024-10-23T22:46:00,ACC00002708,Transfer,915.99,-1276293.75,JPY,Amazon
TXN0000006855,2024-07-26T00:19:08,ACC00004831,Debit,262.25,-1276556.0,USD,Walmart
TXN0000006856,2024-05-14T06:12:26,ACC00009655,Transfer,1375.12,-1275180.88,GBP,Grocery
TXN0000006857,2024-04-23T15:32:42,ACC00008547,Credit,1284.11,-1273896.77,USD,Online Store
TXN0000006858,2024-05-28T16:25:39,ACC00000363,Transfer,956.77,-1272940.0,USD,Restaurant
TXN0000006859,2024-08-09T07:55:05,ACC00007657,Payment,1911.38,-1274851.38,JPY,Restaurant
TXN0000006860,2024-11-27T03:57:57,ACC00002407,ATM,1368.2,-1276219.58,USD,Online Store
TXN0000006861,2024-07-17T15:50:48,ACC00002984,Transfer,1058.54,-1275161.04,GBP,Starbucks
TXN0000006862,2024-01-03T05:08:17,ACC00005831,ATM,1244.6,-1276405.64,JPY,Walmart
TXN0000006863,2024-09-14T10:01:12,ACC00001964,Debit,400.86,-1276806.5,JPY,Restaurant
TXN0000006864,2024-10-19T17:31:54,ACC00008037,Transfer,898.32,-1275908.18,GBP,Grocery
TXN0000006865,2024-05-27T05:09:30,ACC00002271,ATM,1658.31,-1277566.49,EUR,Walmart
TXN0000006866,2024-09-23T08:42:56,ACC00005882,Transfer,991.86,-1276574.63,USD,Restaurant
TXN0000006867,2024-03-12T23:52:17,ACC00009479,ATM,124.58,-1276699.21,JPY,Amazon
TXN0000006868,2024-04-16T10:40:02,ACC00004137,Payment,299.32,-1276998.53,JPY,Grocery
TXN0000006869,2024-07-03T18:34:29,ACC00009462,Debit,1244.21,-1278242.74,USD,Target
TXN0000006870,2024-02-28T22:59:38,ACC00008056,Credit,1227.31,-1277015.43,EUR,Shell
TXN0000006871,2024-08-17T22:43:22,ACC00001511,Debit,700.73,-1277716.16,USD,Target
TXN0000006872,2024-09-14T04:07:55,ACC00005207,Payment,957.47,-1278673.63,JPY,Walmart
TXN0000006873,2024-01-31T09:30:15,ACC00009439,Payment,813.47,-1279487.1,USD,Online Store
TXN0000006874,2024-08-07T22:44:38,ACC00004751,Debit,579.06,-1280066.16,EUR,Target
TXN0000006875,2024-09-06T15:33:04,ACC00001793,Transfer,1408.8,-1278657.36,USD,Target
TXN0000006876,2024-12-08T19:38:25,ACC00001902,Credit,1961.89,-1276695.47,GBP,Starbucks
TXN0000006877,2024-11-01T01:22:01,ACC00003658,Payment,526.63,-1277222.1,EUR,Amazon
TXN0000006878,2024-09-10T11:38:35,ACC00002638,ATM,1530.49,-1278752.59,GBP,Grocery
TXN0000006879,2024-08-04T14:12:57,ACC00007947,Transfer,1819.72,-1276932.87,USD,Walmart
TXN0000006880,2024-04-10T05:36:25,ACC00006340,ATM,1374.05,-1278306.92,JPY,Grocery
TXN0000006881,2024-07-29T06:59:07,ACC00008846,Payment,508.33,-1278815.25,EUR,Online Store
TXN0000006882,2024-08-23T08:57:17,ACC00007810,Debit,904.25,-1279719.5,GBP,Shell
TXN0000006883,2024-12-30T01:24:18,ACC00007278,Payment,856.55,-1280576.05,GBP,Target
TXN0000006884,2024-11-04T16:51:54,ACC00004472,Transfer,1147.15,-1279428.9,EUR,Amazon
TXN0000006885,2024-08-15T14:49:16,ACC00004361,Credit,812.82,-1278616.08,JPY,Amazon
TXN0000006886,2024-05-08T13:05:43,ACC00002973,Payment,1674.81,-1280290.89,GBP,Walmart
TXN0000006887,2024-04-16T14:32:34,ACC00003453,Payment,48.48,-1280339.37,JPY,Starbucks
TXN0000006888,2024-09-17T07:22:13,ACC00002229,Transfer,237.11,-1280102.26,JPY,Starbucks
TXN0000006889,2024-08-18T19:43:46,ACC00001932,ATM,1540.8,-1281643.06,EUR,Online Store
TXN0000006890,2024-03-24T07:07:34,ACC00000870,Debit,419.53,-1282062.59,EUR,Starbucks
TXN0000006891,2024-10-10T03:25:24,ACC00002423,Credit,690.58,-1281372.01,GBP,Shell
TXN0000006892,2024-01-10T15:20:49,ACC00001006,Payment,1909.14,-1283281.15,EUR,Walmart
TXN0000006893,2024-03-11T16:41:25,ACC00009835,Payment,1910.11,-1285191.26,USD,Shell
TXN0000006894,2024-05-05T07:29:24,ACC00008271,Credit,476.56,-1284714.7,USD,Grocery
TXN0000006895,2024-11-22T02:33:10,ACC00005577,ATM,664.23,-1285378.93,EUR,Target
TXN0000006896,2024-07-05T14:53:37,ACC00001476,Payment,669.32,-1286048.25,EUR,Online Store
TXN0000006897,2024-01-22T11:33:18,ACC00001103,Payment,802.17,-1286850.42,JPY,Starbucks
TXN0000006898,2024-01-06T10:24:41,ACC00009749,Payment,1515.01,-1288365.43,USD,Online Store
TXN0000006899,2024-11-18T21:57:42,ACC00003250,Payment,810.87,-1289176.3,JPY,Target
TXN0000006900,2024-12-13T06:49:48,ACC00000330,Credit,195.26,-1288981.04,JPY,Target
TXN0000006901,2024-02-17T13:23:49,ACC00000602,Credit,866.8,-1288114.24,USD,Walmart
TXN0000006902,2024-03-28T11:44:55,ACC00005533,Debit,349.65,-1288463.89,JPY,Online Store
TXN0000006903,2024-11-24T09:03:50,ACC00000682,Debit,71.58,-1288535.47,GBP,Amazon
TXN0000006904,2024-09-08T01:16:38,ACC00004114,Debit,431.87,-1288967.34,EUR,Walmart
TXN0000006905,2024-04-02T16:21:29,ACC00001126,Credit,407.25,-1288560.09,USD,Amazon
TXN0000006906,2024-12-04T19:20:14,ACC00007182,Credit,911.51,-1287648.58,EUR,Target
TXN0000006907,2024-05-10T01:30:47,ACC00004807,ATM,411.31,-1288059.89,JPY,Grocery
TXN0000006908,2024-01-06T01:37:59,ACC00001865,Credit,1936.28,-1286123.61,EUR,Online Store
TXN0000006909,2024-01-05T10:03:37,ACC00001885,Payment,1541.19,-1287664.8,JPY,Online Store
TXN0000006910,2024-07-02T14:08:08,ACC00001774,Credit,121.19,-1287543.61,GBP,Restaurant
TXN0000006911,2024-08-16T05:42:43,ACC00005654,Transfer,1807.48,-1285736.13,JPY,Target
TXN0000006912,2024-02-09T20:49:09,ACC00007528,Credit,1997.03,-1283739.1,USD,Amazon
TXN0000006913,2024-07-14T02:02:06,ACC00002145,Transfer,1246.59,-1282492.51,GBP,Grocery
TXN0000006914,2024-06-27T18:58:39,ACC00001390,ATM,1054.32,-1283546.83,USD,Walmart
TXN0000006915,2024-10-23T17:59:09,ACC00007698,Payment,1149.12,-1284695.95,GBP,Online Store
TXN0000006916,2024-05-20T19:44:14,ACC00001093,Debit,1837.89,-1286533.84,USD,Target
TXN0000006917,2024-05-27T19:23:52,ACC00004457,Payment,1854.04,-1288387.88,USD,Grocery
TXN0000006918,2024-09-22T13:35:03,ACC00005917,Payment,337.78,-1288725.66,GBP,Amazon
TXN0000006919,2024-12-06T02:10:01,ACC00008678,Credit,1356.75,-1287368.91,USD,Online Store
TXN0000006920,2024-06-11T18:24:54,ACC00009997,Transfer,1820.05,-1285548.86,USD,Starbucks
TXN0000006921,2024-05-02T08:19:37,ACC00007648,Debit,1889.2,-1287438.06,JPY,Walmart
TXN0000006922,2024-07-09T20:15:35,ACC00002032,Payment,684.6,-1288122.66,GBP,Starbucks
TXN0000006923,2024-09-20T09:33:06,ACC00008888,Payment,1816.36,-1289939.02,GBP,Shell
TXN0000006924,2024-11-20T16:50:46,ACC00003742,ATM,1215.85,-1291154.87,GBP,Walmart
TXN0000006925,2024-10-21T22:35:15,ACC00006834,Credit,102.52,-1291052.35,EUR,Grocery
TXN0000006926,2024-02-02T22:22:58,ACC00000615,Credit,607.13,-1290445.22,EUR,Starbucks
TXN0000006927,2024-05-11T05:33:16,ACC00004095,Debit,221.28,-1290666.5,JPY,Walmart
TXN0000006928,2024-04-10T00:03:16,ACC00000701,Credit,1064.92,-1289601.58,GBP,Walmart
TXN0000006929,2024-03-16T10:16:31,ACC00001953,Transfer,511.05,-1289090.53,GBP,Grocery
TXN0000006930,2024-01-30T15:36:18,ACC00001618,ATM,878.05,-1289968.58,USD,Online Store
TXN0000006931,2024-05-19T18:21:28,ACC00003679,Credit,294.54,-1289674.04,USD,Online Store
TXN0000006932,2024-05-15T00:39:18,ACC00005207,Transfer,265.46,-1289408.58,JPY,Walmart
TXN0000006933,2024-02-24T15:54:12,ACC00000419,Debit,136.37,-1289544.95,GBP,Restaurant
TXN0000006934,2024-08-23T02:31:09,ACC00002333,Transfer,1908.99,-1287635.96,JPY,Shell
TXN0000006935,2024-10-27T01:39:06,ACC00002932,ATM,1187.03,-1288822.99,USD,Restaurant
TXN0000006936,2024-12-22T13:11:40,ACC00004162,Transfer,1255.21,-1287567.78,GBP,Amazon
TXN0000006937,2024-01-21T12:12:56,ACC00000661,ATM,1163.3,-1288731.08,GBP,Amazon
TXN0000006938,2024-12-22T17:07:55,ACC00007321,ATM,1647.18,-1290378.26,USD,Restaurant
TXN0000006939,2024-08-22T18:22:48,ACC00005491,Credit,1632.36,-1288745.9,GBP,Starbucks
TXN0000006940,2024-10-30T07:01:33,ACC00005076,Payment,1939.42,-1290685.32,JPY,Restaurant
TXN0000006941,2024-08-04T05:55:17,ACC00008955,Debit,821.1,-1291506.42,JPY,Restaurant
TXN0000006942,2024-02-16T06:46:40,ACC00007923,Payment,70.43,-1291576.85,JPY,Walmart
TXN0000006943,2024-02-18T21:33:13,ACC00004574,Payment,1636.7,-1293213.55,USD,Starbucks
TXN0000006944,2024-11-08T06:00:51,ACC00007431,Credit,1735.75,-1291477.8,EUR,Restaurant
TXN0000006945,2024-05-10T14:52:42,ACC00005936,ATM,1753.48,-1293231.28,USD,Starbucks
TXN0000006946,2024-01-19T08:15:05,ACC00000544,Payment,1186.64,-1294417.92,EUR,Online Store
TXN0000006947,2024-03-01T09:15:00,ACC00007686,Transfer,1383.01,-1293034.91,JPY,Amazon
TXN0000006948,2024-07-10T20:39:30,ACC00005174,ATM,860.23,-1293895.14,EUR,Shell
TXN0000006949,2024-06-19T11:29:46,ACC00000036,Payment,554.95,-1294450.09,USD,Grocery
TXN0000006950,2024-01-15T21:32:28,ACC00005374,Debit,1215.4,-1295665.49,JPY,Starbucks
TXN0000006951,2024-04-13T09:28:18,ACC00009781,Debit,1817.22,-1297482.71,JPY,Amazon
TXN0000006952,2024-08-14T01:50:01,ACC00000295,Credit,1386.65,-1296096.06,GBP,Restaurant
TXN0000006953,2024-05-16T07:46:32,ACC00002250,Debit,781.33,-1296877.39,EUR,Grocery
TXN0000006954,2024-12-12T20:57:24,ACC00003622,ATM,1967.79,-1298845.18,GBP,Restaurant
TXN0000006955,2024-07-10T10:30:22,ACC00008627,Transfer,1592.15,-1297253.03,JPY,Target
TXN0000006956,2024-04-18T09:48:04,ACC00005549,Debit,1343.34,-1298596.37,EUR,Walmart
TXN0000006957,2024-09-17T09:39:43,ACC00008529,Payment,1009.74,-1299606.11,USD,Online Store
TXN0000006958,2024-02-03T08:19:28,ACC00009474,ATM,504.54,-1300110.65,EUR,Target
TXN0000006959,2024-03-01T00:56:44,ACC00006700,ATM,1425.75,-1301536.4,USD,Target
TXN0000006960,2024-08-16T20:33:04,ACC00009696,Transfer,1587.34,-1299949.06,JPY,Online Store
TXN0000006961,2024-06-08T21:23:34,ACC00001650,Transfer,417.91,-1299531.15,GBP,Grocery
TXN0000006962,2024-02-28T03:16:21,ACC00005721,ATM,1886.9,-1301418.05,JPY,Shell
TXN0000006963,2024-01-30T11:02:35,ACC00000582,Payment,404.9,-1301822.95,GBP,Target
TXN0000006964,2024-09-22T06:06:10,ACC00009151,Debit,969.52,-1302792.47,USD,Online Store
TXN0000006965,2024-04-16T12:46:42,ACC00007129,Debit,384.01,-1303176.48,USD,Starbucks
TXN0000006966,2024-02-21T05:31:39,ACC00006798,Transfer,1823.69,-1301352.79,EUR,Target
TXN0000006967,2024-10-05T00:53:51,ACC00004338,Debit,1554.62,-1302907.41,EUR,Amazon
TXN0000006968,2024-06-08T09:27:06,ACC00006675,Transfer,435.63,-1302471.78,USD,Restaurant
TXN0000006969,2024-11-03T12:02:52,ACC00006402,Debit,817.08,-1303288.86,USD,Starbucks
TXN0000006970,2024-11-05T07:06:48,ACC00001766,Transfer,1225.48,-1302063.38,GBP,Online Store
TXN0000006971,2024-05-22T03:16:39,ACC00008499,Transfer,150.36,-1301913.02,USD,Amazon
TXN0000006972,2024-12-07T12:33:46,ACC00004417,Payment,1441.3,-1303354.32,EUR,Grocery
TXN0000006973,2024-01-05T21:31:01,ACC00002078,ATM,1742.69,-1305097.01,GBP,Grocery
TXN0000006974,2024-02-05T20:06:58,ACC00007377,Debit,358.01,-1305455.02,JPY,Grocery
TXN0000006975,2024-01-11T04:48:08,ACC00005857,ATM,1438.8,-1306893.82,GBP,Shell
TXN0000006976,2024-02-28T04:00:53,ACC00001250,ATM,679.34,-1307573.16,GBP,Target
TXN0000006977,2024-10-24T21:32:44,ACC00003810,Payment,1623.9,-1309197.06,JPY,Online Store
TXN0000006978,2024-04-30T17:13:25,ACC00005991,Transfer,1402.46,-1307794.6,JPY,Target
TXN0000006979,2024-08-04T02:01:52,ACC00009843,Transfer,166.19,-1307628.41,GBP,Target
TXN0000006980,2024-12-30T16:27:47,ACC00007380,Transfer,376.34,-1307252.07,JPY,Target
TXN0000006981,2024-04-23T03:58:09,ACC00003420,Payment,1353.18,-1308605.25,EUR,Restaurant
TXN0000006982,2024-11-27T01:34:11,ACC00002529,Transfer,814.39,-1307790.86,JPY,Target
TXN0000006983,2024-05-30T20:15:55,ACC00006995,Credit,1061.67,-1306729.19,JPY,Starbucks
TXN0000006984,2024-08-19T12:01:01,ACC00008675,Transfer,910.69,-1305818.5,JPY,Shell
TXN0000006985,2024-01-06T03:51:54,ACC00007826,Debit,1220.34,-1307038.84,GBP,Grocery
TXN0000006986,2024-05-24T04:23:03,ACC00004563,Debit,49.05,-1307087.89,GBP,Starbucks
TXN0000006987,2024-04-21T11:10:53,ACC00001769,Payment,1899.72,-1308987.61,GBP,Starbucks
TXN0000006988,2024-12-09T00:42:26,ACC00006344,Credit,1405.12,-1307582.49,USD,Starbucks
TXN0000006989,2024-11-29T03:27:33,ACC00007516,Payment,627.45,-1308209.94,USD,Walmart
TXN0000006990,2024-10-04T08:14:27,ACC00004990,Transfer,790.52,-1307419.42,EUR,Grocery
TXN0000006991,2024-04-29T09:34:22,ACC00007839,Credit,838.51,-1306580.91,USD,Walmart
TXN0000006992,2024-07-01T01:49:20,ACC00004860,ATM,501.68,-1307082.59,GBP,Restaurant
TXN0000006993,2024-01-29T02:10:57,ACC00000936,Debit,1398.05,-1308480.64,EUR,Starbucks
TXN0000006994,2024-05-27T16:27:49,ACC00004404,ATM,365.18,-1308845.82,EUR,Shell
TXN0000006995,2024-07-11T07:00:39,ACC00007721,Payment,447.62,-1309293.44,EUR,Target
TXN0000006996,2024-06-02T16:14:35,ACC00006301,Transfer,448.53,-1308844.91,GBP,Walmart
TXN0000006997,2024-11-05T19:11:28,ACC00007485,Debit,888.38,-1309733.29,JPY,Online Store
TXN0000006998,2024-05-16T10:18:03,ACC00002002,Debit,1337.97,-1311071.26,GBP,Restaurant
TXN0000006999,2024-02-21T20:36:18,ACC00000729,Payment,42.29,-1311113.55,GBP,Target
TXN0000007000,2024-07-21T06:56:38,ACC00007108,Credit,124.26,-1310989.29,EUR,Walmart
TXN0000007001,2024-04-25T07:18:22,ACC00005172,Debit,830.62,-1311819.91,USD,Grocery
TXN0000007002,2024-02-03T22:18:24,ACC00006932,Transfer,1309.21,-1310510.7,GBP,Online Store
TXN0000007003,2024-06-16T15:51:24,ACC00000423,Credit,1568.76,-1308941.94,EUR,Starbucks
TXN0000007004,2024-01-11T15:54:43,ACC00001379,Debit,857.88,-1309799.82,USD,Online Store
TXN0000007005,2024-03-13T12:58:38,ACC00003358,Transfer,831.61,-1308968.21,GBP,Grocery
TXN0000007006,2024-02-23T00:44:36,ACC00001491,ATM,387.08,-1309355.29,USD,Target
TXN0000007007,2024-09-05T05:07:54,ACC00002772,Transfer,1408.26,-1307947.03,JPY,Shell
TXN0000007008,2024-05-01T15:23:07,ACC00003674,Transfer,495.56,-1307451.47,JPY,Starbucks
TXN0000007009,2024-08-06T05:47:08,ACC00005696,ATM,1162.61,-1308614.08,JPY,Grocery
TXN0000007010,2024-07-04T17:38:01,ACC00000359,Credit,969.19,-1307644.89,USD,Grocery
TXN0000007011,2024-04-03T18:24:48,ACC00001543,Transfer,1618.87,-1306026.02,USD,Restaurant
TXN0000007012,2024-12-01T07:44:42,ACC00001631,Transfer,1376.81,-1304649.21,GBP,Starbucks
TXN0000007013,2024-05-31T00:29:46,ACC00004016,ATM,114.87,-1304764.08,USD,Walmart
TXN0000007014,2024-06-21T07:42:53,ACC00003082,Payment,747.62,-1305511.7,USD,Target
TXN0000007015,2024-08-29T05:43:31,ACC00008775,ATM,1940.21,-1307451.91,JPY,Shell
TXN0000007016,2024-01-01T12:41:43,ACC00002818,Payment,538.85,-1307990.76,JPY,Shell
TXN0000007017,2024-04-08T08:06:18,ACC00008523,Payment,60.14,-1308050.9,JPY,Amazon
TXN0000007018,2024-09-16T23:05:41,ACC00001921,ATM,1730.5,-1309781.4,JPY,Grocery
TXN0000007019,2024-01-28T08:07:12,ACC00002676,Credit,1373.51,-1308407.89,USD,Walmart
TXN0000007020,2024-06-08T12:16:03,ACC00008624,ATM,186.77,-1308594.66,GBP,Walmart
TXN0000007021,2024-09-05T19:14:44,ACC00008999,Payment,10.05,-1308604.71,GBP,Grocery
TXN0000007022,2024-08-13T14:24:08,ACC00001000,Transfer,1555.21,-1307049.5,GBP,Online Store
TXN0000007023,2024-05-28T04:16:25,ACC00004420,Debit,1578.54,-1308628.04,USD,Grocery
TXN0000007024,2024-01-09T01:04:52,ACC00007527,Credit,646.13,-1307981.91,EUR,Walmart
TXN0000007025,2024-04-18T05:24:11,ACC00000866,Payment,494.29,-1308476.2,USD,Restaurant
TXN0000007026,2024-11-23T19:47:38,ACC00002861,Transfer,1033.93,-1307442.27,GBP,Walmart
TXN0000007027,2024-01-22T12:11:37,ACC00000385,Payment,387.85,-1307830.12,GBP,Starbucks
TXN0000007028,2024-09-20T15:56:04,ACC00002607,Credit,411.89,-1307418.23,JPY,Target
TXN0000007029,2024-04-21T21:39:55,ACC00004961,Transfer,1514.15,-1305904.08,JPY,Walmart
TXN0000007030,2024-08-30T05:29:45,ACC00003743,Payment,172.02,-1306076.1,EUR,Amazon
TXN0000007031,2024-05-29T16:38:45,ACC00005149,Payment,486.85,-1306562.95,EUR,Target
TXN0000007032,2024-11-16T23:50:29,ACC00004081,Credit,1626.0,-1304936.95,EUR,Shell
TXN0000007033,2024-04-16T16:49:33,ACC00008882,ATM,1105.05,-1306042.0,GBP,Amazon
TXN0000007034,2024-03-08T01:42:52,ACC00005931,Debit,1654.5,-1307696.5,USD,Starbucks
TXN0000007035,2024-09-11T04:33:39,ACC00005876,Transfer,1631.11,-1306065.39,GBP,Starbucks
TXN0000007036,2024-12-11T07:23:07,ACC00007276,ATM,401.91,-1306467.3,EUR,Starbucks
TXN0000007037,2024-11-05T03:49:13,ACC00005035,Debit,21.21,-1306488.51,JPY,Shell
TXN0000007038,2024-03-21T05:25:18,ACC00005670,Debit,1566.12,-1308054.63,EUR,Starbucks
TXN0000007039,2024-02-11T13:10:50,ACC00004104,Payment,1273.86,-1309328.49,USD,Walmart
TXN0000007040,2024-08-27T06:19:09,ACC00004370,ATM,717.43,-1310045.92,EUR,Online Store
TXN0000007041,2024-10-16T00:36:55,ACC00005877,Payment,84.33,-1310130.25,EUR,Shell
TXN0000007042,2024-09-17T04:31:45,ACC00008843,Credit,1893.68,-1308236.57,GBP,Amazon
TXN0000007043,2024-10-17T20:32:39,ACC00002989,Transfer,1996.35,-1306240.22,JPY,Shell
TXN0000007044,2024-01-20T20:39:19,ACC00003024,Payment,1673.65,-1307913.87,JPY,Restaurant
TXN0000007045,2024-06-06T17:07:16,ACC00001353,Payment,1455.14,-1309369.01,JPY,Starbucks
TXN0000007046,2024-08-26T09:34:35,ACC00000119,Credit,675.22,-1308693.79,EUR,Online Store
TXN0000007047,2024-08-25T14:58:22,ACC00000229,ATM,1276.35,-1309970.14,EUR,Walmart
TXN0000007048,2024-06-21T19:30:26,ACC00005007,Credit,16.47,-1309953.67,JPY,Target
TXN0000007049,2024-03-14T15:32:57,ACC00007653,ATM,1776.01,-1311729.68,GBP,Grocery
TXN0000007050,2024-03-27T00:17:54,ACC00005233,Payment,1209.68,-1312939.36,GBP,Amazon
TXN0000007051,2024-01-26T04:17:38,ACC00002834,Payment,1719.82,-1314659.18,EUR,Target
TXN0000007052,2024-10-12T07:43:28,ACC00001962,Payment,1742.22,-1316401.4,EUR,Walmart
TXN0000007053,2024-09-17T03:16:59,ACC00005469,Debit,294.1,-1316695.5,GBP,Amazon
TXN0000007054,2024-11-05T13:38:08,ACC00002156,Credit,226.98,-1316468.52,EUR,Restaurant
TXN0000007055,2024-11-07T08:23:30,ACC00006519,Transfer,1889.52,-1314579.0,GBP,Online Store
TXN0000007056,2024-07-25T16:14:40,ACC00003000,Debit,693.39,-1315272.39,GBP,Starbucks
TXN0000007057,2024-12-18T00:34:27,ACC00002563,Credit,1504.81,-1313767.58,JPY,Grocery
TXN0000007058,2024-10-16T23:15:49,ACC00004891,Payment,1906.23,-1315673.81,GBP,Grocery
TXN0000007059,2024-08-05T14:11:35,ACC00002607,Credit,86.24,-1315587.57,JPY,Walmart
TXN0000007060,2024-09-26T14:21:00,ACC00002457,Payment,952.58,-1316540.15,USD,Shell
TXN0000007061,2024-06-23T17:26:07,ACC00002832,ATM,1485.3,-1318025.45,JPY,Grocery
TXN0000007062,2024-08-03T22:27:54,ACC00005923,Credit,285.11,-1317740.34,EUR,Amazon
TXN0000007063,2024-04-06T20:00:37,ACC00006840,Debit,705.29,-1318445.63,JPY,Restaurant
TXN0000007064,2024-06-10T15:53:41,ACC00006832,Transfer,1581.76,-1316863.87,JPY,Starbucks
TXN0000007065,2024-06-09T19:37:34,ACC00000128,ATM,1252.82,-1318116.69,GBP,Restaurant
TXN0000007066,2024-12-26T17:08:40,ACC00009997,Credit,1637.6,-1316479.09,JPY,Online Store
TXN0000007067,2024-03-19T02:53:50,ACC00006478,Credit,937.16,-1315541.93,GBP,Shell
TXN0000007068,2024-05-08T06:53:28,ACC00001147,Transfer,682.14,-1314859.79,EUR,Restaurant
TXN0000007069,2024-10-09T12:14:19,ACC00003982,Debit,1985.65,-1316845.44,EUR,Online Store
TXN0000007070,2024-03-12T10:15:08,ACC00008402,Debit,1864.42,-1318709.86,GBP,Shell
TXN0000007071,2024-11-04T19:07:01,ACC00009735,Transfer,968.48,-1317741.38,JPY,Restaurant
TXN0000007072,2024-11-30T10:19:23,ACC00008889,Debit,1473.84,-1319215.22,EUR,Target
TXN0000007073,2024-01-22T11:56:22,ACC00003283,Payment,1013.97,-1320229.19,GBP,Amazon
TXN0000007074,2024-10-02T18:33:47,ACC00006049,Transfer,1048.68,-1319180.51,JPY,Starbucks
TXN0000007075,2024-10-23T21:24:29,ACC00007536,Credit,1757.9,-1317422.61,GBP,Starbucks
TXN0000007076,2024-08-15T14:04:13,ACC00004563,Credit,1843.18,-1315579.43,USD,Amazon
TXN0000007077,2024-02-17T08:37:27,ACC00004757,Credit,1702.0,-1313877.43,JPY,Restaurant
TXN0000007078,2024-07-26T12:20:55,ACC00008558,ATM,1223.7,-1315101.13,JPY,Shell
TXN0000007079,2024-02-01T15:02:50,ACC00004829,Payment,388.49,-1315489.62,GBP,Online Store
TXN0000007080,2024-10-07T23:43:14,ACC00003284,Payment,1427.28,-1316916.9,GBP,Target
TXN0000007081,2024-03-12T17:54:29,ACC00000913,Transfer,1991.32,-1314925.58,USD,Starbucks
TXN0000007082,2024-01-16T10:16:05,ACC00000973,Debit,822.33,-1315747.91,EUR,Grocery
TXN0000007083,2024-06-28T06:04:53,ACC00005143,Transfer,1751.77,-1313996.14,JPY,Starbucks
TXN0000007084,2024-09-30T16:29:30,ACC00005528,Payment,1608.65,-1315604.79,GBP,Grocery
TXN0000007085,2024-06-13T03:36:26,ACC00001203,Debit,537.31,-1316142.1,GBP,Starbucks
TXN0000007086,2024-10-12T00:35:53,ACC00003323,Credit,1454.2,-1314687.9,USD,Amazon
TXN0000007087,2024-10-18T18:38:03,ACC00007963,Payment,1582.61,-1316270.51,USD,Online Store
TXN0000007088,2024-02-22T17:44:53,ACC00004738,Debit,1561.14,-1317831.65,USD,Amazon
TXN0000007089,2024-05-30T14:43:39,ACC00009037,Credit,1693.79,-1316137.86,EUR,Shell
TXN0000007090,2024-04-09T17:47:55,ACC00007918,Transfer,1984.21,-1314153.65,GBP,Shell
TXN0000007091,2024-09-14T17:45:52,ACC00001629,Payment,1752.63,-1315906.28,GBP,Grocery
TXN0000007092,2024-10-28T19:20:36,ACC00001106,Credit,126.54,-1315779.74,USD,Restaurant
TXN0000007093,2024-11-10T18:09:05,ACC00004308,ATM,666.47,-1316446.21,JPY,Restaurant
TXN0000007094,2024-08-28T06:30:06,ACC00003647,Credit,222.28,-1316223.93,JPY,Starbucks
TXN0000007095,2024-02-20T11:33:12,ACC00004168,Debit,613.0,-1316836.93,GBP,Target
TXN0000007096,2024-08-15T10:09:21,ACC00006161,ATM,1553.6,-1318390.53,JPY,Restaurant
TXN0000007097,2024-04-28T12:04:45,ACC00002579,Payment,1298.44,-1319688.97,EUR,Target
TXN0000007098,2024-01-15T09:38:42,ACC00006818,ATM,1597.35,-1321286.32,GBP,Online Store
TXN0000007099,2024-09-11T14:22:21,ACC00005844,Credit,1614.86,-1319671.46,GBP,Restaurant
TXN0000007100,2024-02-09T21:36:00,ACC00007989,Payment,1376.78,-1321048.24,GBP,Starbucks
TXN0000007101,2024-07-01T03:12:20,ACC00006279,Transfer,1424.02,-1319624.22,GBP,Target
TXN0000007102,2024-05-28T15:43:04,ACC00002031,Transfer,1683.9,-1317940.32,GBP,Walmart
TXN0000007103,2024-12-29T11:00:27,ACC00007281,Transfer,1645.68,-1316294.64,JPY,Amazon
TXN0000007104,2024-05-19T07:48:39,ACC00008806,Credit,1526.54,-1314768.1,GBP,Target
TXN0000007105,2024-08-06T16:23:59,ACC00002223,ATM,1703.59,-1316471.69,EUR,Online Store
TXN0000007106,2024-12-10T08:03:18,ACC00000768,ATM,1197.79,-1317669.48,JPY,Restaurant
TXN0000007107,2024-07-18T14:18:07,ACC00003098,Debit,1274.13,-1318943.61,EUR,Restaurant
TXN0000007108,2024-07-02T08:26:06,ACC00008181,Transfer,1127.89,-1317815.72,GBP,Grocery
TXN0000007109,2024-04-15T05:37:35,ACC00007771,Payment,1423.25,-1319238.97,JPY,Grocery
TXN0000007110,2024-05-30T00:51:04,ACC00007980,ATM,349.52,-1319588.49,USD,Walmart
TXN0000007111,2024-11-27T23:51:39,ACC00002529,Credit,305.32,-1319283.17,EUR,Online Store
TXN0000007112,2024-01-16T13:58:44,ACC00008574,Credit,856.09,-1318427.08,GBP,Walmart
TXN0000007113,2024-06-04T06:27:09,ACC00004081,Debit,928.28,-1319355.36,GBP,Grocery
TXN0000007114,2024-10-14T15:19:29,ACC00002346,Payment,150.42,-1319505.78,USD,Amazon
TXN0000007115,2024-04-04T02:55:21,ACC00008270,Payment,584.55,-1320090.33,EUR,Restaurant
TXN0000007116,2024-08-30T14:14:31,ACC00008884,Transfer,312.35,-1319777.98,USD,Amazon
TXN0000007117,2024-08-16T16:21:32,ACC00008874,ATM,752.01,-1320529.99,USD,Starbucks
TXN0000007118,2024-03-17T00:12:57,ACC00006830,Debit,1802.59,-1322332.58,GBP,Walmart
TXN0000007119,2024-11-22T15:23:08,ACC00005906,Credit,1736.32,-1320596.26,JPY,Online Store
TXN0000007120,2024-09-12T22:35:10,ACC00003615,Credit,1818.8,-1318777.46,EUR,Starbucks
TXN0000007121,2024-04-12T10:56:13,ACC00002313,ATM,552.93,-1319330.39,JPY,Shell
TXN0000007122,2024-11-08T22:47:14,ACC00006787,Transfer,735.91,-1318594.48,EUR,Walmart
TXN0000007123,2024-01-21T03:31:15,ACC00000487,ATM,310.16,-1318904.64,GBP,Starbucks
TXN0000007124,2024-07-07T02:26:53,ACC00006454,Transfer,1838.82,-1317065.82,JPY,Shell
TXN0000007125,2024-12-18T05:04:18,ACC00009166,Transfer,1636.21,-1315429.61,USD,Online Store
TXN0000007126,2024-02-20T17:10:25,ACC00006461,ATM,821.08,-1316250.69,GBP,Target
TXN0000007127,2024-03-15T16:42:23,ACC00005321,Credit,763.11,-1315487.58,GBP,Online Store
TXN0000007128,2024-04-02T19:01:27,ACC00002633,Payment,1841.4,-1317328.98,USD,Grocery
TXN0000007129,2024-11-15T11:36:15,ACC00001958,Transfer,13.98,-1317315.0,EUR,Restaurant
TXN0000007130,2024-03-22T01:38:26,ACC00005977,Transfer,398.06,-1316916.94,GBP,Amazon
TXN0000007131,2024-08-06T00:00:47,ACC00004352,Payment,122.15,-1317039.09,GBP,Online Store
TXN0000007132,2024-05-24T01:49:05,ACC00002530,Payment,1127.9,-1318166.99,JPY,Restaurant
TXN0000007133,2024-04-15T03:29:22,ACC00002217,Payment,1714.34,-1319881.33,EUR,Target
TXN0000007134,2024-02-10T18:23:55,ACC00005115,Credit,1376.93,-1318504.4,EUR,Online Store
TXN0000007135,2024-10-01T16:01:55,ACC00009088,Debit,1515.38,-1320019.78,EUR,Grocery
TXN0000007136,2024-09-16T10:16:25,ACC00004569,Transfer,360.41,-1319659.37,JPY,Starbucks
TXN0000007137,2024-01-27T11:35:12,ACC00008099,Credit,442.4,-1319216.97,EUR,Grocery
TXN0000007138,2024-06-13T23:00:10,ACC00000969,Debit,1843.97,-1321060.94,GBP,Starbucks
TXN0000007139,2024-05-02T10:46:12,ACC00000869,Debit,1617.01,-1322677.95,USD,Amazon
TXN0000007140,2024-12-21T18:45:42,ACC00007033,Transfer,189.91,-1322488.04,GBP,Online Store
TXN0000007141,2024-03-16T01:00:30,ACC00004039,ATM,1566.6,-1324054.64,JPY,Shell
TXN0000007142,2024-04-10T07:14:28,ACC00007515,Payment,170.43,-1324225.07,GBP,Restaurant
TXN0000007143,2024-09-20T20:03:15,ACC00002570,Payment,1091.59,-1325316.66,GBP,Online Store
TXN0000007144,2024-03-26T21:23:07,ACC00000694,Credit,543.01,-1324773.65,GBP,Walmart
TXN0000007145,2024-12-08T20:38:04,ACC00004655,Debit,1451.53,-1326225.18,JPY,Starbucks
TXN0000007146,2024-08-04T05:54:58,ACC00001113,Payment,892.62,-1327117.8,USD,Target
TXN0000007147,2024-10-30T15:52:26,ACC00004970,Payment,430.62,-1327548.42,GBP,Shell
TXN0000007148,2024-02-12T11:36:43,ACC00007710,Debit,272.18,-1327820.6,EUR,Amazon
TXN0000007149,2024-02-25T02:38:54,ACC00006359,Debit,83.08,-1327903.68,GBP,Amazon
TXN0000007150,2024-03-02T21:43:36,ACC00004657,Payment,1795.84,-1329699.52,JPY,Walmart
TXN0000007151,2024-07-17T05:36:57,ACC00003795,Payment,1240.13,-1330939.65,JPY,Grocery
TXN0000007152,2024-04-30T05:07:59,ACC00004550,Debit,1198.39,-1332138.04,USD,Shell
TXN0000007153,2024-11-10T22:07:22,ACC00003753,ATM,1359.42,-1333497.46,USD,Amazon
TXN0000007154,2024-03-11T08:18:20,ACC00005517,Credit,684.73,-1332812.73,EUR,Walmart
TXN0000007155,2024-02-17T00:32:48,ACC00007849,ATM,1050.48,-1333863.21,USD,Starbucks
TXN0000007156,2024-10-27T12:46:57,ACC00007790,ATM,1177.82,-1335041.03,USD,Grocery
TXN0000007157,2024-10-17T04:55:53,ACC00008719,Credit,1463.99,-1333577.04,USD,Walmart
TXN0000007158,2024-12-09T11:28:13,ACC00005543,Payment,401.64,-1333978.68,EUR,Online Store
TXN0000007159,2024-10-14T07:15:53,ACC00007900,Debit,1635.18,-1335613.86,USD,Target
TXN0000007160,2024-06-05T22:08:51,ACC00004993,ATM,660.81,-1336274.67,JPY,Shell
TXN0000007161,2024-05-17T22:01:11,ACC00008632,Credit,253.79,-1336020.88,EUR,Amazon
TXN0000007162,2024-09-06T10:56:30,ACC00002888,Transfer,735.98,-1335284.9,EUR,Shell
TXN0000007163,2024-06-26T04:48:32,ACC00002175,Credit,1556.08,-1333728.82,JPY,Online Store
TXN0000007164,2024-06-04T00:31:06,ACC00008798,ATM,1531.41,-1335260.23,JPY,Walmart
TXN0000007165,2024-11-14T17:46:52,ACC00006694,Debit,11.64,-1335271.87,EUR,Shell
TXN0000007166,2024-01-11T18:58:13,ACC00003072,Payment,1268.66,-1336540.53,EUR,Online Store
TXN0000007167,2024-05-09T19:13:05,ACC00003405,Debit,1449.14,-1337989.67,USD,Restaurant
TXN0000007168,2024-05-27T10:27:58,ACC00003741,Credit,1128.0,-1336861.67,EUR,Starbucks
TXN0000007169,2024-10-30T20:50:45,ACC00000584,ATM,395.67,-1337257.34,USD,Amazon
TXN0000007170,2024-03-25T05:18:12,ACC00001320,Credit,1659.35,-1335597.99,EUR,Starbucks
TXN0000007171,2024-11-26T07:08:21,ACC00009958,Payment,75.0,-1335672.99,USD,Grocery
TXN0000007172,2024-03-19T00:46:04,ACC00007168,Credit,1016.43,-1334656.56,GBP,Target
TXN0000007173,2024-07-11T23:11:08,ACC00000426,Transfer,1064.04,-1333592.52,USD,Online Store
TXN0000007174,2024-11-20T15:50:02,ACC00006523,Credit,1270.5,-1332322.02,JPY,Online Store
TXN0000007175,2024-09-07T04:08:52,ACC00009361,Credit,625.45,-1331696.57,JPY,Walmart
TXN0000007176,2024-01-06T06:16:36,ACC00003414,Payment,85.72,-1331782.29,GBP,Online Store
TXN0000007177,2024-05-10T00:00:47,ACC00000149,Transfer,136.16,-1331646.13,GBP,Grocery
TXN0000007178,2024-08-06T20:14:35,ACC00004912,Payment,649.69,-1332295.82,GBP,Shell
TXN0000007179,2024-04-29T12:08:52,ACC00000446,Transfer,887.49,-1331408.33,JPY,Online Store
TXN0000007180,2024-06-06T14:59:18,ACC00005525,Credit,1577.82,-1329830.51,USD,Target
TXN0000007181,2024-09-22T19:18:23,ACC00006460,Credit,729.57,-1329100.94,EUR,Grocery
TXN0000007182,2024-03-23T22:52:13,ACC00000698,Payment,563.7,-1329664.64,EUR,Restaurant
TXN0000007183,2024-09-17T12:28:54,ACC00007607,Transfer,1678.88,-1327985.76,EUR,Starbucks
TXN0000007184,2024-07-09T16:41:14,ACC00009252,ATM,1536.23,-1329521.99,JPY,Restaurant
TXN0000007185,2024-03-03T21:00:22,ACC00002060,Payment,214.66,-1329736.65,EUR,Grocery
TXN0000007186,2024-08-05T05:41:43,ACC00009318,Payment,1502.11,-1331238.76,JPY,Amazon
TXN0000007187,2024-12-11T10:31:36,ACC00000008,Payment,1686.88,-1332925.64,EUR,Target
TXN0000007188,2024-01-15T15:09:37,ACC00000801,Debit,578.39,-1333504.03,EUR,Starbucks
TXN0000007189,2024-01-24T19:46:02,ACC00006663,Payment,1946.96,-1335450.99,EUR,Shell
TXN0000007190,2024-01-29T09:46:02,ACC00002923,Credit,1456.96,-1333994.03,EUR,Online Store
TXN0000007191,2024-04-06T15:33:58,ACC00006842,ATM,1989.93,-1335983.96,USD,Shell
TXN0000007192,2024-03-23T04:44:24,ACC00008852,Payment,1133.62,-1337117.58,GBP,Target
TXN0000007193,2024-10-01T05:41:39,ACC00002902,Debit,325.15,-1337442.73,USD,Restaurant
TXN0000007194,2024-12-28T20:32:57,ACC00003458,Payment,1040.36,-1338483.09,GBP,Walmart
TXN0000007195,2024-09-15T17:10:22,ACC00006320,Transfer,1062.1,-1337420.99,GBP,Online Store
TXN0000007196,2024-12-12T07:31:09,ACC00001995,ATM,808.29,-1338229.28,EUR,Grocery
TXN0000007197,2024-09-17T12:44:14,ACC00006682,Credit,1860.24,-1336369.04,USD,Amazon
TXN0000007198,2024-08-08T01:39:15,ACC00007735,ATM,1596.04,-1337965.08,GBP,Target
TXN0000007199,2024-04-15T01:19:23,ACC00006523,ATM,950.04,-1338915.12,JPY,Restaurant
TXN0000007200,2024-06-24T13:03:29,ACC00008353,ATM,1036.02,-1339951.14,EUR,Online Store
TXN0000007201,2024-03-23T16:39:27,ACC00004086,ATM,596.7,-1340547.84,USD,Walmart
TXN0000007202,2024-07-11T01:21:12,ACC00005249,Transfer,1525.72,-1339022.12,GBP,Starbucks
TXN0000007203,2024-05-29T09:15:45,ACC00009527,Credit,334.77,-1338687.35,GBP,Restaurant
TXN0000007204,2024-07-11T02:25:53,ACC00007882,Payment,1637.76,-1340325.11,GBP,Walmart
TXN0000007205,2024-11-15T12:46:11,ACC00003671,ATM,737.46,-1341062.57,EUR,Amazon
TXN0000007206,2024-09-25T20:32:28,ACC00002401,Transfer,991.87,-1340070.7,USD,Walmart
TXN0000007207,2024-05-05T05:35:40,ACC00000121,Credit,1400.51,-1338670.19,JPY,Starbucks
TXN0000007208,2024-06-07T22:17:17,ACC00002476,Debit,1365.13,-1340035.32,USD,Shell
TXN0000007209,2024-08-05T04:46:30,ACC00002210,Credit,136.76,-1339898.56,EUR,Walmart
TXN0000007210,2024-12-04T08:39:27,ACC00003433,Credit,1864.98,-1338033.58,USD,Amazon
TXN0000007211,2024-06-14T04:17:50,ACC00009406,Payment,261.82,-1338295.4,GBP,Grocery
TXN0000007212,2024-03-02T00:10:23,ACC00000872,Transfer,1651.61,-1336643.79,EUR,Starbucks
TXN0000007213,2024-08-04T08:48:09,ACC00000309,ATM,867.03,-1337510.82,EUR,Starbucks
TXN0000007214,2024-11-21T12:00:57,ACC00007976,ATM,326.69,-1337837.51,USD,Online Store
TXN0000007215,2024-01-01T11:52:37,ACC00000834,ATM,420.09,-1338257.6,USD,Target
TXN0000007216,2024-05-30T03:56:49,ACC00003395,Credit,13.58,-1338244.02,USD,Starbucks
TXN0000007217,2024-03-26T23:32:49,ACC00000283,Payment,1054.59,-1339298.61,USD,Target
TXN0000007218,2024-07-22T01:04:20,ACC00006004,Transfer,205.24,-1339093.37,USD,Target
TXN0000007219,2024-12-06T16:02:50,ACC00004365,Debit,1871.78,-1340965.15,JPY,Restaurant
TXN0000007220,2024-07-25T19:20:02,ACC00004274,ATM,41.38,-1341006.53,JPY,Shell
TXN0000007221,2024-08-23T18:52:36,ACC00003690,Transfer,714.88,-1340291.65,EUR,Online Store
TXN0000007222,2024-05-24T03:54:18,ACC00002868,Credit,1679.3,-1338612.35,EUR,Restaurant
TXN0000007223,2024-03-17T13:22:00,ACC00009507,ATM,271.58,-1338883.93,JPY,Starbucks
TXN0000007224,2024-03-26T06:59:40,ACC00007764,Transfer,1756.06,-1337127.87,USD,Walmart
TXN0000007225,2024-10-11T07:39:53,ACC00005328,Payment,429.66,-1337557.53,JPY,Amazon
TXN0000007226,2024-07-24T12:15:58,ACC00002183,Transfer,1710.35,-1335847.18,USD,Target
TXN0000007227,2024-10-17T01:53:54,ACC00008010,Transfer,1554.69,-1334292.49,USD,Amazon
TXN0000007228,2024-02-16T18:55:14,ACC00008085,Debit,980.38,-1335272.87,GBP,Grocery
TXN0000007229,2024-01-13T01:20:05,ACC00007124,ATM,957.5,-1336230.37,USD,Restaurant
TXN0000007230,2024-08-17T14:30:03,ACC00006938,ATM,1518.78,-1337749.15,EUR,Target
TXN0000007231,2024-10-25T17:47:23,ACC00002568,Payment,762.96,-1338512.11,USD,Starbucks
TXN0000007232,2024-03-21T13:57:08,ACC00008628,Payment,1676.41,-1340188.52,JPY,Shell
TXN0000007233,2024-10-04T17:28:43,ACC00006235,Payment,1128.01,-1341316.53,GBP,Shell
TXN0000007234,2024-08-11T02:30:19,ACC00005545,ATM,1440.57,-1342757.1,JPY,Amazon
TXN0000007235,2024-12-18T13:14:03,ACC00004188,Transfer,951.02,-1341806.08,USD,Starbucks
TXN0000007236,2024-05-01T00:55:38,ACC00008015,Credit,238.48,-1341567.6,USD,Shell
TXN0000007237,2024-08-18T08:52:29,ACC00004541,Transfer,723.25,-1340844.35,GBP,Target
TXN0000007238,2024-07-10T22:06:58,ACC00009491,Transfer,1017.23,-1339827.12,JPY,Shell
TXN0000007239,2024-06-25T13:31:50,ACC00007801,ATM,1452.79,-1341279.91,JPY,Grocery
TXN0000007240,2024-12-03T14:11:13,ACC00007580,Payment,850.25,-1342130.16,USD,Restaurant
TXN0000007241,2024-12-12T10:35:43,ACC00009201,Transfer,390.06,-1341740.1,JPY,Target
TXN0000007242,2024-04-04T05:48:51,ACC00000406,Transfer,81.12,-1341658.98,USD,Online Store
TXN0000007243,2024-05-01T10:23:20,ACC00004083,Payment,1263.04,-1342922.02,USD,Online Store
TXN0000007244,2024-02-13T23:44:02,ACC00001890,Credit,183.11,-1342738.91,USD,Target
TXN0000007245,2024-03-05T23:03:28,ACC00009239,Payment,1360.95,-1344099.86,EUR,Restaurant
TXN0000007246,2024-09-09T04:59:16,ACC00005230,Transfer,1456.2,-1342643.66,GBP,Walmart
TXN0000007247,2024-10-17T13:33:09,ACC00007944,Credit,24.02,-1342619.64,USD,Grocery
TXN0000007248,2024-11-06T07:58:05,ACC00006219,ATM,307.35,-1342926.99,EUR,Amazon
TXN0000007249,2024-12-25T02:10:41,ACC00001579,Transfer,1866.99,-1341060.0,GBP,Grocery
TXN0000007250,2024-09-07T07:11:37,ACC00009272,Debit,1272.32,-1342332.32,JPY,Restaurant
TXN0000007251,2024-11-13T18:09:10,ACC00001656,Transfer,386.03,-1341946.29,EUR,Shell
TXN0000007252,2024-10-29T12:27:48,ACC00005991,Credit,1599.4,-1340346.89,EUR,Restaurant
TXN0000007253,2024-01-17T06:41:21,ACC00004855,Transfer,1428.02,-1338918.87,USD,Shell
TXN0000007254,2024-05-09T19:18:11,ACC00003720,Credit,587.01,-1338331.86,GBP,Shell
TXN0000007255,2024-06-13T00:43:39,ACC00005445,Credit,1414.71,-1336917.15,JPY,Restaurant
TXN0000007256,2024-07-12T06:42:46,ACC00008334,Credit,1540.82,-1335376.33,EUR,Shell
TXN0000007257,2024-08-15T22:56:16,ACC00001695,ATM,879.87,-1336256.2,GBP,Shell
TXN0000007258,2024-02-06T17:17:55,ACC00005003,Payment,805.0,-1337061.2,USD,Restaurant
TXN0000007259,2024-02-04T07:20:29,ACC00009806,ATM,410.67,-1337471.87,JPY,Restaurant
TXN0000007260,2024-04-04T20:46:23,ACC00002437,Debit,1169.04,-1338640.91,USD,Online Store
TXN0000007261,2024-01-11T08:26:15,ACC00001846,Debit,891.67,-1339532.58,GBP,Walmart
TXN0000007262,2024-12-13T23:54:27,ACC00007385,Transfer,1383.69,-1338148.89,JPY,Online Store
TXN0000007263,2024-11-16T06:05:25,ACC00008072,Payment,308.96,-1338457.85,USD,Restaurant
TXN0000007264,2024-06-23T00:15:48,ACC00004656,ATM,1212.27,-1339670.12,GBP,Starbucks
TXN0000007265,2024-06-08T05:53:33,ACC00002234,ATM,102.13,-1339772.25,GBP,Target
TXN0000007266,2024-11-24T17:43:20,ACC00000227,ATM,942.53,-1340714.78,GBP,Amazon
TXN0000007267,2024-03-19T14:28:30,ACC00009423,Debit,1094.96,-1341809.74,GBP,Shell
TXN0000007268,2024-08-21T02:14:05,ACC00004792,Payment,263.22,-1342072.96,USD,Restaurant
TXN0000007269,2024-09-23T10:16:42,ACC00002444,ATM,18.67,-1342091.63,JPY,Walmart
TXN0000007270,2024-05-29T21:12:37,ACC00003801,Debit,123.53,-1342215.16,USD,Restaurant
TXN0000007271,2024-09-27T12:34:16,ACC00000387,Transfer,1818.84,-1340396.32,USD,Starbucks
TXN0000007272,2024-05-05T01:31:49,ACC00009462,Debit,145.06,-1340541.38,JPY,Grocery
TXN0000007273,2024-05-14T10:50:06,ACC00003594,Credit,375.59,-1340165.79,EUR,Walmart
TXN0000007274,2024-11-09T06:16:37,ACC00005141,Transfer,1274.29,-1338891.5,JPY,Walmart
TXN0000007275,2024-11-13T22:46:33,ACC00008931,Transfer,777.56,-1338113.94,USD,Grocery
TXN0000007276,2024-06-15T20:49:06,ACC00008805,Transfer,468.43,-1337645.51,GBP,Online Store
TXN0000007277,2024-11-21T18:40:18,ACC00005922,Payment,1329.1,-1338974.61,JPY,Starbucks
TXN0000007278,2024-05-22T00:57:37,ACC00008768,Debit,619.71,-1339594.32,EUR,Shell
TXN0000007279,2024-12-08T03:23:44,ACC00001508,Transfer,295.25,-1339299.07,EUR,Target
TXN0000007280,2024-11-01T07:11:50,ACC00004504,Transfer,1345.11,-1337953.96,JPY,Online Store
TXN0000007281,2024-10-08T02:28:58,ACC00001969,Debit,954.34,-1338908.3,USD,Target
TXN0000007282,2024-09-03T13:45:29,ACC00000532,Credit,1688.09,-1337220.21,GBP,Online Store
TXN0000007283,2024-08-28T18:35:29,ACC00003166,Credit,221.94,-1336998.27,GBP,Walmart
TXN0000007284,2024-12-20T14:20:03,ACC00003124,Credit,806.25,-1336192.02,USD,Online Store
TXN0000007285,2024-07-19T18:56:06,ACC00002605,Credit,1887.0,-1334305.02,EUR,Grocery
TXN0000007286,2024-07-21T08:51:56,ACC00003456,Transfer,1693.4,-1332611.62,GBP,Starbucks
TXN0000007287,2024-01-15T12:24:48,ACC00000459,Transfer,1825.4,-1330786.22,JPY,Amazon
TXN0000007288,2024-06-03T09:08:20,ACC00009428,ATM,1552.99,-1332339.21,EUR,Target
TXN0000007289,2024-06-22T18:15:33,ACC00006730,Transfer,1458.32,-1330880.89,USD,Amazon
TXN0000007290,2024-01-22T20:28:15,ACC00008800,Transfer,1465.12,-1329415.77,GBP,Restaurant
TXN0000007291,2024-07-03T09:49:45,ACC00002473,ATM,1432.22,-1330847.99,JPY,Online Store
TXN0000007292,2024-09-16T21:16:35,ACC00003745,Transfer,1712.49,-1329135.5,JPY,Online Store
TXN0000007293,2024-02-25T09:24:50,ACC00006562,Debit,1686.66,-1330822.16,EUR,Online Store
TXN0000007294,2024-07-07T23:17:41,ACC00000561,ATM,356.93,-1331179.09,JPY,Online Store
TXN0000007295,2024-03-30T06:10:25,ACC00001038,Debit,1294.72,-1332473.81,USD,Online Store
TXN0000007296,2024-12-25T11:29:28,ACC00009638,Payment,787.8,-1333261.61,JPY,Starbucks
TXN0000007297,2024-12-21T18:50:48,ACC00005640,Transfer,737.27,-1332524.34,JPY,Online Store
TXN0000007298,2024-10-04T16:38:30,ACC00003065,Payment,351.15,-1332875.49,EUR,Grocery
TXN0000007299,2024-07-04T03:50:03,ACC00007265,Transfer,1078.1,-1331797.39,JPY,Restaurant
TXN0000007300,2024-01-04T12:06:23,ACC00004643,Credit,1266.97,-1330530.42,EUR,Target
TXN0000007301,2024-07-28T20:23:13,ACC00005930,Payment,22.85,-1330553.27,JPY,Restaurant
TXN0000007302,2024-07-21T11:54:27,ACC00004775,ATM,492.54,-1331045.81,USD,Target
TXN0000007303,2024-08-27T23:32:22,ACC00005240,Credit,798.17,-1330247.64,EUR,Grocery
TXN0000007304,2024-03-01T22:14:55,ACC00002513,ATM,694.02,-1330941.66,JPY,Starbucks
TXN0000007305,2024-08-25T04:20:04,ACC00003860,Debit,1676.25,-1332617.91,EUR,Walmart
TXN0000007306,2024-09-26T09:10:41,ACC00001041,Payment,218.95,-1332836.86,EUR,Starbucks
TXN0000007307,2024-03-01T05:46:10,ACC00005604,Payment,940.19,-1333777.05,USD,Walmart
TXN0000007308,2024-02-08T14:13:34,ACC00008638,Credit,1408.92,-1332368.13,EUR,Walmart
TXN0000007309,2024-04-08T00:48:23,ACC00001419,Payment,1976.73,-1334344.86,USD,Restaurant
TXN0000007310,2024-10-07T05:56:10,ACC00009076,Credit,583.86,-1333761.0,USD,Restaurant
TXN0000007311,2024-04-04T16:50:59,ACC00007018,Payment,485.87,-1334246.87,EUR,Shell
TXN0000007312,2024-10-28T22:42:33,ACC00007984,ATM,620.28,-1334867.15,JPY,Restaurant
TXN0000007313,2024-09-20T21:23:12,ACC00003204,Credit,408.9,-1334458.25,EUR,Starbucks
TXN0000007314,2024-08-09T13:13:23,ACC00008010,Transfer,987.89,-1333470.36,EUR,Online Store
TXN0000007315,2024-01-24T05:04:23,ACC00001505,Debit,246.7,-1333717.06,JPY,Online Store
TXN0000007316,2024-07-25T01:37:08,ACC00003297,ATM,933.2,-1334650.26,JPY,Shell
TXN0000007317,2024-01-25T16:56:26,ACC00001561,Transfer,468.46,-1334181.8,JPY,Shell
TXN0000007318,2024-10-28T14:26:20,ACC00000132,Debit,513.98,-1334695.78,GBP,Walmart
TXN0000007319,2024-02-08T10:30:29,ACC00009791,Credit,1169.38,-1333526.4,GBP,Amazon
TXN0000007320,2024-07-06T20:17:23,ACC00004824,Transfer,1545.5,-1331980.9,JPY,Amazon
TXN0000007321,2024-09-05T14:27:07,ACC00009560,ATM,570.31,-1332551.21,EUR,Walmart
TXN0000007322,2024-08-06T07:37:38,ACC00007855,Payment,1246.69,-1333797.9,GBP,Restaurant
TXN0000007323,2024-03-20T11:08:38,ACC00006018,Credit,1431.92,-1332365.98,USD,Grocery
TXN0000007324,2024-02-18T22:05:11,ACC00008560,Transfer,1455.32,-1330910.66,JPY,Target
TXN0000007325,2024-10-05T02:54:42,ACC00003124,Transfer,1055.3,-1329855.36,GBP,Online Store
TXN0000007326,2024-07-29T08:24:10,ACC00002747,Credit,464.38,-1329390.98,JPY,Starbucks
TXN0000007327,2024-07-17T20:13:34,ACC00001804,Payment,164.68,-1329555.66,JPY,Walmart
TXN0000007328,2024-09-09T15:12:05,ACC00001857,ATM,594.81,-1330150.47,GBP,Amazon
TXN0000007329,2024-09-21T14:38:14,ACC00003289,ATM,1016.33,-1331166.8,EUR,Grocery
TXN0000007330,2024-08-03T19:57:40,ACC00005271,Debit,665.5,-1331832.3,EUR,Target
TXN0000007331,2024-09-22T03:25:34,ACC00000062,ATM,482.99,-1332315.29,EUR,Starbucks
TXN0000007332,2024-03-24T05:34:02,ACC00007091,ATM,1954.99,-1334270.28,GBP,Amazon
TXN0000007333,2024-10-26T14:51:35,ACC00008766,ATM,1165.76,-1335436.04,JPY,Restaurant
TXN0000007334,2024-04-18T17:41:18,ACC00005355,Payment,802.93,-1336238.97,USD,Starbucks
TXN0000007335,2024-09-21T04:05:53,ACC00002946,Debit,567.32,-1336806.29,GBP,Shell
TXN0000007336,2024-09-08T16:36:29,ACC00005336,Payment,1128.36,-1337934.65,JPY,Starbucks
TXN0000007337,2024-01-13T06:56:18,ACC00002809,Transfer,735.47,-1337199.18,USD,Target
TXN0000007338,2024-05-17T23:43:30,ACC00009551,ATM,1628.44,-1338827.62,GBP,Starbucks
TXN0000007339,2024-06-12T12:24:26,ACC00008481,ATM,1382.21,-1340209.83,GBP,Target
TXN0000007340,2024-08-13T04:47:27,ACC00007600,Credit,1507.12,-1338702.71,JPY,Starbucks
TXN0000007341,2024-11-29T04:23:23,ACC00002265,Debit,1741.47,-1340444.18,JPY,Grocery
TXN0000007342,2024-08-15T20:13:07,ACC00000769,Payment,966.0,-1341410.18,GBP,Target
TXN0000007343,2024-06-29T02:46:48,ACC00006308,Debit,1589.8,-1342999.98,EUR,Grocery
TXN0000007344,2024-08-27T10:46:35,ACC00002855,Payment,1217.62,-1344217.6,EUR,Shell
TXN0000007345,2024-12-06T04:21:44,ACC00004736,ATM,243.19,-1344460.79,JPY,Online Store
TXN0000007346,2024-08-02T08:25:22,ACC00003171,Transfer,716.9,-1343743.89,EUR,Amazon
TXN0000007347,2024-09-04T15:15:41,ACC00002070,Payment,1695.64,-1345439.53,USD,Shell
TXN0000007348,2024-06-10T14:59:49,ACC00003830,Transfer,984.49,-1344455.04,JPY,Grocery
TXN0000007349,2024-10-04T16:25:45,ACC00009466,ATM,1433.98,-1345889.02,GBP,Amazon
TXN0000007350,2024-05-05T07:19:34,ACC00000459,ATM,1536.36,-1347425.38,JPY,Restaurant
TXN0000007351,2024-09-29T02:28:52,ACC00008369,ATM,52.88,-1347478.26,USD,Starbucks
TXN0000007352,2024-02-26T23:53:57,ACC00002491,Debit,1908.65,-1349386.91,JPY,Amazon
TXN0000007353,2024-02-02T15:32:24,ACC00002360,Payment,439.37,-1349826.28,USD,Target
TXN0000007354,2024-01-18T20:40:04,ACC00004844,Debit,1334.91,-1351161.19,JPY,Target
TXN0000007355,2024-08-26T04:27:12,ACC00008846,Payment,1663.02,-1352824.21,GBP,Restaurant
TXN0000007356,2024-11-05T01:06:35,ACC00009140,Debit,1802.21,-1354626.42,GBP,Starbucks
TXN0000007357,2024-10-12T02:19:08,ACC00009330,Transfer,928.69,-1353697.73,EUR,Starbucks
TXN0000007358,2024-01-31T00:53:52,ACC00000226,Payment,431.55,-1354129.28,EUR,Online Store
TXN0000007359,2024-06-25T20:38:10,ACC00008628,Credit,1654.11,-1352475.17,USD,Shell
TXN0000007360,2024-07-25T09:32:56,ACC00006051,Credit,922.89,-1351552.28,USD,Walmart
TXN0000007361,2024-02-18T13:06:57,ACC00001930,Payment,1993.72,-1353546.0,USD,Shell
TXN0000007362,2024-03-09T18:50:05,ACC00008135,ATM,1452.23,-1354998.23,USD,Walmart
TXN0000007363,2024-06-26T19:46:20,ACC00003593,Transfer,449.96,-1354548.27,JPY,Restaurant
TXN0000007364,2024-02-18T06:06:35,ACC00000751,Debit,1594.85,-1356143.12,JPY,Target
TXN0000007365,2024-05-31T02:56:20,ACC00003741,Payment,685.4,-1356828.52,USD,Grocery
TXN0000007366,2024-06-26T13:28:14,ACC00007938,Transfer,426.79,-1356401.73,USD,Starbucks
TXN0000007367,2024-01-07T15:45:54,ACC00008088,Transfer,891.6,-1355510.13,GBP,Online Store
TXN0000007368,2024-07-05T05:25:27,ACC00001920,ATM,280.37,-1355790.5,JPY,Restaurant
TXN0000007369,2024-02-08T09:16:00,ACC00003744,Transfer,459.94,-1355330.56,EUR,Restaurant
TXN0000007370,2024-02-17T02:42:46,ACC00003553,Payment,882.79,-1356213.35,GBP,Restaurant
TXN0000007371,2024-07-25T12:09:49,ACC00009830,Transfer,1057.06,-1355156.29,USD,Walmart
TXN0000007372,2024-06-19T00:06:51,ACC00000164,Transfer,1494.51,-1353661.78,USD,Grocery
TXN0000007373,2024-05-24T08:05:14,ACC00004283,Credit,1826.33,-1351835.45,GBP,Restaurant
TXN0000007374,2024-02-16T00:37:44,ACC00007761,Transfer,1702.5,-1350132.95,USD,Online Store
TXN0000007375,2024-04-11T02:32:11,ACC00004392,Payment,592.34,-1350725.29,JPY,Shell
TXN0000007376,2024-04-23T08:26:04,ACC00009604,Transfer,323.53,-1350401.76,GBP,Walmart
TXN0000007377,2024-09-13T11:32:47,ACC00004200,ATM,25.74,-1350427.5,EUR,Online Store
TXN0000007378,2024-08-07T05:19:05,ACC00004703,ATM,191.55,-1350619.05,EUR,Target
TXN0000007379,2024-12-24T09:37:25,ACC00005665,Credit,1499.33,-1349119.72,EUR,Shell
TXN0000007380,2024-07-17T13:20:12,ACC00004331,Payment,1129.67,-1350249.39,USD,Walmart
TXN0000007381,2024-10-14T18:00:38,ACC00007416,Payment,1882.93,-1352132.32,JPY,Starbucks
TXN0000007382,2024-07-09T04:59:49,ACC00004661,Credit,52.9,-1352079.42,GBP,Restaurant
TXN0000007383,2024-10-18T08:10:58,ACC00006694,ATM,1692.64,-1353772.06,JPY,Shell
TXN0000007384,2024-03-14T00:39:34,ACC00008561,Payment,77.55,-1353849.61,JPY,Grocery
TXN0000007385,2024-09-16T13:58:53,ACC00001132,Transfer,1886.07,-1351963.54,JPY,Restaurant
TXN0000007386,2024-09-06T00:03:01,ACC00003624,Credit,966.41,-1350997.13,EUR,Online Store
TXN0000007387,2024-10-03T07:22:31,ACC00000950,ATM,1958.21,-1352955.34,EUR,Restaurant
TXN0000007388,2024-05-24T07:19:26,ACC00009840,Credit,74.47,-1352880.87,JPY,Shell
TXN0000007389,2024-06-04T15:08:27,ACC00004874,ATM,1283.51,-1354164.38,EUR,Online Store
TXN0000007390,2024-10-24T06:10:51,ACC00005937,Payment,589.24,-1354753.62,EUR,Starbucks
TXN0000007391,2024-10-22T20:17:02,ACC00004594,Transfer,1581.77,-1353171.85,USD,Shell
TXN0000007392,2024-12-20T03:13:01,ACC00007916,Debit,1784.18,-1354956.03,JPY,Grocery
TXN0000007393,2024-04-17T21:23:10,ACC00001051,Payment,303.32,-1355259.35,JPY,Grocery
TXN0000007394,2024-08-01T20:02:51,ACC00001797,Payment,361.87,-1355621.22,GBP,Restaurant
TXN0000007395,2024-12-29T19:44:24,ACC00007130,ATM,1927.66,-1357548.88,JPY,Target
TXN0000007396,2024-10-16T12:18:05,ACC00008711,Payment,1615.93,-1359164.81,EUR,Starbucks
TXN0000007397,2024-03-24T13:36:04,ACC00007972,Debit,1796.29,-1360961.1,USD,Walmart
TXN0000007398,2024-03-04T20:37:40,ACC00003772,Transfer,443.86,-1360517.24,GBP,Grocery
TXN0000007399,2024-01-23T14:22:50,ACC00004030,Credit,550.54,-1359966.7,JPY,Target
TXN0000007400,2024-10-26T22:04:07,ACC00004616,Payment,1264.69,-1361231.39,USD,Target
TXN0000007401,2024-12-11T12:35:34,ACC00004556,Transfer,1896.39,-1359335.0,EUR,Shell
TXN0000007402,2024-11-25T08:23:01,ACC00008194,ATM,1796.03,-1361131.03,GBP,Amazon
TXN0000007403,2024-01-12T03:29:00,ACC00003187,Debit,838.53,-1361969.56,EUR,Online Store
TXN0000007404,2024-10-03T18:12:42,ACC00006504,Transfer,1762.61,-1360206.95,JPY,Starbucks
TXN0000007405,2024-12-29T11:33:14,ACC00008808,ATM,1770.47,-1361977.42,USD,Starbucks
TXN0000007406,2024-12-14T19:11:11,ACC00002080,Credit,462.13,-1361515.29,USD,Walmart
TXN0000007407,2024-01-24T14:49:12,ACC00002351,Credit,483.09,-1361032.2,EUR,Starbucks
TXN0000007408,2024-04-04T05:04:31,ACC00003302,Debit,266.3,-1361298.5,GBP,Target
TXN0000007409,2024-04-03T02:28:22,ACC00002197,Debit,1392.9,-1362691.4,JPY,Amazon
TXN0000007410,2024-03-07T05:31:21,ACC00002873,Debit,1381.19,-1364072.59,EUR,Restaurant
TXN0000007411,2024-02-27T07:56:17,ACC00001519,Transfer,1408.6,-1362663.99,GBP,Restaurant
TXN0000007412,2024-12-20T09:28:57,ACC00008610,Transfer,1822.27,-1360841.72,USD,Walmart
TXN0000007413,2024-04-12T07:57:47,ACC00008219,Debit,156.0,-1360997.72,JPY,Online Store
TXN0000007414,2024-03-19T01:45:16,ACC00002808,Credit,1184.58,-1359813.14,EUR,Grocery
TXN0000007415,2024-04-02T10:51:31,ACC00006870,ATM,786.54,-1360599.68,GBP,Starbucks
TXN0000007416,2024-02-21T08:04:48,ACC00009441,Transfer,247.48,-1360352.2,GBP,Grocery
TXN0000007417,2024-08-29T14:44:17,ACC00007301,Credit,158.63,-1360193.57,USD,Shell
TXN0000007418,2024-06-14T03:34:26,ACC00007205,ATM,1397.5,-1361591.07,JPY,Restaurant
TXN0000007419,2024-01-18T23:09:03,ACC00007539,Debit,410.84,-1362001.91,GBP,Grocery
TXN0000007420,2024-03-20T18:39:17,ACC00001895,Transfer,221.19,-1361780.72,EUR,Shell
TXN0000007421,2024-10-17T19:38:28,ACC00003274,Transfer,1742.68,-1360038.04,JPY,Walmart
TXN0000007422,2024-04-27T20:41:33,ACC00008872,Payment,878.05,-1360916.09,JPY,Restaurant
TXN0000007423,2024-11-21T05:24:07,ACC00000507,Credit,901.25,-1360014.84,JPY,Starbucks
TXN0000007424,2024-10-02T16:55:42,ACC00006261,Transfer,1095.25,-1358919.59,EUR,Amazon
TXN0000007425,2024-01-07T08:27:22,ACC00003089,Transfer,958.42,-1357961.17,USD,Target
TXN0000007426,2024-06-01T21:06:32,ACC00009652,Payment,425.68,-1358386.85,GBP,Shell
TXN0000007427,2024-01-19T18:48:27,ACC00009616,Payment,383.24,-1358770.09,GBP,Restaurant
TXN0000007428,2024-12-29T23:28:15,ACC00003673,ATM,979.36,-1359749.45,JPY,Target
TXN0000007429,2024-05-10T02:02:16,ACC00004667,Transfer,708.93,-1359040.52,JPY,Shell
TXN0000007430,2024-03-22T08:49:08,ACC00009174,Payment,1725.94,-1360766.46,JPY,Restaurant
TXN0000007431,2024-10-29T12:58:01,ACC00006990,Debit,1072.59,-1361839.05,EUR,Grocery
TXN0000007432,2024-11-28T04:41:31,ACC00006447,Debit,523.67,-1362362.72,USD,Starbucks
TXN0000007433,2024-09-06T14:04:51,ACC00003942,ATM,952.09,-1363314.81,EUR,Target
TXN0000007434,2024-05-25T21:11:32,ACC00005445,Credit,1611.42,-1361703.39,JPY,Starbucks
TXN0000007435,2024-02-03T11:03:27,ACC00006285,ATM,775.48,-1362478.87,EUR,Shell
TXN0000007436,2024-09-23T16:17:39,ACC00008027,Payment,614.88,-1363093.75,JPY,Target
TXN0000007437,2024-02-09T01:49:48,ACC00004370,Debit,1843.7,-1364937.45,JPY,Online Store
TXN0000007438,2024-07-16T06:00:59,ACC00008664,Debit,289.58,-1365227.03,USD,Amazon
TXN0000007439,2024-11-04T23:46:38,ACC00004048,Payment,462.05,-1365689.08,USD,Online Store
TXN0000007440,2024-09-23T11:23:19,ACC00005553,Credit,80.91,-1365608.17,GBP,Shell
TXN0000007441,2024-09-07T00:14:41,ACC00003839,Credit,1413.51,-1364194.66,USD,Target
TXN0000007442,2024-01-01T18:22:09,ACC00005403,Transfer,67.91,-1364126.75,JPY,Starbucks
TXN0000007443,2024-03-08T03:29:15,ACC00004950,Transfer,1634.85,-1362491.9,GBP,Starbucks
TXN0000007444,2024-11-06T12:04:35,ACC00002755,Credit,1905.01,-1360586.89,JPY,Online Store
TXN0000007445,2024-03-11T19:33:30,ACC00005147,Debit,1045.27,-1361632.16,EUR,Starbucks
TXN0000007446,2024-02-29T19:41:15,ACC00003696,Credit,198.3,-1361433.86,USD,Shell
TXN0000007447,2024-12-19T00:05:08,ACC00005280,Debit,1621.44,-1363055.3,JPY,Grocery
TXN0000007448,2024-08-10T14:09:48,ACC00008712,Payment,604.88,-1363660.18,GBP,Walmart
TXN0000007449,2024-07-19T02:53:07,ACC00008206,Payment,178.53,-1363838.71,EUR,Grocery
TXN0000007450,2024-09-02T06:29:10,ACC00002803,Debit,1548.07,-1365386.78,EUR,Restaurant
TXN0000007451,2024-08-22T09:34:28,ACC00009423,Credit,243.36,-1365143.42,EUR,Target
TXN0000007452,2024-06-14T16:56:48,ACC00004102,Credit,1926.68,-1363216.74,JPY,Online Store
TXN0000007453,2024-09-04T18:03:59,ACC00007679,Payment,1035.72,-1364252.46,JPY,Amazon
TXN0000007454,2024-09-19T08:24:11,ACC00003199,Payment,306.04,-1364558.5,USD,Restaurant
TXN0000007455,2024-05-16T17:15:36,ACC00002648,ATM,576.75,-1365135.25,GBP,Amazon
TXN0000007456,2024-08-01T04:49:03,ACC00003391,Transfer,25.09,-1365110.16,GBP,Amazon
TXN0000007457,2024-06-27T05:13:53,ACC00003670,Transfer,249.17,-1364860.99,USD,Amazon
TXN0000007458,2024-09-20T07:13:54,ACC00001315,Credit,197.35,-1364663.64,JPY,Target
TXN0000007459,2024-06-30T15:16:57,ACC00000287,Credit,1620.79,-1363042.85,JPY,Amazon
TXN0000007460,2024-06-01T21:33:49,ACC00005466,Payment,606.41,-1363649.26,EUR,Grocery
TXN0000007461,2024-10-02T07:48:58,ACC00002628,Debit,1948.95,-1365598.21,JPY,Online Store
TXN0000007462,2024-09-17T02:39:52,ACC00002758,Payment,327.07,-1365925.28,JPY,Grocery
TXN0000007463,2024-01-21T18:25:04,ACC00005026,ATM,1826.04,-1367751.32,EUR,Shell
TXN0000007464,2024-06-07T18:37:17,ACC00001963,Debit,1483.31,-1369234.63,EUR,Starbucks
TXN0000007465,2024-03-20T13:25:48,ACC00004456,Transfer,777.0,-1368457.63,GBP,Online Store
TXN0000007466,2024-08-04T10:52:36,ACC00004717,ATM,86.59,-1368544.22,GBP,Restaurant
TXN0000007467,2024-05-22T14:15:10,ACC00004262,Debit,650.54,-1369194.76,GBP,Restaurant
TXN0000007468,2024-06-16T14:45:02,ACC00000141,Payment,60.59,-1369255.35,USD,Grocery
TXN0000007469,2024-11-30T07:40:56,ACC00003472,Debit,1245.04,-1370500.39,GBP,Target
TXN0000007470,2024-10-22T22:18:13,ACC00007517,Transfer,245.25,-1370255.14,GBP,Target
TXN0000007471,2024-08-07T14:47:25,ACC00008476,Transfer,1326.58,-1368928.56,EUR,Restaurant
TXN0000007472,2024-02-29T11:57:08,ACC00005409,Credit,1759.42,-1367169.14,USD,Grocery
TXN0000007473,2024-12-16T07:35:05,ACC00000401,Transfer,564.13,-1366605.01,JPY,Grocery
TXN0000007474,2024-02-17T08:27:43,ACC00005697,Payment,550.84,-1367155.85,JPY,Walmart
TXN0000007475,2024-07-03T22:48:32,ACC00009846,Debit,1714.74,-1368870.59,EUR,Target
TXN0000007476,2024-07-15T05:37:47,ACC00009054,Debit,1918.53,-1370789.12,JPY,Starbucks
TXN0000007477,2024-07-10T06:21:19,ACC00002189,ATM,577.0,-1371366.12,USD,Grocery
TXN0000007478,2024-07-07T07:35:35,ACC00007393,Payment,731.63,-1372097.75,JPY,Starbucks
TXN0000007479,2024-11-09T22:56:49,ACC00000893,ATM,1936.58,-1374034.33,USD,Online Store
TXN0000007480,2024-02-21T15:55:00,ACC00009946,Payment,761.69,-1374796.02,EUR,Grocery
TXN0000007481,2024-11-10T07:07:37,ACC00002940,Payment,1039.47,-1375835.49,JPY,Target
TXN0000007482,2024-01-07T05:57:47,ACC00001815,Debit,665.02,-1376500.51,EUR,Grocery
TXN0000007483,2024-11-18T03:52:21,ACC00005781,Transfer,750.87,-1375749.64,GBP,Amazon
TXN0000007484,2024-10-03T01:15:41,ACC00000410,Credit,1883.99,-1373865.65,GBP,Restaurant
TXN0000007485,2024-03-30T11:09:02,ACC00008705,Credit,871.51,-1372994.14,GBP,Starbucks
TXN0000007486,2024-06-22T02:33:36,ACC00005347,Credit,1718.46,-1371275.68,GBP,Grocery
TXN0000007487,2024-04-06T17:18:44,ACC00009448,Payment,957.84,-1372233.52,JPY,Starbucks
TXN0000007488,2024-05-15T16:00:18,ACC00006476,Credit,1432.0,-1370801.52,JPY,Grocery
TXN0000007489,2024-08-07T16:06:49,ACC00007725,Payment,292.49,-1371094.01,EUR,Target
TXN0000007490,2024-01-13T12:13:39,ACC00001951,Payment,1846.05,-1372940.06,JPY,Shell
TXN0000007491,2024-10-28T12:27:25,ACC00009392,Payment,643.49,-1373583.55,USD,Starbucks
TXN0000007492,2024-08-29T09:03:18,ACC00003973,Transfer,636.5,-1372947.05,JPY,Shell
TXN0000007493,2024-02-12T22:44:31,ACC00004182,Debit,678.62,-1373625.67,EUR,Amazon
TXN0000007494,2024-12-28T04:47:40,ACC00004786,Credit,1280.43,-1372345.24,USD,Restaurant
TXN0000007495,2024-04-08T13:33:26,ACC00002770,Debit,173.4,-1372518.64,EUR,Grocery
TXN0000007496,2024-09-05T21:55:08,ACC00009850,Credit,812.78,-1371705.86,GBP,Shell
TXN0000007497,2024-04-16T13:35:05,ACC00002696,Debit,942.42,-1372648.28,USD,Shell
TXN0000007498,2024-04-03T13:40:51,ACC00000157,Payment,49.04,-1372697.32,USD,Amazon
TXN0000007499,2024-12-11T09:21:20,ACC00002926,Transfer,1341.56,-1371355.76,EUR,Walmart
TXN0000007500,2024-01-26T19:15:55,ACC00000127,Payment,691.62,-1372047.38,EUR,Walmart
TXN0000007501,2024-04-15T18:30:07,ACC00001286,Payment,1142.36,-1373189.74,EUR,Online Store
TXN0000007502,2024-03-25T16:41:08,ACC00002650,Transfer,539.44,-1372650.3,GBP,Restaurant
TXN0000007503,2024-07-20T18:39:12,ACC00008565,Debit,1170.29,-1373820.59,JPY,Shell
TXN0000007504,2024-01-27T21:53:28,ACC00004128,ATM,627.55,-1374448.14,USD,Grocery
TXN0000007505,2024-08-19T15:34:39,ACC00007580,Payment,1268.71,-1375716.85,JPY,Amazon
TXN0000007506,2024-11-25T02:41:46,ACC00003337,Payment,1269.49,-1376986.34,GBP,Grocery
TXN0000007507,2024-03-20T17:04:17,ACC00005718,ATM,1057.56,-1378043.9,GBP,Shell
TXN0000007508,2024-06-09T19:53:06,ACC00006365,Credit,106.69,-1377937.21,JPY,Restaurant
TXN0000007509,2024-02-01T02:10:40,ACC00000239,Debit,264.83,-1378202.04,USD,Target
TXN0000007510,2024-05-02T02:32:35,ACC00008714,Payment,859.27,-1379061.31,EUR,Shell
TXN0000007511,2024-04-13T06:43:39,ACC00005171,ATM,247.9,-1379309.21,GBP,Shell
TXN0000007512,2024-02-07T12:54:38,ACC00007140,Payment,1204.97,-1380514.18,EUR,Amazon
TXN0000007513,2024-03-02T05:23:38,ACC00002477,Transfer,590.15,-1379924.03,GBP,Grocery
TXN0000007514,2024-01-20T06:26:01,ACC00004343,Credit,142.2,-1379781.83,GBP,Target
TXN0000007515,2024-07-25T08:38:18,ACC00007453,Transfer,1964.29,-1377817.54,GBP,Starbucks
TXN0000007516,2024-07-29T10:37:29,ACC00008788,Payment,1880.74,-1379698.28,USD,Starbucks
TXN0000007517,2024-03-16T04:34:02,ACC00000178,Transfer,808.32,-1378889.96,EUR,Grocery
TXN0000007518,2024-09-13T00:01:06,ACC00005095,Credit,852.42,-1378037.54,EUR,Amazon
TXN0000007519,2024-05-05T04:52:35,ACC00008330,Transfer,438.72,-1377598.82,JPY,Walmart
TXN0000007520,2024-01-14T11:25:49,ACC00006051,Debit,1690.74,-1379289.56,GBP,Amazon
TXN0000007521,2024-03-07T11:51:09,ACC00000753,Payment,154.82,-1379444.38,GBP,Walmart
TXN0000007522,2024-11-12T07:12:01,ACC00008590,ATM,1831.28,-1381275.66,EUR,Target
TXN0000007523,2024-12-30T10:24:11,ACC00009167,Transfer,749.17,-1380526.49,GBP,Online Store
TXN0000007524,2024-01-06T19:46:51,ACC00007796,Debit,1111.72,-1381638.21,JPY,Restaurant
TXN0000007525,2024-06-15T23:23:22,ACC00009504,Transfer,1171.98,-1380466.23,GBP,Starbucks
TXN0000007526,2024-11-26T16:15:33,ACC00006598,Credit,51.16,-1380415.07,USD,Restaurant
TXN0000007527,2024-01-15T16:32:52,ACC00003278,Transfer,1526.25,-1378888.82,JPY,Walmart
TXN0000007528,2024-11-10T03:48:08,ACC00009773,Credit,1929.94,-1376958.88,JPY,Shell
TXN0000007529,2024-10-30T06:16:09,ACC00004393,ATM,715.4,-1377674.28,JPY,Amazon
TXN0000007530,2024-09-25T12:59:25,ACC00002136,Payment,1851.56,-1379525.84,EUR,Shell
TXN0000007531,2024-04-24T17:56:23,ACC00003180,Transfer,630.3,-1378895.54,EUR,Starbucks
TXN0000007532,2024-08-01T22:52:12,ACC00009686,ATM,537.69,-1379433.23,GBP,Starbucks
TXN0000007533,2024-01-20T14:23:07,ACC00001531,ATM,272.73,-1379705.96,JPY,Amazon
TXN0000007534,2024-05-20T01:47:50,ACC00000699,Transfer,695.59,-1379010.37,GBP,Walmart
TXN0000007535,2024-09-11T01:27:03,ACC00007404,Credit,1795.48,-1377214.89,GBP,Grocery
TXN0000007536,2024-03-05T20:55:28,ACC00007081,Credit,940.04,-1376274.85,GBP,Target
TXN0000007537,2024-05-26T20:01:41,ACC00005759,Debit,1365.7,-1377640.55,USD,Walmart
TXN0000007538,2024-11-27T09:39:05,ACC00002387,Debit,606.31,-1378246.86,GBP,Shell
TXN0000007539,2024-11-25T18:36:24,ACC00004942,Transfer,624.51,-1377622.35,USD,Amazon
TXN0000007540,2024-11-22T21:19:11,ACC00001837,Payment,204.24,-1377826.59,USD,Target
TXN0000007541,2024-05-07T09:50:57,ACC00007102,ATM,1772.7,-1379599.29,GBP,Amazon
TXN0000007542,2024-11-17T06:14:58,ACC00002428,Debit,1268.06,-1380867.35,GBP,Amazon
TXN0000007543,2024-12-26T19:18:35,ACC00003322,Payment,824.79,-1381692.14,JPY,Restaurant
TXN0000007544,2024-08-19T17:01:20,ACC00003633,Payment,1289.15,-1382981.29,GBP,Grocery
TXN0000007545,2024-08-03T14:44:24,ACC00005341,Debit,1989.82,-1384971.11,EUR,Shell
TXN0000007546,2024-01-12T18:12:08,ACC00009374,Credit,127.58,-1384843.53,GBP,Target
TXN0000007547,2024-08-29T05:10:08,ACC00002895,Payment,872.4,-1385715.93,USD,Restaurant
TXN0000007548,2024-06-12T00:04:31,ACC00004774,Payment,1411.8,-1387127.73,JPY,Amazon
TXN0000007549,2024-03-05T04:59:32,ACC00005504,Debit,1667.77,-1388795.5,GBP,Restaurant
TXN0000007550,2024-10-22T10:44:05,ACC00008938,Payment,1235.22,-1390030.72,GBP,Amazon
TXN0000007551,2024-10-19T08:16:55,ACC00008028,Credit,244.38,-1389786.34,JPY,Online Store
TXN0000007552,2024-06-30T06:38:36,ACC00005671,ATM,1227.24,-1391013.58,JPY,Amazon
TXN0000007553,2024-12-01T04:03:32,ACC00008957,ATM,952.29,-1391965.87,GBP,Grocery
TXN0000007554,2024-03-10T20:45:17,ACC00002963,Debit,40.33,-1392006.2,JPY,Walmart
TXN0000007555,2024-04-23T03:55:25,ACC00004557,Payment,1294.61,-1393300.81,JPY,Online Store
TXN0000007556,2024-07-06T05:27:08,ACC00001479,ATM,918.63,-1394219.44,JPY,Shell
TXN0000007557,2024-09-24T19:28:38,ACC00001168,Transfer,286.72,-1393932.72,USD,Target
TXN0000007558,2024-07-19T14:23:45,ACC00009494,Debit,581.82,-1394514.54,USD,Starbucks
TXN0000007559,2024-10-11T19:33:03,ACC00007098,ATM,155.36,-1394669.9,USD,Online Store
TXN0000007560,2024-08-11T11:37:59,ACC00008582,Transfer,1776.37,-1392893.53,USD,Starbucks
TXN0000007561,2024-03-31T01:56:30,ACC00006738,Payment,14.69,-1392908.22,GBP,Shell
TXN0000007562,2024-04-30T06:56:42,ACC00000058,Debit,905.93,-1393814.15,USD,Amazon
TXN0000007563,2024-01-21T07:00:10,ACC00005181,Payment,1805.96,-1395620.11,JPY,Amazon
TXN0000007564,2024-06-14T19:54:29,ACC00005376,Debit,52.65,-1395672.76,USD,Grocery
TXN0000007565,2024-02-21T16:04:51,ACC00000006,ATM,1144.13,-1396816.89,JPY,Starbucks
TXN0000007566,2024-10-31T05:45:30,ACC00002253,Payment,1181.44,-1397998.33,GBP,Starbucks
TXN0000007567,2024-08-29T21:34:12,ACC00003044,Credit,954.31,-1397044.02,JPY,Starbucks
TXN0000007568,2024-04-16T01:16:45,ACC00001001,Credit,710.79,-1396333.23,EUR,Online Store
TXN0000007569,2024-09-17T02:45:44,ACC00001620,Transfer,140.99,-1396192.24,JPY,Amazon
TXN0000007570,2024-12-30T22:06:25,ACC00003662,Transfer,550.42,-1395641.82,JPY,Walmart
TXN0000007571,2024-02-15T13:49:47,ACC00009432,ATM,680.3,-1396322.12,JPY,Target
TXN0000007572,2024-03-24T13:35:39,ACC00009235,Transfer,687.4,-1395634.72,GBP,Online Store
TXN0000007573,2024-09-11T13:41:05,ACC00003418,Credit,695.88,-1394938.84,USD,Grocery
TXN0000007574,2024-08-11T15:18:13,ACC00005217,Payment,1301.91,-1396240.75,GBP,Shell
TXN0000007575,2024-01-03T03:47:07,ACC00002294,Debit,1753.92,-1397994.67,USD,Amazon
TXN0000007576,2024-12-02T13:21:49,ACC00000414,Transfer,251.17,-1397743.5,EUR,Amazon
TXN0000007577,2024-04-05T09:31:15,ACC00009270,ATM,1883.99,-1399627.49,JPY,Restaurant
TXN0000007578,2024-04-30T19:02:03,ACC00002969,Credit,300.28,-1399327.21,GBP,Target
TXN0000007579,2024-09-05T23:45:11,ACC00005120,Debit,229.35,-1399556.56,JPY,Walmart
TXN0000007580,2024-05-04T21:11:39,ACC00004580,Payment,1626.19,-1401182.75,JPY,Target
TXN0000007581,2024-03-09T04:39:00,ACC00000706,Debit,1453.83,-1402636.58,USD,Amazon
TXN0000007582,2024-06-27T00:10:41,ACC00002164,ATM,1815.02,-1404451.6,GBP,Target
TXN0000007583,2024-03-11T15:34:27,ACC00001492,Credit,1088.05,-1403363.55,GBP,Online Store
TXN0000007584,2024-11-18T00:58:37,ACC00005006,Transfer,1313.17,-1402050.38,USD,Walmart
TXN0000007585,2024-03-20T23:29:18,ACC00008126,ATM,30.48,-1402080.86,USD,Grocery
TXN0000007586,2024-03-23T13:02:20,ACC00003003,Debit,942.64,-1403023.5,EUR,Restaurant
TXN0000007587,2024-04-06T20:34:24,ACC00009105,ATM,1109.79,-1404133.29,GBP,Shell
TXN0000007588,2024-10-24T09:31:52,ACC00009327,Debit,1279.35,-1405412.64,USD,Target
TXN0000007589,2024-05-22T15:40:08,ACC00003941,ATM,1823.69,-1407236.33,EUR,Shell
TXN0000007590,2024-06-18T19:19:05,ACC00006517,Credit,1501.42,-1405734.91,GBP,Starbucks
TXN0000007591,2024-11-06T11:48:41,ACC00004511,Debit,62.33,-1405797.24,GBP,Grocery
TXN0000007592,2024-09-07T06:36:19,ACC00000068,Debit,714.67,-1406511.91,JPY,Restaurant
TXN0000007593,2024-05-04T14:39:27,ACC00003050,ATM,1231.17,-1407743.08,JPY,Restaurant
TXN0000007594,2024-09-18T17:22:46,ACC00006855,Debit,1708.8,-1409451.88,JPY,Target
TXN0000007595,2024-04-25T04:43:14,ACC00007856,Transfer,1664.11,-1407787.77,EUR,Grocery
TXN0000007596,2024-06-14T10:50:08,ACC00005032,Credit,1863.89,-1405923.88,USD,Shell
TXN0000007597,2024-07-14T19:17:20,ACC00006228,Credit,200.76,-1405723.12,GBP,Online Store
TXN0000007598,2024-05-29T05:54:37,ACC00008683,Credit,1544.36,-1404178.76,JPY,Starbucks
TXN0000007599,2024-09-12T21:34:11,ACC00004095,ATM,364.14,-1404542.9,EUR,Grocery
TXN0000007600,2024-09-07T06:57:32,ACC00007545,ATM,931.73,-1405474.63,EUR,Walmart
TXN0000007601,2024-12-13T02:58:51,ACC00007627,Debit,1178.32,-1406652.95,USD,Restaurant
TXN0000007602,2024-09-13T04:12:28,ACC00009911,Payment,1876.84,-1408529.79,USD,Grocery
TXN0000007603,2024-07-10T14:29:13,ACC00004787,ATM,1892.55,-1410422.34,USD,Amazon
TXN0000007604,2024-10-14T19:47:39,ACC00003813,Transfer,1814.9,-1408607.44,JPY,Shell
TXN0000007605,2024-06-05T00:04:23,ACC00007432,Credit,233.64,-1408373.8,EUR,Online Store
TXN0000007606,2024-11-24T16:14:58,ACC00005683,Credit,407.05,-1407966.75,JPY,Target
TXN0000007607,2024-05-15T03:47:26,ACC00006589,Credit,586.0,-1407380.75,EUR,Grocery
TXN0000007608,2024-01-15T00:20:17,ACC00008302,Credit,839.99,-1406540.76,EUR,Walmart
TXN0000007609,2024-10-18T14:51:24,ACC00001124,ATM,1762.84,-1408303.6,JPY,Restaurant
TXN0000007610,2024-04-11T06:16:46,ACC00005638,Credit,981.78,-1407321.82,JPY,Shell
TXN0000007611,2024-02-04T14:42:43,ACC00004822,Transfer,1780.57,-1405541.25,EUR,Walmart
TXN0000007612,2024-05-23T09:32:17,ACC00009856,Debit,1250.77,-1406792.02,GBP,Restaurant
TXN0000007613,2024-03-25T04:37:44,ACC00002917,Payment,970.99,-1407763.01,EUR,Grocery
TXN0000007614,2024-05-30T07:32:55,ACC00005335,Payment,1029.83,-1408792.84,JPY,Amazon
TXN0000007615,2024-01-10T17:24:15,ACC00000474,Payment,1648.29,-1410441.13,EUR,Amazon
TXN0000007616,2024-06-22T18:00:19,ACC00000952,ATM,1262.06,-1411703.19,JPY,Restaurant
TXN0000007617,2024-06-15T08:52:26,ACC00005411,Credit,349.67,-1411353.52,USD,Amazon
TXN0000007618,2024-07-14T22:43:08,ACC00004272,Debit,1961.67,-1413315.19,USD,Amazon
TXN0000007619,2024-06-19T21:48:43,ACC00003927,ATM,80.02,-1413395.21,EUR,Grocery
TXN0000007620,2024-09-23T00:19:48,ACC00008556,Transfer,1482.94,-1411912.27,EUR,Grocery
TXN0000007621,2024-07-09T12:32:49,ACC00009816,Transfer,558.12,-1411354.15,GBP,Shell
TXN0000007622,2024-10-08T19:41:29,ACC00007469,Credit,897.28,-1410456.87,JPY,Walmart
TXN0000007623,2024-07-01T22:39:08,ACC00009473,Credit,1524.67,-1408932.2,GBP,Grocery
TXN0000007624,2024-10-10T10:11:30,ACC00005448,Debit,1558.7,-1410490.9,JPY,Amazon
TXN0000007625,2024-10-10T06:19:01,ACC00009741,Debit,411.64,-1410902.54,EUR,Restaurant
TXN0000007626,2024-12-14T02:26:03,ACC00006000,ATM,1382.07,-1412284.61,JPY,Online Store
TXN0000007627,2024-07-18T03:59:33,ACC00001656,ATM,796.31,-1413080.92,JPY,Shell
TXN0000007628,2024-01-29T07:38:17,ACC00003970,Payment,800.17,-1413881.09,JPY,Amazon
TXN0000007629,2024-05-06T14:31:05,ACC00007025,Transfer,1699.44,-1412181.65,EUR,Walmart
TXN0000007630,2024-12-14T06:26:33,ACC00008167,Transfer,1959.96,-1410221.69,EUR,Restaurant
TXN0000007631,2024-10-14T15:03:31,ACC00003141,Payment,820.94,-1411042.63,GBP,Shell
TXN0000007632,2024-06-15T01:15:25,ACC00002442,Debit,1302.66,-1412345.29,EUR,Restaurant
TXN0000007633,2024-09-14T01:03:02,ACC00000769,ATM,1577.07,-1413922.36,EUR,Starbucks
TXN0000007634,2024-12-09T12:22:07,ACC00003402,Debit,1259.99,-1415182.35,USD,Grocery
TXN0000007635,2024-07-10T20:58:33,ACC00008070,ATM,939.73,-1416122.08,JPY,Restaurant
TXN0000007636,2024-11-17T11:06:38,ACC00003667,Debit,1815.01,-1417937.09,USD,Starbucks
TXN0000007637,2024-05-01T12:30:12,ACC00000866,Payment,60.3,-1417997.39,USD,Restaurant
TXN0000007638,2024-07-25T09:25:34,ACC00005743,Debit,1937.9,-1419935.29,EUR,Restaurant
TXN0000007639,2024-08-03T01:36:42,ACC00008043,Credit,643.32,-1419291.97,GBP,Shell
TXN0000007640,2024-05-07T08:00:55,ACC00000322,Credit,1487.7,-1417804.27,USD,Walmart
TXN0000007641,2024-09-25T14:42:52,ACC00004826,Payment,371.44,-1418175.71,GBP,Grocery
TXN0000007642,2024-07-16T19:01:22,ACC00004177,Debit,1235.47,-1419411.18,USD,Target
TXN0000007643,2024-04-18T01:10:27,ACC00002811,Credit,635.28,-1418775.9,JPY,Online Store
TXN0000007644,2024-01-22T21:08:40,ACC00002498,Credit,408.37,-1418367.53,GBP,Restaurant
TXN0000007645,2024-08-16T23:44:14,ACC00000378,ATM,1487.36,-1419854.89,USD,Walmart
TXN0000007646,2024-09-10T11:05:48,ACC00007441,Payment,1954.3,-1421809.19,JPY,Online Store
TXN0000007647,2024-06-25T12:37:23,ACC00004821,Debit,873.54,-1422682.73,EUR,Shell
TXN0000007648,2024-05-17T05:27:28,ACC00009068,Payment,1689.81,-1424372.54,JPY,Shell
TXN0000007649,2024-06-02T05:35:49,ACC00001369,Debit,1342.16,-1425714.7,JPY,Restaurant
TXN0000007650,2024-01-19T21:12:27,ACC00004597,Credit,1988.31,-1423726.39,GBP,Target
TXN0000007651,2024-10-17T21:06:10,ACC00000976,Payment,1531.14,-1425257.53,EUR,Target
TXN0000007652,2024-06-29T11:26:16,ACC00004420,Credit,1118.77,-1424138.76,GBP,Restaurant
TXN0000007653,2024-03-18T19:25:28,ACC00008835,Payment,975.63,-1425114.39,GBP,Walmart
TXN0000007654,2024-03-24T05:28:48,ACC00006173,Payment,1378.99,-1426493.38,GBP,Target
TXN0000007655,2024-02-06T06:54:13,ACC00005261,ATM,1465.64,-1427959.02,GBP,Online Store
TXN0000007656,2024-05-21T04:56:55,ACC00006961,Credit,104.31,-1427854.71,USD,Online Store
TXN0000007657,2024-09-08T18:41:10,ACC00008502,Credit,26.95,-1427827.76,JPY,Walmart
TXN0000007658,2024-09-09T01:58:46,ACC00003467,Transfer,1140.92,-1426686.84,USD,Target
TXN0000007659,2024-06-17T09:24:23,ACC00005962,Transfer,448.92,-1426237.92,USD,Walmart
TXN0000007660,2024-12-17T14:47:31,ACC00000930,Debit,165.43,-1426403.35,GBP,Grocery
TXN0000007661,2024-09-12T05:18:10,ACC00001682,Credit,198.89,-1426204.46,USD,Restaurant
TXN0000007662,2024-01-29T01:30:47,ACC00005899,Transfer,254.36,-1425950.1,GBP,Walmart
TXN0000007663,2024-08-07T10:47:24,ACC00009405,Debit,1524.48,-1427474.58,GBP,Restaurant
TXN0000007664,2024-05-31T13:36:01,ACC00009793,Debit,1834.93,-1429309.51,GBP,Starbucks
TXN0000007665,2024-01-04T22:30:58,ACC00005397,ATM,97.55,-1429407.06,USD,Starbucks
TXN0000007666,2024-02-25T13:29:25,ACC00008639,Payment,110.3,-1429517.36,USD,Target
TXN0000007667,2024-11-15T03:10:33,ACC00002447,Transfer,690.27,-1428827.09,JPY,Walmart
TXN0000007668,2024-01-15T01:43:36,ACC00008951,Payment,383.17,-1429210.26,GBP,Amazon
TXN0000007669,2024-06-03T10:05:43,ACC00004752,ATM,1310.85,-1430521.11,USD,Walmart
TXN0000007670,2024-10-07T21:45:38,ACC00003390,ATM,282.14,-1430803.25,USD,Online Store
TXN0000007671,2024-08-13T09:10:29,ACC00008853,Transfer,1647.46,-1429155.79,GBP,Amazon
TXN0000007672,2024-01-18T03:30:48,ACC00006277,Payment,579.19,-1429734.98,JPY,Grocery
TXN0000007673,2024-07-16T06:40:23,ACC00008628,Debit,951.79,-1430686.77,EUR,Target
TXN0000007674,2024-06-20T23:11:14,ACC00009473,Transfer,311.83,-1430374.94,EUR,Target
TXN0000007675,2024-07-06T02:18:30,ACC00008096,Credit,569.95,-1429804.99,EUR,Walmart
TXN0000007676,2024-08-11T08:15:44,ACC00001453,Payment,1287.25,-1431092.24,USD,Target
TXN0000007677,2024-11-20T20:33:24,ACC00000604,Credit,1436.6,-1429655.64,JPY,Online Store
TXN0000007678,2024-03-13T09:43:26,ACC00009612,Transfer,1634.95,-1428020.69,USD,Shell
TXN0000007679,2024-08-05T13:32:29,ACC00009193,Debit,1793.82,-1429814.51,USD,Walmart
TXN0000007680,2024-07-11T22:37:52,ACC00001306,Credit,593.07,-1429221.44,JPY,Starbucks
TXN0000007681,2024-03-19T07:38:39,ACC00002361,Payment,1706.42,-1430927.86,GBP,Shell
TXN0000007682,2024-04-09T20:45:39,ACC00000091,Credit,1756.31,-1429171.55,EUR,Target
TXN0000007683,2024-07-08T04:13:06,ACC00008366,Transfer,1954.31,-1427217.24,JPY,Grocery
TXN0000007684,2024-08-12T05:20:41,ACC00007384,Debit,315.21,-1427532.45,JPY,Online Store
TXN0000007685,2024-04-22T06:51:47,ACC00006465,Credit,1020.09,-1426512.36,USD,Amazon
TXN0000007686,2024-09-28T05:02:42,ACC00006637,Transfer,1721.33,-1424791.03,EUR,Starbucks
TXN0000007687,2024-07-06T03:48:01,ACC00002824,Payment,82.32,-1424873.35,USD,Walmart
TXN0000007688,2024-07-08T19:09:22,ACC00008616,Credit,305.41,-1424567.94,EUR,Amazon
TXN0000007689,2024-03-07T19:23:14,ACC00005494,Debit,181.59,-1424749.53,EUR,Online Store
TXN0000007690,2024-10-16T18:06:38,ACC00000379,Transfer,986.96,-1423762.57,USD,Target
TXN0000007691,2024-10-29T22:31:19,ACC00002010,Credit,1061.42,-1422701.15,JPY,Online Store
TXN0000007692,2024-05-04T23:48:16,ACC00009615,Credit,1930.74,-1420770.41,GBP,Shell
TXN0000007693,2024-08-05T05:22:13,ACC00005593,Debit,1236.45,-1422006.86,JPY,Walmart
TXN0000007694,2024-04-22T03:34:25,ACC00000130,Credit,462.53,-1421544.33,EUR,Online Store
TXN0000007695,2024-10-30T14:37:32,ACC00001948,Transfer,238.51,-1421305.82,USD,Starbucks
TXN0000007696,2024-03-22T13:03:55,ACC00003685,Credit,1097.17,-1420208.65,EUR,Shell
TXN0000007697,2024-03-03T01:05:20,ACC00003475,Transfer,680.45,-1419528.2,EUR,Grocery
TXN0000007698,2024-01-04T09:28:09,ACC00002794,Payment,1040.17,-1420568.37,EUR,Online Store
TXN0000007699,2024-07-22T00:14:29,ACC00007475,Debit,604.0,-1421172.37,EUR,Starbucks
TXN0000007700,2024-12-28T17:26:53,ACC00004901,Transfer,725.06,-1420447.31,USD,Starbucks
TXN0000007701,2024-03-26T06:12:48,ACC00004853,ATM,369.88,-1420817.19,USD,Starbucks
TXN0000007702,2024-02-04T13:02:15,ACC00005151,Payment,1226.1,-1422043.29,GBP,Shell
TXN0000007703,2024-11-08T07:32:39,ACC00001078,Transfer,459.44,-1421583.85,JPY,Shell
TXN0000007704,2024-09-25T18:39:38,ACC00005065,Transfer,282.11,-1421301.74,USD,Target
TXN0000007705,2024-06-29T18:46:04,ACC00007130,Transfer,1682.46,-1419619.28,USD,Restaurant
TXN0000007706,2024-11-20T19:14:42,ACC00004543,Credit,1510.12,-1418109.16,EUR,Target
TXN0000007707,2024-07-19T03:55:56,ACC00007085,ATM,970.28,-1419079.44,USD,Starbucks
TXN0000007708,2024-06-22T11:55:57,ACC00000996,Credit,234.11,-1418845.33,USD,Amazon
TXN0000007709,2024-04-15T09:46:18,ACC00008717,Transfer,544.81,-1418300.52,GBP,Amazon
TXN0000007710,2024-01-25T01:24:28,ACC00001992,Debit,1244.29,-1419544.81,JPY,Restaurant
TXN0000007711,2024-02-07T09:42:01,ACC00009310,Debit,1231.27,-1420776.08,JPY,Walmart
TXN0000007712,2024-07-26T06:22:29,ACC00006214,ATM,833.59,-1421609.67,GBP,Amazon
TXN0000007713,2024-06-19T20:50:23,ACC00004561,Credit,527.2,-1421082.47,USD,Restaurant
TXN0000007714,2024-03-17T06:04:10,ACC00000824,Transfer,835.94,-1420246.53,USD,Shell
TXN0000007715,2024-02-07T12:45:32,ACC00007738,Payment,452.23,-1420698.76,USD,Amazon
TXN0000007716,2024-04-01T14:54:33,ACC00009982,Transfer,291.2,-1420407.56,JPY,Restaurant
TXN0000007717,2024-03-18T15:25:19,ACC00006547,Credit,652.57,-1419754.99,USD,Online Store
TXN0000007718,2024-02-13T05:58:50,ACC00009200,ATM,1155.38,-1420910.37,EUR,Restaurant
TXN0000007719,2024-01-16T20:06:29,ACC00005057,Credit,168.31,-1420742.06,GBP,Starbucks
TXN0000007720,2024-12-09T23:28:40,ACC00004534,Debit,1201.58,-1421943.64,USD,Shell
TXN0000007721,2024-11-30T22:01:35,ACC00006262,ATM,15.12,-1421958.76,USD,Starbucks
TXN0000007722,2024-03-22T01:52:07,ACC00006079,ATM,803.73,-1422762.49,USD,Online Store
TXN0000007723,2024-06-08T10:45:53,ACC00006676,Payment,1284.6,-1424047.09,GBP,Target
TXN0000007724,2024-03-12T11:03:51,ACC00005752,Credit,1807.55,-1422239.54,EUR,Shell
TXN0000007725,2024-09-09T08:44:26,ACC00004613,Transfer,989.83,-1421249.71,EUR,Shell
TXN0000007726,2024-02-08T04:54:29,ACC00002917,Credit,1046.93,-1420202.78,EUR,Target
TXN0000007727,2024-11-12T00:52:18,ACC00001139,ATM,1478.79,-1421681.57,USD,Target
TXN0000007728,2024-01-16T23:58:34,ACC00000412,Transfer,1631.25,-1420050.32,GBP,Starbucks
TXN0000007729,2024-10-05T20:26:06,ACC00009828,Payment,18.24,-1420068.56,EUR,Target
TXN0000007730,2024-11-12T16:39:34,ACC00003403,ATM,1847.6,-1421916.16,EUR,Starbucks
TXN0000007731,2024-05-18T21:12:42,ACC00006754,Credit,1339.07,-1420577.09,EUR,Online Store
TXN0000007732,2024-09-24T19:01:25,ACC00003639,Credit,51.64,-1420525.45,JPY,Amazon
TXN0000007733,2024-06-20T04:57:39,ACC00004303,Transfer,1222.55,-1419302.9,GBP,Online Store
TXN0000007734,2024-03-05T20:35:38,ACC00004169,Debit,1786.09,-1421088.99,EUR,Restaurant
TXN0000007735,2024-01-12T23:13:21,ACC00000165,Payment,96.5,-1421185.49,USD,Target
TXN0000007736,2024-03-17T03:06:38,ACC00000988,Credit,1392.98,-1419792.51,USD,Online Store
TXN0000007737,2024-06-11T19:24:10,ACC00001718,Debit,1185.43,-1420977.94,JPY,Online Store
TXN0000007738,2024-12-20T18:42:38,ACC00004159,Credit,1144.65,-1419833.29,JPY,Walmart
TXN0000007739,2024-01-15T09:36:33,ACC00007255,ATM,746.36,-1420579.65,JPY,Amazon
TXN0000007740,2024-02-19T06:40:34,ACC00006253,Credit,250.82,-1420328.83,EUR,Grocery
TXN0000007741,2024-09-16T08:37:40,ACC00003955,Transfer,902.33,-1419426.5,JPY,Amazon
TXN0000007742,2024-01-24T12:58:14,ACC00009012,ATM,657.41,-1420083.91,JPY,Shell
TXN0000007743,2024-12-02T07:04:11,ACC00006892,Transfer,1915.36,-1418168.55,GBP,Shell
TXN0000007744,2024-10-12T15:33:49,ACC00001854,Credit,1822.93,-1416345.62,USD,Walmart
TXN0000007745,2024-01-19T20:15:23,ACC00005430,ATM,1383.46,-1417729.08,GBP,Restaurant
TXN0000007746,2024-02-01T18:38:24,ACC00009396,ATM,1736.92,-1419466.0,JPY,Amazon
TXN0000007747,2024-02-04T19:57:37,ACC00009386,Payment,537.84,-1420003.84,EUR,Restaurant
TXN0000007748,2024-01-03T07:03:19,ACC00005668,Debit,137.77,-1420141.61,USD,Starbucks
TXN0000007749,2024-10-12T17:42:39,ACC00006237,Debit,1985.66,-1422127.27,USD,Restaurant
TXN0000007750,2024-03-09T02:15:43,ACC00002278,Transfer,612.34,-1421514.93,GBP,Restaurant
TXN0000007751,2024-01-04T11:59:47,ACC00009051,Payment,181.74,-1421696.67,EUR,Grocery
TXN0000007752,2024-03-24T20:19:04,ACC00002305,Payment,1192.94,-1422889.61,USD,Grocery
TXN0000007753,2024-01-19T07:46:02,ACC00001698,Payment,1300.97,-1424190.58,GBP,Walmart
TXN0000007754,2024-05-09T17:35:12,ACC00000255,Credit,784.73,-1423405.85,EUR,Amazon
TXN0000007755,2024-12-06T10:35:56,ACC00005547,Debit,1547.25,-1424953.1,EUR,Online Store
TXN0000007756,2024-07-05T22:57:17,ACC00009479,Debit,1094.83,-1426047.93,USD,Amazon
TXN0000007757,2024-05-31T02:31:25,ACC00006626,Transfer,905.79,-1425142.14,JPY,Amazon
TXN0000007758,2024-01-03T00:07:28,ACC00007916,Transfer,709.07,-1424433.07,USD,Amazon
TXN0000007759,2024-05-08T04:44:33,ACC00005350,ATM,933.24,-1425366.31,USD,Online Store
TXN0000007760,2024-01-18T07:31:53,ACC00004751,Transfer,966.1,-1424400.21,USD,Online Store
TXN0000007761,2024-09-29T09:51:42,ACC00009616,ATM,1621.11,-1426021.32,JPY,Walmart
TXN0000007762,2024-12-03T01:31:15,ACC00007234,Debit,401.95,-1426423.27,JPY,Grocery
TXN0000007763,2024-04-03T21:14:36,ACC00001864,Credit,664.82,-1425758.45,JPY,Restaurant
TXN0000007764,2024-01-24T03:46:05,ACC00008283,ATM,1091.86,-1426850.31,USD,Restaurant
TXN0000007765,2024-07-20T07:14:22,ACC00005054,Credit,217.7,-1426632.61,EUR,Amazon
TXN0000007766,2024-03-01T02:47:43,ACC00006609,ATM,97.01,-1426729.62,GBP,Walmart
TXN0000007767,2024-01-28T21:30:07,ACC00005913,Debit,928.19,-1427657.81,USD,Starbucks
TXN0000007768,2024-01-14T15:47:29,ACC00000395,Debit,411.44,-1428069.25,GBP,Shell
TXN0000007769,2024-12-01T06:44:30,ACC00002458,Transfer,1444.79,-1426624.46,GBP,Starbucks
TXN0000007770,2024-10-15T21:12:56,ACC00004939,ATM,1667.51,-1428291.97,EUR,Online Store
TXN0000007771,2024-02-05T02:26:53,ACC00008497,Debit,1676.08,-1429968.05,JPY,Online Store
TXN0000007772,2024-11-17T12:05:47,ACC00002040,Transfer,364.9,-1429603.15,GBP,Restaurant
TXN0000007773,2024-12-23T21:05:49,ACC00005044,Payment,324.91,-1429928.06,GBP,Online Store
TXN0000007774,2024-02-10T23:08:36,ACC00000367,Transfer,1527.85,-1428400.21,EUR,Walmart
TXN0000007775,2024-10-02T02:04:23,ACC00005399,Payment,458.76,-1428858.97,EUR,Restaurant
TXN0000007776,2024-09-30T01:01:14,ACC00009046,Credit,1621.58,-1427237.39,EUR,Walmart
TXN0000007777,2024-11-26T06:26:03,ACC00007726,ATM,1331.64,-1428569.03,JPY,Amazon
TXN0000007778,2024-11-26T04:02:34,ACC00000168,ATM,1727.69,-1430296.72,USD,Target
TXN0000007779,2024-04-04T15:41:14,ACC00004187,Payment,702.64,-1430999.36,USD,Starbucks
TXN0000007780,2024-12-22T07:20:49,ACC00004948,Payment,1949.81,-1432949.17,GBP,Walmart
TXN0000007781,2024-12-29T07:19:25,ACC00009941,Credit,127.48,-1432821.69,GBP,Restaurant
TXN0000007782,2024-12-14T01:06:31,ACC00000706,Payment,866.08,-1433687.77,GBP,Shell
TXN0000007783,2024-08-08T19:11:04,ACC00007115,Payment,286.72,-1433974.49,EUR,Starbucks
TXN0000007784,2024-04-20T05:32:21,ACC00000290,Transfer,1881.55,-1432092.94,USD,Restaurant
TXN0000007785,2024-11-30T20:29:14,ACC00000961,Credit,1629.19,-1430463.75,USD,Walmart
TXN0000007786,2024-10-31T13:24:15,ACC00005249,Debit,976.01,-1431439.76,JPY,Starbucks
TXN0000007787,2024-08-18T18:35:52,ACC00002987,Payment,206.96,-1431646.72,EUR,Restaurant
TXN0000007788,2024-01-15T15:47:40,ACC00008976,Payment,975.75,-1432622.47,GBP,Grocery
TXN0000007789,2024-01-12T19:05:25,ACC00000010,Credit,544.29,-1432078.18,USD,Grocery
TXN0000007790,2024-03-15T02:54:58,ACC00001018,ATM,1023.19,-1433101.37,EUR,Restaurant
TXN0000007791,2024-06-15T10:34:21,ACC00003983,Credit,1817.7,-1431283.67,GBP,Grocery
TXN0000007792,2024-12-13T05:24:30,ACC00004064,Credit,369.82,-1430913.85,GBP,Starbucks
TXN0000007793,2024-06-08T23:47:47,ACC00004026,Debit,1372.69,-1432286.54,EUR,Restaurant
TXN0000007794,2024-05-14T19:09:31,ACC00002262,Transfer,1947.19,-1430339.35,EUR,Online Store
TXN0000007795,2024-01-11T14:19:59,ACC00007245,Credit,1433.9,-1428905.45,JPY,Grocery
TXN0000007796,2024-07-18T15:16:23,ACC00004874,Payment,213.95,-1429119.4,EUR,Grocery
TXN0000007797,2024-04-21T04:05:33,ACC00007603,Debit,1190.67,-1430310.07,JPY,Amazon
TXN0000007798,2024-02-13T18:29:11,ACC00003256,Payment,727.46,-1431037.53,JPY,Amazon
TXN0000007799,2024-04-12T13:42:51,ACC00005394,Payment,1736.42,-1432773.95,JPY,Walmart
TXN0000007800,2024-12-01T23:44:56,ACC00009661,Credit,1919.32,-1430854.63,EUR,Shell
TXN0000007801,2024-06-14T01:49:39,ACC00005341,ATM,1919.94,-1432774.57,JPY,Shell
TXN0000007802,2024-01-08T20:28:49,ACC00000448,Transfer,1573.06,-1431201.51,EUR,Amazon
TXN0000007803,2024-04-01T13:32:51,ACC00005944,Credit,1113.34,-1430088.17,USD,Starbucks
TXN0000007804,2024-06-12T05:37:32,ACC00000409,Debit,83.91,-1430172.08,USD,Walmart
TXN0000007805,2024-12-06T18:24:53,ACC00001604,Credit,452.05,-1429720.03,GBP,Online Store
TXN0000007806,2024-06-01T05:54:12,ACC00001762,Transfer,776.95,-1428943.08,GBP,Amazon
TXN0000007807,2024-11-07T20:27:19,ACC00004078,Payment,1888.25,-1430831.33,JPY,Restaurant
TXN0000007808,2024-05-23T02:36:48,ACC00008427,Debit,1748.29,-1432579.62,GBP,Shell
TXN0000007809,2024-08-31T10:12:50,ACC00000588,Credit,933.04,-1431646.58,USD,Target
TXN0000007810,2024-10-05T19:15:28,ACC00000510,ATM,1390.23,-1433036.81,EUR,Target
TXN0000007811,2024-12-22T01:34:36,ACC00001366,Debit,820.04,-1433856.85,JPY,Grocery
TXN0000007812,2024-05-14T02:23:13,ACC00000324,Transfer,1969.21,-1431887.64,USD,Restaurant
TXN0000007813,2024-11-24T10:55:45,ACC00007270,Payment,555.03,-1432442.67,JPY,Starbucks
TXN0000007814,2024-01-06T15:30:40,ACC00000724,ATM,1682.45,-1434125.12,USD,Grocery
TXN0000007815,2024-11-16T19:26:06,ACC00004138,Credit,893.57,-1433231.55,EUR,Walmart
TXN0000007816,2024-05-05T11:24:48,ACC00004413,Credit,1992.95,-1431238.6,EUR,Online Store
TXN0000007817,2024-09-15T07:06:22,ACC00008305,ATM,166.02,-1431404.62,USD,Target
TXN0000007818,2024-05-16T15:38:23,ACC00005722,Credit,432.0,-1430972.62,GBP,Walmart
TXN0000007819,2024-12-01T17:40:47,ACC00005339,ATM,796.98,-1431769.6,EUR,Shell
TXN0000007820,2024-02-17T00:01:16,ACC00005617,Payment,476.04,-1432245.64,USD,Amazon
TXN0000007821,2024-07-13T01:02:33,ACC00003002,Payment,1306.95,-1433552.59,USD,Restaurant
TXN0000007822,2024-03-08T23:01:00,ACC00002025,ATM,1927.67,-1435480.26,EUR,Grocery
TXN0000007823,2024-09-30T13:09:30,ACC00000332,Payment,1937.21,-1437417.47,JPY,Starbucks
TXN0000007824,2024-09-15T18:38:43,ACC00002396,Credit,1733.17,-1435684.3,GBP,Walmart
TXN0000007825,2024-10-08T02:14:54,ACC00002402,Debit,1330.59,-1437014.89,JPY,Starbucks
TXN0000007826,2024-09-20T11:07:20,ACC00001100,Payment,534.22,-1437549.11,GBP,Grocery
TXN0000007827,2024-01-03T21:18:12,ACC00009989,ATM,558.53,-1438107.64,EUR,Shell
TXN0000007828,2024-08-19T22:57:24,ACC00008361,Credit,707.43,-1437400.21,JPY,Online Store
TXN0000007829,2024-09-25T02:04:02,ACC00008898,Payment,378.7,-1437778.91,USD,Restaurant
TXN0000007830,2024-05-25T00:45:10,ACC00004580,Credit,1673.75,-1436105.16,USD,Online Store
TXN0000007831,2024-06-05T04:19:08,ACC00002692,Transfer,936.8,-1435168.36,USD,Online Store
TXN0000007832,2024-07-18T03:40:08,ACC00008755,Debit,341.98,-1435510.34,USD,Grocery
TXN0000007833,2024-02-07T06:45:44,ACC00002131,Debit,425.88,-1435936.22,EUR,Restaurant
TXN0000007834,2024-12-19T23:13:44,ACC00005443,ATM,842.49,-1436778.71,JPY,Starbucks
TXN0000007835,2024-03-21T23:18:02,ACC00009995,Debit,1144.83,-1437923.54,JPY,Grocery
TXN0000007836,2024-01-02T09:41:33,ACC00002952,Credit,1581.08,-1436342.46,EUR,Amazon
TXN0000007837,2024-07-28T03:39:33,ACC00002455,Debit,824.78,-1437167.24,EUR,Starbucks
TXN0000007838,2024-05-12T22:33:58,ACC00008120,Debit,1509.07,-1438676.31,GBP,Online Store
TXN0000007839,2024-11-04T08:20:25,ACC00004683,Transfer,834.62,-1437841.69,USD,Shell
TXN0000007840,2024-06-08T15:23:25,ACC00009428,Debit,750.48,-1438592.17,USD,Walmart
TXN0000007841,2024-12-26T22:53:01,ACC00006632,ATM,286.28,-1438878.45,GBP,Starbucks
TXN0000007842,2024-05-23T12:42:40,ACC00006490,Debit,1253.48,-1440131.93,JPY,Starbucks
TXN0000007843,2024-10-21T21:12:21,ACC00004031,Payment,1240.92,-1441372.85,GBP,Amazon
TXN0000007844,2024-09-11T18:15:34,ACC00006307,Payment,1588.61,-1442961.46,JPY,Amazon
TXN0000007845,2024-02-29T00:14:56,ACC00009565,Transfer,15.97,-1442945.49,GBP,Amazon
TXN0000007846,2024-06-10T01:32:23,ACC00001113,ATM,479.41,-1443424.9,GBP,Target
TXN0000007847,2024-10-22T07:14:30,ACC00003408,Credit,1417.74,-1442007.16,EUR,Walmart
TXN0000007848,2024-07-29T03:00:30,ACC00005272,Debit,940.25,-1442947.41,GBP,Amazon
TXN0000007849,2024-05-14T14:59:31,ACC00007891,Debit,1435.44,-1444382.85,JPY,Amazon
TXN0000007850,2024-07-08T02:18:49,ACC00002334,Credit,1342.88,-1443039.97,GBP,Shell
TXN0000007851,2024-01-16T17:59:00,ACC00001064,Debit,1714.87,-1444754.84,EUR,Restaurant
TXN0000007852,2024-03-25T22:30:08,ACC00002398,Credit,847.63,-1443907.21,JPY,Restaurant
TXN0000007853,2024-09-16T00:33:25,ACC00006936,Payment,1741.87,-1445649.08,EUR,Shell
TXN0000007854,2024-07-03T01:48:54,ACC00009752,ATM,1310.38,-1446959.46,USD,Grocery
TXN0000007855,2024-11-02T05:04:05,ACC00001868,Credit,217.77,-1446741.69,USD,Walmart
TXN0000007856,2024-01-04T20:51:21,ACC00007375,Credit,151.57,-1446590.12,EUR,Amazon
TXN0000007857,2024-02-10T18:48:21,ACC00007328,Credit,714.56,-1445875.56,USD,Amazon
TXN0000007858,2024-04-19T17:30:38,ACC00002580,Credit,1883.39,-1443992.17,USD,Shell
TXN0000007859,2024-02-07T10:46:51,ACC00009764,Debit,1708.65,-1445700.82,GBP,Shell
TXN0000007860,2024-11-24T23:26:09,ACC00009575,Credit,534.29,-1445166.53,USD,Grocery
TXN0000007861,2024-09-15T22:17:21,ACC00004710,Payment,444.33,-1445610.86,USD,Starbucks
TXN0000007862,2024-03-15T03:20:43,ACC00003370,Payment,812.95,-1446423.81,USD,Shell
TXN0000007863,2024-01-16T07:53:21,ACC00001733,Payment,1972.35,-1448396.16,JPY,Walmart
TXN0000007864,2024-06-03T18:16:42,ACC00004804,ATM,1703.6,-1450099.76,EUR,Grocery
TXN0000007865,2024-11-25T14:50:55,ACC00001582,Payment,645.16,-1450744.92,JPY,Shell
TXN0000007866,2024-04-26T23:13:46,ACC00002216,ATM,178.08,-1450923.0,USD,Restaurant
TXN0000007867,2024-01-09T17:29:14,ACC00009688,Credit,1844.92,-1449078.08,EUR,Shell
TXN0000007868,2024-09-26T12:47:36,ACC00005194,Debit,1087.35,-1450165.43,EUR,Target
TXN0000007869,2024-10-13T06:19:11,ACC00001408,Credit,900.69,-1449264.74,USD,Amazon
TXN0000007870,2024-05-13T00:50:32,ACC00008223,Transfer,152.19,-1449112.55,JPY,Walmart
TXN0000007871,2024-05-01T19:08:54,ACC00009263,Transfer,1125.4,-1447987.15,USD,Amazon
TXN0000007872,2024-09-18T09:19:30,ACC00000500,Payment,1827.89,-1449815.04,GBP,Starbucks
TXN0000007873,2024-05-21T15:13:45,ACC00000691,Credit,291.18,-1449523.86,GBP,Grocery
TXN0000007874,2024-08-31T00:31:41,ACC00005196,ATM,1010.37,-1450534.23,USD,Shell
TXN0000007875,2024-07-01T02:23:27,ACC00002441,Debit,876.05,-1451410.28,GBP,Restaurant
TXN0000007876,2024-01-26T23:39:20,ACC00007011,ATM,1447.25,-1452857.53,GBP,Grocery
TXN0000007877,2024-10-28T07:38:43,ACC00009335,ATM,1207.58,-1454065.11,GBP,Shell
TXN0000007878,2024-11-07T16:45:27,ACC00000519,Transfer,1068.63,-1452996.48,GBP,Restaurant
TXN0000007879,2024-11-21T13:25:26,ACC00003581,Debit,465.04,-1453461.52,USD,Online Store
TXN0000007880,2024-02-29T03:10:44,ACC00006938,Credit,663.56,-1452797.96,EUR,Online Store
TXN0000007881,2024-08-20T17:37:41,ACC00002253,ATM,570.25,-1453368.21,EUR,Starbucks
TXN0000007882,2024-07-07T10:38:05,ACC00003579,Credit,110.22,-1453257.99,EUR,Online Store
TXN0000007883,2024-01-30T03:22:27,ACC00003387,Payment,36.06,-1453294.05,GBP,Starbucks
TXN0000007884,2024-10-30T16:56:34,ACC00007854,ATM,893.05,-1454187.1,GBP,Walmart
TXN0000007885,2024-09-21T08:33:12,ACC00000483,Payment,1866.18,-1456053.28,USD,Walmart
TXN0000007886,2024-12-15T18:03:25,ACC00009845,Debit,644.95,-1456698.23,GBP,Online Store
TXN0000007887,2024-01-04T20:00:46,ACC00009945,Credit,1933.5,-1454764.73,EUR,Starbucks
TXN0000007888,2024-01-12T13:16:43,ACC00009231,Transfer,858.24,-1453906.49,USD,Starbucks
TXN0000007889,2024-02-17T12:34:38,ACC00008345,Credit,265.15,-1453641.34,JPY,Amazon
TXN0000007890,2024-09-05T03:50:45,ACC00008729,Transfer,265.14,-1453376.2,GBP,Restaurant
TXN0000007891,2024-03-26T18:17:34,ACC00003137,Debit,360.09,-1453736.29,GBP,Walmart
TXN0000007892,2024-07-29T14:04:28,ACC00002580,Transfer,1011.87,-1452724.42,JPY,Walmart
TXN0000007893,2024-03-18T18:27:12,ACC00001590,Payment,645.2,-1453369.62,USD,Amazon
TXN0000007894,2024-03-29T20:35:12,ACC00000944,Transfer,1225.73,-1452143.89,JPY,Online Store
TXN0000007895,2024-06-25T18:54:58,ACC00000476,Debit,1808.67,-1453952.56,JPY,Grocery
TXN0000007896,2024-11-27T07:36:09,ACC00006605,ATM,257.95,-1454210.51,GBP,Target
TXN0000007897,2024-05-17T15:00:18,ACC00003129,ATM,314.06,-1454524.57,USD,Restaurant
TXN0000007898,2024-05-13T00:27:35,ACC00006676,Transfer,1504.59,-1453019.98,JPY,Starbucks
TXN0000007899,2024-01-25T13:30:50,ACC00006707,Transfer,1970.6,-1451049.38,GBP,Online Store
TXN0000007900,2024-10-08T16:34:24,ACC00005111,Payment,1900.8,-1452950.18,EUR,Starbucks
TXN0000007901,2024-03-27T00:30:45,ACC00000055,Debit,685.26,-1453635.44,GBP,Amazon
TXN0000007902,2024-03-11T03:01:18,ACC00001920,Credit,1606.06,-1452029.38,USD,Amazon
TXN0000007903,2024-07-19T18:26:32,ACC00005298,ATM,471.69,-1452501.07,JPY,Walmart
TXN0000007904,2024-10-18T19:57:32,ACC00000405,Payment,958.53,-1453459.6,JPY,Amazon
TXN0000007905,2024-11-29T11:39:59,ACC00000992,Credit,1355.88,-1452103.72,JPY,Online Store
TXN0000007906,2024-12-04T09:19:16,ACC00004395,Transfer,208.77,-1451894.95,EUR,Starbucks
TXN0000007907,2024-07-01T19:43:52,ACC00003935,ATM,1434.62,-1453329.57,EUR,Shell
TXN0000007908,2024-04-13T01:27:16,ACC00001067,Debit,1184.27,-1454513.84,GBP,Restaurant
TXN0000007909,2024-06-01T06:03:50,ACC00001746,Credit,763.07,-1453750.77,JPY,Restaurant
TXN0000007910,2024-04-12T22:25:10,ACC00006156,Payment,820.34,-1454571.11,JPY,Amazon
TXN0000007911,2024-11-05T07:02:48,ACC00003991,Debit,909.17,-1455480.28,JPY,Grocery
TXN0000007912,2024-10-12T09:42:09,ACC00006621,Credit,71.8,-1455408.48,GBP,Shell
TXN0000007913,2024-12-16T23:51:48,ACC00007188,Payment,267.74,-1455676.22,EUR,Walmart
TXN0000007914,2024-12-25T00:32:51,ACC00006481,Credit,311.61,-1455364.61,GBP,Shell
TXN0000007915,2024-07-12T00:29:03,ACC00006795,Transfer,1270.09,-1454094.52,JPY,Target
TXN0000007916,2024-02-29T19:39:10,ACC00005359,Debit,1735.74,-1455830.26,GBP,Grocery
TXN0000007917,2024-10-05T03:20:04,ACC00001869,Credit,1334.62,-1454495.64,JPY,Online Store
TXN0000007918,2024-03-13T09:11:27,ACC00006082,ATM,1534.81,-1456030.45,GBP,Walmart
TXN0000007919,2024-05-27T22:58:10,ACC00005168,Debit,1634.17,-1457664.62,GBP,Target
TXN0000007920,2024-06-20T09:14:38,ACC00002837,Transfer,881.94,-1456782.68,JPY,Amazon
TXN0000007921,2024-02-24T19:51:47,ACC00003562,Payment,23.07,-1456805.75,GBP,Starbucks
TXN0000007922,2024-06-15T14:30:41,ACC00004830,Payment,1849.55,-1458655.3,JPY,Walmart
TXN0000007923,2024-07-03T22:43:18,ACC00006211,Debit,691.98,-1459347.28,GBP,Target
TXN0000007924,2024-03-02T05:50:30,ACC00004914,Transfer,828.46,-1458518.82,EUR,Amazon
TXN0000007925,2024-04-29T07:43:45,ACC00000627,ATM,812.34,-1459331.16,GBP,Grocery
TXN0000007926,2024-04-19T00:18:29,ACC00003198,Debit,681.69,-1460012.85,USD,Target
TXN0000007927,2024-08-08T20:52:24,ACC00000069,Payment,1333.53,-1461346.38,EUR,Walmart
TXN0000007928,2024-10-25T00:05:07,ACC00001380,Payment,1143.38,-1462489.76,GBP,Starbucks
TXN0000007929,2024-07-02T17:21:55,ACC00002386,Debit,698.47,-1463188.23,EUR,Online Store
TXN0000007930,2024-03-01T01:48:14,ACC00007579,Debit,1739.91,-1464928.14,EUR,Online Store
TXN0000007931,2024-12-10T17:38:22,ACC00007195,Debit,800.08,-1465728.22,USD,Restaurant
TXN0000007932,2024-11-19T22:10:49,ACC00007712,Transfer,563.05,-1465165.17,JPY,Starbucks
TXN0000007933,2024-02-11T19:18:10,ACC00001051,Credit,108.01,-1465057.16,USD,Walmart
TXN0000007934,2024-07-12T18:17:43,ACC00005580,Credit,1078.83,-1463978.33,USD,Shell
TXN0000007935,2024-03-26T03:01:49,ACC00004664,Debit,1881.56,-1465859.89,EUR,Online Store
TXN0000007936,2024-11-15T04:08:52,ACC00001649,Credit,962.05,-1464897.84,JPY,Shell
TXN0000007937,2024-12-07T03:21:30,ACC00004438,ATM,1609.16,-1466507.0,USD,Restaurant
TXN0000007938,2024-12-12T22:03:28,ACC00001205,ATM,1231.55,-1467738.55,JPY,Grocery
TXN0000007939,2024-10-25T06:43:53,ACC00007368,Credit,406.62,-1467331.93,EUR,Restaurant
TXN0000007940,2024-10-23T08:59:11,ACC00009233,Credit,1691.3,-1465640.63,USD,Grocery
TXN0000007941,2024-07-15T20:44:23,ACC00007392,Payment,1341.44,-1466982.07,USD,Restaurant
TXN0000007942,2024-10-21T05:49:56,ACC00009858,Payment,120.88,-1467102.95,USD,Walmart
TXN0000007943,2024-03-05T01:38:46,ACC00007951,Credit,1826.38,-1465276.57,JPY,Amazon
TXN0000007944,2024-08-23T07:20:53,ACC00003463,Debit,1374.49,-1466651.06,EUR,Target
TXN0000007945,2024-01-13T15:32:49,ACC00004832,ATM,36.44,-1466687.5,EUR,Restaurant
TXN0000007946,2024-11-09T14:43:29,ACC00008531,ATM,796.87,-1467484.37,JPY,Target
TXN0000007947,2024-01-04T15:58:44,ACC00009718,Transfer,798.5,-1466685.87,EUR,Online Store
TXN0000007948,2024-11-17T22:09:24,ACC00005340,ATM,995.72,-1467681.59,EUR,Grocery
TXN0000007949,2024-02-16T14:18:49,ACC00000255,ATM,474.79,-1468156.38,GBP,Grocery
TXN0000007950,2024-07-14T23:45:38,ACC00002967,Payment,246.16,-1468402.54,JPY,Starbucks
TXN0000007951,2024-07-31T14:11:36,ACC00001313,ATM,113.85,-1468516.39,GBP,Shell
TXN0000007952,2024-12-07T08:37:01,ACC00009366,Credit,302.13,-1468214.26,USD,Shell
TXN0000007953,2024-03-26T19:58:14,ACC00003444,Credit,937.04,-1467277.22,GBP,Starbucks
TXN0000007954,2024-08-11T08:56:03,ACC00003260,Credit,1732.04,-1465545.18,JPY,Shell
TXN0000007955,2024-12-18T13:40:04,ACC00007329,Transfer,1819.72,-1463725.46,EUR,Amazon
TXN0000007956,2024-12-16T22:30:53,ACC00009801,Payment,1484.48,-1465209.94,GBP,Shell
TXN0000007957,2024-12-01T10:41:57,ACC00001235,Credit,905.47,-1464304.47,USD,Shell
TXN0000007958,2024-01-17T19:07:18,ACC00003167,ATM,1684.48,-1465988.95,JPY,Walmart
TXN0000007959,2024-12-25T18:26:31,ACC00007761,Debit,1530.49,-1467519.44,EUR,Starbucks
TXN0000007960,2024-12-29T18:06:17,ACC00005718,Transfer,276.21,-1467243.23,JPY,Walmart
TXN0000007961,2024-02-14T00:12:26,ACC00001732,Payment,1989.09,-1469232.32,USD,Starbucks
TXN0000007962,2024-08-18T14:04:52,ACC00008018,Credit,1060.19,-1468172.13,JPY,Walmart
TXN0000007963,2024-04-29T19:06:10,ACC00003718,ATM,338.85,-1468510.98,GBP,Shell
TXN0000007964,2024-07-07T08:08:34,ACC00002170,Credit,1149.79,-1467361.19,JPY,Shell
TXN0000007965,2024-12-17T10:41:35,ACC00002684,ATM,414.14,-1467775.33,GBP,Amazon
TXN0000007966,2024-10-27T12:38:52,ACC00008787,Credit,740.27,-1467035.06,EUR,Walmart
TXN0000007967,2024-03-26T12:59:50,ACC00004315,ATM,872.59,-1467907.65,EUR,Amazon
TXN0000007968,2024-03-21T09:17:39,ACC00004792,Transfer,665.69,-1467241.96,EUR,Online Store
TXN0000007969,2024-01-02T16:10:12,ACC00007909,Credit,1291.16,-1465950.8,JPY,Online Store
TXN0000007970,2024-06-19T14:21:51,ACC00007491,Debit,1777.46,-1467728.26,EUR,Walmart
TXN0000007971,2024-09-06T04:14:00,ACC00005869,Credit,296.52,-1467431.74,JPY,Walmart
TXN0000007972,2024-06-27T17:45:00,ACC00001010,ATM,561.41,-1467993.15,GBP,Restaurant
TXN0000007973,2024-12-21T12:32:06,ACC00000609,Payment,1504.4,-1469497.55,USD,Online Store
TXN0000007974,2024-09-16T13:30:17,ACC00001790,ATM,1440.86,-1470938.41,GBP,Walmart
TXN0000007975,2024-03-30T15:48:31,ACC00009459,ATM,298.76,-1471237.17,JPY,Amazon
TXN0000007976,2024-02-17T10:55:29,ACC00006731,Debit,1671.25,-1472908.42,JPY,Starbucks
TXN0000007977,2024-01-16T18:40:35,ACC00008325,ATM,1454.42,-1474362.84,GBP,Shell
TXN0000007978,2024-08-28T06:35:45,ACC00004243,Transfer,1435.53,-1472927.31,JPY,Online Store
TXN0000007979,2024-11-28T22:45:41,ACC00004068,ATM,871.98,-1473799.29,JPY,Shell
TXN0000007980,2024-07-05T09:02:47,ACC00000636,Transfer,761.51,-1473037.78,GBP,Starbucks
TXN0000007981,2024-10-29T18:51:35,ACC00002957,Payment,1609.08,-1474646.86,JPY,Starbucks
TXN0000007982,2024-07-09T06:02:12,ACC00006294,Payment,455.21,-1475102.07,GBP,Grocery
TXN0000007983,2024-04-02T21:12:54,ACC00002719,Transfer,1625.3,-1473476.77,EUR,Starbucks
TXN0000007984,2024-06-25T01:36:42,ACC00003701,Payment,1990.62,-1475467.39,EUR,Amazon
TXN0000007985,2024-05-09T10:52:42,ACC00005463,Payment,751.4,-1476218.79,GBP,Starbucks
TXN0000007986,2024-04-02T00:07:01,ACC00009954,Transfer,1350.53,-1474868.26,USD,Restaurant
TXN0000007987,2024-08-29T00:02:00,ACC00002508,Transfer,1046.27,-1473821.99,JPY,Shell
TXN0000007988,2024-02-11T22:09:47,ACC00003605,Transfer,703.77,-1473118.22,USD,Restaurant
TXN0000007989,2024-07-19T10:50:29,ACC00009923,Credit,911.32,-1472206.9,JPY,Shell
TXN0000007990,2024-03-09T18:37:08,ACC00005732,ATM,1687.8,-1473894.7,EUR,Amazon
TXN0000007991,2024-10-10T12:33:42,ACC00005159,ATM,1717.58,-1475612.28,EUR,Target
TXN0000007992,2024-07-09T11:29:19,ACC00002955,ATM,1796.33,-1477408.61,USD,Online Store
TXN0000007993,2024-03-10T12:05:38,ACC00001119,Credit,776.29,-1476632.32,JPY,Target
TXN0000007994,2024-07-04T00:27:23,ACC00006717,Debit,498.5,-1477130.82,JPY,Starbucks
TXN0000007995,2024-01-13T14:55:35,ACC00003063,Payment,754.95,-1477885.77,EUR,Grocery
TXN0000007996,2024-11-27T07:08:52,ACC00000773,ATM,909.07,-1478794.84,GBP,Online Store
TXN0000007997,2024-07-01T18:16:52,ACC00004746,Debit,1069.41,-1479864.25,USD,Grocery
TXN0000007998,2024-07-15T22:17:32,ACC00008041,Credit,368.6,-1479495.65,USD,Starbucks
TXN0000007999,2024-05-31T03:14:01,ACC00003259,Transfer,56.57,-1479439.08,JPY,Target
TXN0000008000,2024-09-11T18:15:10,ACC00008790,Debit,1939.75,-1481378.83,JPY,Walmart
TXN0000008001,2024-03-04T01:30:05,ACC00000254,Debit,1732.09,-1483110.92,JPY,Grocery
TXN0000008002,2024-04-03T15:32:39,ACC00006619,Credit,1658.86,-1481452.06,USD,Grocery
TXN0000008003,2024-05-25T14:14:47,ACC00005677,Transfer,745.35,-1480706.71,EUR,Restaurant
TXN0000008004,2024-06-30T10:19:29,ACC00005716,Debit,1090.35,-1481797.06,EUR,Online Store
TXN0000008005,2024-11-07T17:07:41,ACC00002194,Transfer,1683.21,-1480113.85,USD,Grocery
TXN0000008006,2024-12-22T03:27:20,ACC00004430,Transfer,1839.96,-1478273.89,JPY,Walmart
TXN0000008007,2024-07-23T00:04:37,ACC00009161,Debit,596.83,-1478870.72,EUR,Target
TXN0000008008,2024-10-04T10:52:58,ACC00001952,Payment,851.09,-1479721.81,USD,Shell
TXN0000008009,2024-03-16T06:02:49,ACC00009660,ATM,1359.68,-1481081.49,EUR,Target
TXN0000008010,2024-06-24T04:33:45,ACC00002915,Transfer,1145.18,-1479936.31,JPY,Online Store
TXN0000008011,2024-07-01T19:25:56,ACC00001467,ATM,1313.67,-1481249.98,EUR,Grocery
TXN0000008012,2024-07-30T01:48:05,ACC00009883,ATM,1011.65,-1482261.63,JPY,Walmart
TXN0000008013,2024-08-18T19:42:25,ACC00003489,Transfer,1908.6,-1480353.03,JPY,Amazon
TXN0000008014,2024-02-01T05:21:14,ACC00003930,ATM,810.76,-1481163.79,GBP,Grocery
TXN0000008015,2024-12-19T16:58:48,ACC00009477,Debit,1330.34,-1482494.13,USD,Walmart
TXN0000008016,2024-02-02T00:29:57,ACC00009975,Payment,657.84,-1483151.97,USD,Walmart
TXN0000008017,2024-07-05T09:17:18,ACC00007851,ATM,944.96,-1484096.93,JPY,Restaurant
TXN0000008018,2024-05-27T21:28:14,ACC00006012,Credit,1620.05,-1482476.88,USD,Restaurant
TXN0000008019,2024-10-06T15:44:51,ACC00000913,Debit,501.49,-1482978.37,EUR,Target
TXN0000008020,2024-11-08T01:43:23,ACC00001775,ATM,69.44,-1483047.81,GBP,Grocery
TXN0000008021,2024-03-13T19:43:25,ACC00003542,Payment,839.94,-1483887.75,GBP,Online Store
TXN0000008022,2024-04-03T10:22:36,ACC00005471,Debit,687.47,-1484575.22,JPY,Starbucks
TXN0000008023,2024-10-06T16:23:53,ACC00002407,Credit,1902.47,-1482672.75,GBP,Amazon
TXN0000008024,2024-07-16T17:13:11,ACC00009449,Credit,989.52,-1481683.23,EUR,Starbucks
TXN0000008025,2024-07-06T11:02:41,ACC00006343,Credit,1585.99,-1480097.24,EUR,Online Store
TXN0000008026,2024-04-05T22:47:50,ACC00008114,Debit,732.89,-1480830.13,JPY,Restaurant
TXN0000008027,2024-11-06T03:16:02,ACC00003831,ATM,1105.24,-1481935.37,GBP,Restaurant
TXN0000008028,2024-07-11T19:12:25,ACC00003730,Debit,936.41,-1482871.78,GBP,Shell
TXN0000008029,2024-08-21T18:08:59,ACC00007216,Debit,176.14,-1483047.92,EUR,Online Store
TXN0000008030,2024-09-30T13:02:38,ACC00000439,Credit,1821.09,-1481226.83,USD,Target
TXN0000008031,2024-09-21T19:09:51,ACC00005685,Transfer,1420.93,-1479805.9,GBP,Target
TXN0000008032,2024-05-01T22:22:25,ACC00001262,Credit,598.61,-1479207.29,EUR,Target
TXN0000008033,2024-01-12T18:46:44,ACC00006329,Transfer,1088.5,-1478118.79,GBP,Target
TXN0000008034,2024-11-03T20:44:59,ACC00009748,Credit,1589.89,-1476528.9,EUR,Amazon
TXN0000008035,2024-07-22T19:35:55,ACC00005345,Transfer,148.85,-1476380.05,EUR,Target
TXN0000008036,2024-04-21T14:11:57,ACC00008310,ATM,1122.91,-1477502.96,USD,Online Store
TXN0000008037,2024-09-03T13:57:52,ACC00004484,Debit,1902.2,-1479405.16,EUR,Grocery
TXN0000008038,2024-04-22T11:14:34,ACC00007819,Transfer,1831.67,-1477573.49,JPY,Online Store
TXN0000008039,2024-02-14T05:32:56,ACC00004572,ATM,1484.04,-1479057.53,JPY,Online Store
TXN0000008040,2024-01-14T11:07:37,ACC00007180,Credit,1986.58,-1477070.95,EUR,Target
TXN0000008041,2024-04-17T09:58:53,ACC00008820,Debit,948.07,-1478019.02,JPY,Amazon
TXN0000008042,2024-07-23T08:40:32,ACC00000397,Payment,232.49,-1478251.51,EUR,Shell
TXN0000008043,2024-08-15T01:11:40,ACC00005602,Payment,1794.12,-1480045.63,USD,Shell
TXN0000008044,2024-12-02T10:45:55,ACC00005189,Payment,1971.77,-1482017.4,EUR,Shell
TXN0000008045,2024-03-29T22:23:29,ACC00005097,Payment,515.9,-1482533.3,JPY,Amazon
TXN0000008046,2024-08-15T13:44:07,ACC00003137,ATM,517.75,-1483051.05,USD,Grocery
TXN0000008047,2024-04-13T20:02:09,ACC00001750,Credit,486.32,-1482564.73,EUR,Walmart
TXN0000008048,2024-09-04T19:28:41,ACC00008138,Credit,400.15,-1482164.58,USD,Grocery
TXN0000008049,2024-07-28T11:14:10,ACC00007941,ATM,298.17,-1482462.75,JPY,Target
TXN0000008050,2024-08-27T23:34:18,ACC00001886,Debit,1299.69,-1483762.44,USD,Restaurant
TXN0000008051,2024-11-05T16:51:18,ACC00001088,Payment,1496.12,-1485258.56,EUR,Shell
TXN0000008052,2024-11-24T00:16:54,ACC00002113,Transfer,339.73,-1484918.83,GBP,Starbucks
TXN0000008053,2024-01-16T10:17:41,ACC00008290,Transfer,1830.39,-1483088.44,JPY,Restaurant
TXN0000008054,2024-09-28T06:10:30,ACC00002781,ATM,1474.23,-1484562.67,EUR,Restaurant
TXN0000008055,2024-07-31T12:08:23,ACC00003865,Credit,577.12,-1483985.55,EUR,Target
TXN0000008056,2024-07-26T00:09:52,ACC00008234,Debit,1592.92,-1485578.47,JPY,Grocery
TXN0000008057,2024-02-09T09:20:13,ACC00006959,Debit,568.51,-1486146.98,GBP,Restaurant
TXN0000008058,2024-06-22T09:03:15,ACC00002265,Credit,1284.9,-1484862.08,USD,Target
TXN0000008059,2024-07-19T03:02:19,ACC00005498,Transfer,1003.68,-1483858.4,GBP,Grocery
TXN0000008060,2024-05-27T13:52:47,ACC00005749,Transfer,1611.5,-1482246.9,EUR,Starbucks
TXN0000008061,2024-05-30T05:53:48,ACC00000507,Credit,1281.15,-1480965.75,USD,Restaurant
TXN0000008062,2024-02-26T23:49:57,ACC00005564,ATM,693.4,-1481659.15,EUR,Shell
TXN0000008063,2024-07-16T19:02:29,ACC00005646,ATM,1790.46,-1483449.61,USD,Walmart
TXN0000008064,2024-04-03T02:01:00,ACC00004747,Transfer,1927.0,-1481522.61,EUR,Online Store
TXN0000008065,2024-09-03T01:49:29,ACC00005006,Transfer,961.63,-1480560.98,GBP,Grocery
TXN0000008066,2024-04-09T18:10:48,ACC00002118,Debit,1758.36,-1482319.34,USD,Target
TXN0000008067,2024-12-11T02:38:57,ACC00002784,Transfer,1838.04,-1480481.3,EUR,Restaurant
TXN0000008068,2024-01-07T04:34:14,ACC00000427,Transfer,1820.76,-1478660.54,USD,Shell
TXN0000008069,2024-10-04T08:26:02,ACC00008714,Transfer,1483.9,-1477176.64,JPY,Grocery
TXN0000008070,2024-03-17T05:40:04,ACC00000383,Credit,1231.31,-1475945.33,GBP,Starbucks
TXN0000008071,2024-12-16T09:58:44,ACC00005462,ATM,1654.96,-1477600.29,EUR,Target
TXN0000008072,2024-10-27T18:36:15,ACC00003596,Credit,330.95,-1477269.34,JPY,Target
TXN0000008073,2024-11-21T17:58:23,ACC00005338,Payment,1903.96,-1479173.3,EUR,Target
TXN0000008074,2024-12-05T22:55:40,ACC00003174,Transfer,544.64,-1478628.66,EUR,Grocery
TXN0000008075,2024-07-24T16:22:22,ACC00006222,Transfer,883.07,-1477745.59,GBP,Online Store
TXN0000008076,2024-01-28T19:49:12,ACC00003632,Debit,812.98,-1478558.57,EUR,Grocery
TXN0000008077,2024-10-12T07:53:11,ACC00009403,Transfer,1997.07,-1476561.5,USD,Amazon
TXN0000008078,2024-06-07T05:26:46,ACC00003567,Credit,1273.46,-1475288.04,USD,Shell
TXN0000008079,2024-01-29T11:54:31,ACC00005563,Transfer,761.75,-1474526.29,EUR,Target
TXN0000008080,2024-12-13T02:08:27,ACC00008575,Debit,440.34,-1474966.63,GBP,Online Store
TXN0000008081,2024-01-29T15:35:50,ACC00001176,Debit,1154.47,-1476121.1,USD,Walmart
TXN0000008082,2024-03-27T21:01:06,ACC00002254,Payment,143.63,-1476264.73,EUR,Walmart
TXN0000008083,2024-11-12T15:43:59,ACC00005418,Credit,268.89,-1475995.84,USD,Grocery
TXN0000008084,2024-06-20T02:42:19,ACC00007378,Payment,457.98,-1476453.82,USD,Walmart
TXN0000008085,2024-02-04T16:27:29,ACC00000256,ATM,550.8,-1477004.62,USD,Starbucks
TXN0000008086,2024-07-07T21:49:54,ACC00003212,ATM,1579.7,-1478584.32,JPY,Restaurant
TXN0000008087,2024-05-15T09:56:36,ACC00003839,Transfer,1896.55,-1476687.77,EUR,Amazon
TXN0000008088,2024-07-04T08:10:04,ACC00000482,ATM,1701.59,-1478389.36,EUR,Walmart
TXN0000008089,2024-12-23T22:58:58,ACC00003856,ATM,1970.94,-1480360.3,EUR,Amazon
TXN0000008090,2024-04-10T14:49:48,ACC00009268,Credit,650.57,-1479709.73,EUR,Amazon
TXN0000008091,2024-11-15T10:54:35,ACC00007465,Debit,1493.18,-1481202.91,JPY,Walmart
TXN0000008092,2024-01-30T15:45:01,ACC00004911,Debit,1825.68,-1483028.59,EUR,Grocery
TXN0000008093,2024-04-10T06:07:12,ACC00004775,Payment,1802.31,-1484830.9,GBP,Walmart
TXN0000008094,2024-12-09T08:30:51,ACC00000301,Credit,1545.23,-1483285.67,JPY,Grocery
TXN0000008095,2024-01-19T15:03:47,ACC00005787,ATM,1696.55,-1484982.22,EUR,Target
TXN0000008096,2024-01-17T22:58:49,ACC00007336,Payment,1639.63,-1486621.85,JPY,Shell
TXN0000008097,2024-11-06T17:13:26,ACC00008926,ATM,1411.57,-1488033.42,EUR,Restaurant
TXN0000008098,2024-10-03T22:05:20,ACC00002921,Debit,745.63,-1488779.05,GBP,Walmart
TXN0000008099,2024-03-22T07:31:20,ACC00002036,ATM,1677.82,-1490456.87,USD,Amazon
TXN0000008100,2024-10-28T09:53:13,ACC00001714,Credit,1347.6,-1489109.27,JPY,Grocery
TXN0000008101,2024-11-11T00:44:27,ACC00002537,Credit,295.72,-1488813.55,USD,Walmart
TXN0000008102,2024-12-23T11:00:08,ACC00002190,Credit,585.7,-1488227.85,EUR,Starbucks
TXN0000008103,2024-03-22T14:14:00,ACC00003452,Transfer,1480.66,-1486747.19,JPY,Amazon
TXN0000008104,2024-08-04T06:18:58,ACC00004705,Payment,1104.55,-1487851.74,GBP,Shell
TXN0000008105,2024-08-01T12:32:33,ACC00006842,Transfer,73.4,-1487778.34,EUR,Walmart
TXN0000008106,2024-09-03T16:59:30,ACC00007864,Payment,283.89,-1488062.23,GBP,Walmart
TXN0000008107,2024-07-09T20:52:52,ACC00002575,Payment,298.34,-1488360.57,USD,Online Store
TXN0000008108,2024-03-15T08:21:00,ACC00007485,Payment,1555.04,-1489915.61,GBP,Starbucks
TXN0000008109,2024-04-05T02:40:54,ACC00005889,Credit,670.02,-1489245.59,GBP,Target
TXN0000008110,2024-01-05T10:04:51,ACC00005148,Credit,1496.55,-1487749.04,USD,Target
TXN0000008111,2024-05-03T11:03:30,ACC00002689,Payment,1236.25,-1488985.29,JPY,Shell
TXN0000008112,2024-09-13T08:54:30,ACC00009144,Payment,93.16,-1489078.45,USD,Online Store
TXN0000008113,2024-09-08T03:32:18,ACC00000742,Credit,1740.36,-1487338.09,USD,Online Store
TXN0000008114,2024-07-05T14:25:50,ACC00009926,Debit,1645.09,-1488983.18,EUR,Walmart
TXN0000008115,2024-11-05T13:37:08,ACC00009993,ATM,768.98,-1489752.16,USD,Walmart
TXN0000008116,2024-02-17T09:46:02,ACC00004960,ATM,91.3,-1489843.46,JPY,Starbucks
TXN0000008117,2024-04-24T05:19:57,ACC00001145,Payment,614.13,-1490457.59,JPY,Shell
TXN0000008118,2024-07-07T13:14:03,ACC00007257,Transfer,1635.62,-1488821.97,EUR,Target
TXN0000008119,2024-01-26T08:37:58,ACC00005262,Debit,1728.85,-1490550.82,EUR,Online Store
TXN0000008120,2024-11-16T05:21:09,ACC00001026,Payment,1340.85,-1491891.67,JPY,Target
TXN0000008121,2024-10-15T17:48:28,ACC00005453,Credit,223.72,-1491667.95,JPY,Grocery
TXN0000008122,2024-07-17T18:09:22,ACC00000007,ATM,387.69,-1492055.64,EUR,Walmart
TXN0000008123,2024-04-14T04:23:16,ACC00001003,ATM,1668.14,-1493723.78,GBP,Starbucks
TXN0000008124,2024-06-17T04:31:59,ACC00002282,ATM,1497.42,-1495221.2,GBP,Amazon
TXN0000008125,2024-06-12T00:26:23,ACC00009161,ATM,1363.14,-1496584.34,EUR,Target
TXN0000008126,2024-12-11T22:13:17,ACC00001945,Transfer,1489.95,-1495094.39,JPY,Grocery
TXN0000008127,2024-07-02T12:12:36,ACC00005293,Debit,1112.17,-1496206.56,GBP,Online Store
TXN0000008128,2024-05-25T06:05:20,ACC00000809,ATM,720.28,-1496926.84,GBP,Shell
TXN0000008129,2024-08-14T16:14:49,ACC00008019,Credit,274.65,-1496652.19,EUR,Target
TXN0000008130,2024-12-15T14:06:06,ACC00000848,ATM,809.63,-1497461.82,JPY,Walmart
TXN0000008131,2024-04-16T05:25:04,ACC00003991,Debit,240.11,-1497701.93,JPY,Starbucks
TXN0000008132,2024-02-22T00:19:29,ACC00009487,Payment,539.59,-1498241.52,GBP,Shell
TXN0000008133,2024-01-27T23:10:18,ACC00006284,Transfer,1571.92,-1496669.6,GBP,Online Store
TXN0000008134,2024-10-08T00:32:45,ACC00000181,Debit,1367.2,-1498036.8,EUR,Starbucks
TXN0000008135,2024-06-07T18:01:56,ACC00002892,Credit,1324.19,-1496712.61,GBP,Starbucks
TXN0000008136,2024-05-16T07:49:11,ACC00007905,Debit,759.16,-1497471.77,USD,Walmart
TXN0000008137,2024-03-17T20:35:03,ACC00003790,Credit,1945.95,-1495525.82,JPY,Starbucks
TXN0000008138,2024-02-26T05:08:12,ACC00005913,Debit,1712.06,-1497237.88,JPY,Walmart
TXN0000008139,2024-12-26T02:20:32,ACC00003636,ATM,1808.95,-1499046.83,GBP,Online Store
TXN0000008140,2024-03-18T22:41:06,ACC00001225,Debit,632.96,-1499679.79,GBP,Amazon
TXN0000008141,2024-08-23T11:55:10,ACC00009195,ATM,340.21,-1500020.0,EUR,Shell
TXN0000008142,2024-03-19T13:13:43,ACC00006184,Payment,1336.63,-1501356.63,USD,Target
TXN0000008143,2024-08-07T03:39:38,ACC00002875,Payment,62.14,-1501418.77,GBP,Online Store
TXN0000008144,2024-12-12T06:13:35,ACC00008911,Payment,285.57,-1501704.34,USD,Shell
TXN0000008145,2024-02-16T02:07:09,ACC00006448,ATM,71.2,-1501775.54,JPY,Grocery
TXN0000008146,2024-12-12T10:28:11,ACC00005145,Transfer,247.04,-1501528.5,EUR,Amazon
TXN0000008147,2024-06-04T10:47:58,ACC00007163,Payment,34.66,-1501563.16,USD,Restaurant
TXN0000008148,2024-05-19T10:40:22,ACC00007325,Debit,1092.42,-1502655.58,EUR,Shell
TXN0000008149,2024-07-25T00:20:09,ACC00006209,Payment,493.34,-1503148.92,GBP,Restaurant
TXN0000008150,2024-06-16T18:10:14,ACC00009407,Credit,1752.16,-1501396.76,USD,Restaurant
TXN0000008151,2024-01-25T19:40:26,ACC00002348,Credit,1613.46,-1499783.3,USD,Online Store
TXN0000008152,2024-07-30T17:46:20,ACC00002272,ATM,211.72,-1499995.02,JPY,Restaurant
TXN0000008153,2024-11-22T17:01:29,ACC00009242,ATM,1011.44,-1501006.46,USD,Online Store
TXN0000008154,2024-04-17T01:26:53,ACC00005286,Transfer,1177.86,-1499828.6,USD,Starbucks
TXN0000008155,2024-12-17T02:11:40,ACC00009073,Debit,724.78,-1500553.38,GBP,Online Store
TXN0000008156,2024-12-01T00:25:52,ACC00004461,Credit,1058.9,-1499494.48,USD,Walmart
TXN0000008157,2024-07-23T08:24:06,ACC00006683,Credit,1915.16,-1497579.32,EUR,Online Store
TXN0000008158,2024-07-29T18:49:36,ACC00001407,ATM,1425.01,-1499004.33,JPY,Amazon
TXN0000008159,2024-08-30T21:08:15,ACC00008581,Credit,877.18,-1498127.15,JPY,Online Store
TXN0000008160,2024-11-14T06:32:19,ACC00008575,ATM,411.38,-1498538.53,JPY,Online Store
TXN0000008161,2024-03-21T14:00:13,ACC00005510,Credit,1087.26,-1497451.27,GBP,Shell
TXN0000008162,2024-09-15T04:58:12,ACC00001719,Credit,737.39,-1496713.88,GBP,Grocery
TXN0000008163,2024-11-20T19:57:18,ACC00001001,Transfer,497.74,-1496216.14,GBP,Grocery
TXN0000008164,2024-11-01T18:56:22,ACC00009473,Payment,1309.53,-1497525.67,JPY,Target
TXN0000008165,2024-05-03T19:18:30,ACC00007840,Payment,22.87,-1497548.54,EUR,Restaurant
TXN0000008166,2024-01-30T07:21:50,ACC00002706,ATM,1184.21,-1498732.75,GBP,Target
TXN0000008167,2024-03-03T05:52:09,ACC00001619,Payment,1149.82,-1499882.57,USD,Restaurant
TXN0000008168,2024-09-01T02:43:21,ACC00005919,Payment,981.29,-1500863.86,USD,Starbucks
TXN0000008169,2024-09-17T04:58:20,ACC00006590,Debit,1186.72,-1502050.58,USD,Restaurant
TXN0000008170,2024-06-19T22:17:33,ACC00005164,Credit,591.55,-1501459.03,EUR,Shell
TXN0000008171,2024-06-05T03:45:17,ACC00002940,Payment,1678.38,-1503137.41,USD,Grocery
TXN0000008172,2024-09-11T01:16:05,ACC00008434,Debit,56.9,-1503194.31,USD,Amazon
TXN0000008173,2024-01-07T01:02:01,ACC00009610,Payment,1110.98,-1504305.29,EUR,Online Store
TXN0000008174,2024-05-14T09:47:58,ACC00001761,ATM,1222.0,-1505527.29,GBP,Walmart
TXN0000008175,2024-11-15T00:37:09,ACC00000064,Payment,501.84,-1506029.13,EUR,Target
TXN0000008176,2024-10-29T03:41:46,ACC00007922,Debit,1986.95,-1508016.08,USD,Shell
TXN0000008177,2024-05-27T19:32:51,ACC00004085,Transfer,799.52,-1507216.56,USD,Target
TXN0000008178,2024-09-25T21:54:26,ACC00001874,Debit,1111.95,-1508328.51,GBP,Online Store
TXN0000008179,2024-01-14T10:35:55,ACC00003723,Transfer,193.98,-1508134.53,JPY,Restaurant
TXN0000008180,2024-03-14T06:25:01,ACC00001938,Debit,398.14,-1508532.67,GBP,Shell
TXN0000008181,2024-07-06T06:09:19,ACC00003668,Transfer,1225.46,-1507307.21,USD,Walmart
TXN0000008182,2024-09-17T11:49:52,ACC00005758,Payment,1061.58,-1508368.79,EUR,Online Store
TXN0000008183,2024-07-28T04:28:11,ACC00007670,Payment,1705.71,-1510074.5,EUR,Online Store
TXN0000008184,2024-05-06T20:25:46,ACC00006994,Credit,1055.58,-1509018.92,JPY,Grocery
TXN0000008185,2024-06-09T05:47:41,ACC00004001,Transfer,117.22,-1508901.7,EUR,Starbucks
TXN0000008186,2024-10-01T11:33:34,ACC00009510,ATM,511.74,-1509413.44,EUR,Target
TXN0000008187,2024-11-14T14:03:32,ACC00006675,Credit,972.79,-1508440.65,EUR,Starbucks
TXN0000008188,2024-02-02T03:24:36,ACC00002765,Payment,1742.89,-1510183.54,JPY,Walmart
TXN0000008189,2024-09-19T22:22:12,ACC00008894,Credit,1661.12,-1508522.42,USD,Walmart
TXN0000008190,2024-03-14T05:38:33,ACC00004026,Credit,1297.83,-1507224.59,JPY,Walmart
TXN0000008191,2024-11-23T09:02:51,ACC00005894,ATM,1849.4,-1509073.99,USD,Grocery
TXN0000008192,2024-12-19T11:27:24,ACC00009047,Debit,1616.22,-1510690.21,USD,Grocery
TXN0000008193,2024-09-04T16:53:44,ACC00007439,Credit,709.46,-1509980.75,JPY,Online Store
TXN0000008194,2024-06-24T13:37:33,ACC00005999,Debit,842.79,-1510823.54,JPY,Online Store
TXN0000008195,2024-10-05T17:41:04,ACC00009761,Debit,795.51,-1511619.05,GBP,Online Store
TXN0000008196,2024-01-09T21:00:01,ACC00002346,Credit,547.14,-1511071.91,EUR,Restaurant
TXN0000008197,2024-03-11T14:29:33,ACC00009723,Credit,843.15,-1510228.76,JPY,Walmart
TXN0000008198,2024-03-08T05:09:13,ACC00001130,Credit,1825.02,-1508403.74,USD,Restaurant
TXN0000008199,2024-11-25T08:14:15,ACC00009206,Credit,186.42,-1508217.32,EUR,Starbucks
TXN0000008200,2024-03-03T03:25:47,ACC00006209,ATM,434.89,-1508652.21,GBP,Online Store
TXN0000008201,2024-09-14T17:29:33,ACC00008539,Payment,199.01,-1508851.22,JPY,Starbucks
TXN0000008202,2024-05-30T09:00:11,ACC00006909,ATM,1986.43,-1510837.65,JPY,Restaurant
TXN0000008203,2024-08-21T00:59:16,ACC00005745,ATM,301.05,-1511138.7,GBP,Online Store
TXN0000008204,2024-09-17T09:24:35,ACC00000739,Credit,660.1,-1510478.6,USD,Target
TXN0000008205,2024-02-07T21:02:18,ACC00006835,Payment,1613.65,-1512092.25,USD,Grocery
TXN0000008206,2024-11-16T07:39:51,ACC00000114,ATM,278.06,-1512370.31,EUR,Shell
TXN0000008207,2024-07-29T02:41:11,ACC00007670,Credit,1355.35,-1511014.96,JPY,Grocery
TXN0000008208,2024-04-16T18:01:42,ACC00005201,Transfer,1639.86,-1509375.1,USD,Walmart
TXN0000008209,2024-04-24T03:59:46,ACC00001008,Payment,1896.38,-1511271.48,JPY,Walmart
TXN0000008210,2024-03-03T16:50:44,ACC00008663,Payment,452.67,-1511724.15,USD,Starbucks
TXN0000008211,2024-03-05T15:34:29,ACC00004210,Debit,853.15,-1512577.3,JPY,Walmart
TXN0000008212,2024-09-05T09:50:26,ACC00000401,Transfer,1147.09,-1511430.21,GBP,Amazon
TXN0000008213,2024-04-13T00:47:08,ACC00007658,Payment,677.0,-1512107.21,GBP,Grocery
TXN0000008214,2024-03-02T06:51:59,ACC00000129,ATM,1997.05,-1514104.26,JPY,Walmart
TXN0000008215,2024-11-12T06:21:05,ACC00005417,Transfer,1196.67,-1512907.59,GBP,Grocery
TXN0000008216,2024-02-29T20:18:27,ACC00003492,Payment,1714.76,-1514622.35,EUR,Grocery
TXN0000008217,2024-12-10T16:20:47,ACC00004271,Debit,1790.52,-1516412.87,EUR,Starbucks
TXN0000008218,2024-01-23T01:23:46,ACC00002162,ATM,1067.48,-1517480.35,USD,Target
TXN0000008219,2024-11-14T15:24:25,ACC00006535,Transfer,794.6,-1516685.75,JPY,Walmart
TXN0000008220,2024-12-13T08:37:06,ACC00005796,Payment,1291.13,-1517976.88,GBP,Online Store
TXN0000008221,2024-09-19T00:59:39,ACC00001204,ATM,1383.28,-1519360.16,GBP,Grocery
TXN0000008222,2024-03-18T17:31:58,ACC00001891,ATM,127.57,-1519487.73,USD,Walmart
TXN0000008223,2024-09-12T18:43:56,ACC00009523,Payment,1698.21,-1521185.94,GBP,Starbucks
TXN0000008224,2024-11-16T21:14:23,ACC00005723,ATM,1833.48,-1523019.42,GBP,Shell
TXN0000008225,2024-11-02T23:51:24,ACC00005237,ATM,1700.47,-1524719.89,JPY,Walmart
TXN0000008226,2024-10-03T10:51:01,ACC00005167,Payment,1330.57,-1526050.46,JPY,Starbucks
TXN0000008227,2024-01-05T07:21:43,ACC00009481,Debit,1255.4,-1527305.86,EUR,Online Store
TXN0000008228,2024-10-04T16:04:52,ACC00000949,Debit,1002.16,-1528308.02,EUR,Grocery
TXN0000008229,2024-03-06T23:06:12,ACC00006074,Credit,1334.19,-1526973.83,EUR,Target
TXN0000008230,2024-11-18T09:13:28,ACC00003040,Payment,84.77,-1527058.6,JPY,Shell
TXN0000008231,2024-12-22T22:14:39,ACC00000081,Transfer,315.12,-1526743.48,GBP,Restaurant
TXN0000008232,2024-06-26T05:09:21,ACC00003298,Transfer,1654.92,-1525088.56,USD,Online Store
TXN0000008233,2024-08-16T23:13:06,ACC00002201,Credit,1353.48,-1523735.08,USD,Shell
TXN0000008234,2024-05-13T21:54:06,ACC00007497,Payment,1368.59,-1525103.67,USD,Shell
TXN0000008235,2024-08-10T13:24:44,ACC00008480,Transfer,1341.99,-1523761.68,GBP,Online Store
TXN0000008236,2024-04-17T21:09:23,ACC00002794,ATM,599.74,-1524361.42,USD,Restaurant
TXN0000008237,2024-01-29T14:44:30,ACC00005848,Transfer,663.11,-1523698.31,EUR,Walmart
TXN0000008238,2024-01-20T13:46:31,ACC00001192,Transfer,1833.68,-1521864.63,USD,Starbucks
TXN0000008239,2024-01-01T17:07:25,ACC00004788,ATM,1197.79,-1523062.42,EUR,Target
TXN0000008240,2024-12-30T19:26:03,ACC00001120,Debit,1871.04,-1524933.46,GBP,Amazon
TXN0000008241,2024-03-31T18:26:47,ACC00004350,Debit,436.36,-1525369.82,JPY,Online Store
TXN0000008242,2024-05-13T12:24:36,ACC00003613,Debit,886.58,-1526256.4,USD,Starbucks
TXN0000008243,2024-08-15T01:50:11,ACC00007781,Credit,1949.82,-1524306.58,EUR,Restaurant
TXN0000008244,2024-07-27T16:28:34,ACC00008293,Credit,1198.23,-1523108.35,JPY,Restaurant
TXN0000008245,2024-11-21T23:44:04,ACC00002930,ATM,857.39,-1523965.74,GBP,Shell
TXN0000008246,2024-05-16T19:51:44,ACC00009679,ATM,932.14,-1524897.88,GBP,Online Store
TXN0000008247,2024-08-12T11:01:01,ACC00008242,Credit,95.49,-1524802.39,EUR,Walmart
TXN0000008248,2024-11-06T18:27:14,ACC00007531,Payment,256.29,-1525058.68,JPY,Restaurant
TXN0000008249,2024-11-02T16:08:06,ACC00008608,Payment,1622.63,-1526681.31,USD,Target
TXN0000008250,2024-03-04T21:39:35,ACC00008836,Debit,554.52,-1527235.83,GBP,Amazon
TXN0000008251,2024-11-02T07:47:50,ACC00005126,Payment,1827.48,-1529063.31,USD,Shell
TXN0000008252,2024-08-17T09:23:20,ACC00004175,Credit,1025.9,-1528037.41,USD,Restaurant
TXN0000008253,2024-09-30T12:03:20,ACC00002859,Debit,1372.91,-1529410.32,USD,Target
TXN0000008254,2024-06-12T09:42:23,ACC00008872,Debit,1116.63,-1530526.95,USD,Walmart
TXN0000008255,2024-01-19T02:51:31,ACC00005516,Debit,1821.49,-1532348.44,EUR,Amazon
TXN0000008256,2024-09-28T18:51:44,ACC00004847,Debit,743.25,-1533091.69,USD,Restaurant
TXN0000008257,2024-10-15T07:52:46,ACC00004020,Credit,30.58,-1533061.11,JPY,Starbucks
TXN0000008258,2024-01-24T12:35:25,ACC00001738,Transfer,1051.27,-1532009.84,USD,Target
TXN0000008259,2024-01-25T06:02:16,ACC00009349,Payment,1028.62,-1533038.46,EUR,Amazon
TXN0000008260,2024-01-01T08:38:38,ACC00002957,Payment,1539.67,-1534578.13,GBP,Shell
TXN0000008261,2024-12-18T01:38:34,ACC00009865,Payment,1827.27,-1536405.4,EUR,Online Store
TXN0000008262,2024-04-09T08:09:17,ACC00005141,Transfer,686.26,-1535719.14,EUR,Target
TXN0000008263,2024-03-10T16:11:35,ACC00002031,Transfer,906.51,-1534812.63,EUR,Grocery
TXN0000008264,2024-03-27T01:03:53,ACC00002050,Transfer,846.09,-1533966.54,GBP,Starbucks
TXN0000008265,2024-01-27T03:57:25,ACC00004157,Credit,570.89,-1533395.65,USD,Online Store
TXN0000008266,2024-06-06T06:29:08,ACC00007029,Transfer,94.72,-1533300.93,EUR,Amazon
TXN0000008267,2024-12-02T15:25:29,ACC00002922,Transfer,1984.66,-1531316.27,GBP,Amazon
TXN0000008268,2024-01-07T13:55:06,ACC00004963,Transfer,1972.2,-1529344.07,JPY,Restaurant
TXN0000008269,2024-03-18T20:02:06,ACC00006430,Transfer,950.32,-1528393.75,JPY,Target
TXN0000008270,2024-06-11T12:54:57,ACC00006444,Transfer,419.09,-1527974.66,EUR,Online Store
TXN0000008271,2024-06-08T04:54:45,ACC00004228,Transfer,893.07,-1527081.59,EUR,Starbucks
TXN0000008272,2024-05-24T16:15:25,ACC00000959,Transfer,1967.09,-1525114.5,JPY,Target
TXN0000008273,2024-03-06T15:43:01,ACC00005613,Debit,1004.96,-1526119.46,JPY,Shell
TXN0000008274,2024-03-30T02:46:01,ACC00001605,Transfer,60.02,-1526059.44,JPY,Starbucks
TXN0000008275,2024-01-18T00:37:42,ACC00003723,Debit,1250.4,-1527309.84,GBP,Restaurant
TXN0000008276,2024-10-27T01:17:06,ACC00008833,Debit,1571.27,-1528881.11,GBP,Shell
TXN0000008277,2024-04-02T21:19:53,ACC00003500,Transfer,1266.98,-1527614.13,EUR,Amazon
TXN0000008278,2024-09-05T08:45:30,ACC00004934,Debit,1982.26,-1529596.39,GBP,Restaurant
TXN0000008279,2024-11-20T18:22:18,ACC00002067,Payment,1415.12,-1531011.51,GBP,Starbucks
TXN0000008280,2024-12-22T05:38:00,ACC00003764,Credit,682.19,-1530329.32,USD,Target
TXN0000008281,2024-01-15T08:29:59,ACC00003153,Debit,1192.26,-1531521.58,JPY,Target
TXN0000008282,2024-08-08T21:49:33,ACC00009544,Debit,203.11,-1531724.69,USD,Amazon
TXN0000008283,2024-09-23T09:07:44,ACC00005965,ATM,399.54,-1532124.23,EUR,Target
TXN0000008284,2024-07-25T08:47:05,ACC00000484,ATM,1037.13,-1533161.36,JPY,Starbucks
TXN0000008285,2024-01-13T10:31:54,ACC00002701,Credit,1146.58,-1532014.78,GBP,Shell
TXN0000008286,2024-02-04T19:47:30,ACC00001816,ATM,601.15,-1532615.93,EUR,Target
TXN0000008287,2024-01-05T14:03:45,ACC00007051,Debit,319.5,-1532935.43,EUR,Shell
TXN0000008288,2024-05-29T19:48:05,ACC00007514,Transfer,919.61,-1532015.82,GBP,Restaurant
TXN0000008289,2024-11-12T12:10:26,ACC00005651,ATM,1748.27,-1533764.09,GBP,Grocery
TXN0000008290,2024-02-28T09:54:50,ACC00004330,ATM,1414.86,-1535178.95,JPY,Target
TXN0000008291,2024-09-15T14:19:15,ACC00004814,Transfer,450.06,-1534728.89,JPY,Grocery
TXN0000008292,2024-09-27T21:14:46,ACC00003381,Debit,990.23,-1535719.12,USD,Amazon
TXN0000008293,2024-11-14T05:20:24,ACC00001936,Credit,213.68,-1535505.44,USD,Shell
TXN0000008294,2024-01-14T20:08:23,ACC00002380,Transfer,1547.72,-1533957.72,USD,Amazon
TXN0000008295,2024-09-11T17:31:36,ACC00005820,Transfer,1923.51,-1532034.21,EUR,Starbucks
TXN0000008296,2024-12-01T16:47:13,ACC00009084,Debit,128.49,-1532162.7,GBP,Restaurant
TXN0000008297,2024-03-28T00:56:15,ACC00003981,Payment,1589.18,-1533751.88,GBP,Target
TXN0000008298,2024-11-25T08:49:34,ACC00004192,Debit,994.47,-1534746.35,USD,Grocery
TXN0000008299,2024-10-01T01:52:57,ACC00006687,ATM,1613.0,-1536359.35,USD,Grocery
TXN0000008300,2024-11-02T02:48:15,ACC00002030,Transfer,1890.67,-1534468.68,USD,Grocery
TXN0000008301,2024-05-30T13:00:37,ACC00007397,ATM,1784.13,-1536252.81,JPY,Target
TXN0000008302,2024-03-19T08:57:48,ACC00005647,ATM,938.89,-1537191.7,GBP,Amazon
TXN0000008303,2024-10-09T08:04:35,ACC00008330,ATM,1328.47,-1538520.17,GBP,Target
TXN0000008304,2024-11-02T14:51:01,ACC00002180,Credit,293.09,-1538227.08,GBP,Walmart
TXN0000008305,2024-04-28T17:25:17,ACC00005583,Credit,499.32,-1537727.76,EUR,Walmart
TXN0000008306,2024-10-19T05:21:21,ACC00005238,Transfer,1222.16,-1536505.6,USD,Starbucks
TXN0000008307,2024-04-02T09:25:05,ACC00008500,Transfer,1097.46,-1535408.14,GBP,Amazon
TXN0000008308,2024-07-13T09:51:30,ACC00003668,ATM,281.49,-1535689.63,EUR,Grocery
TXN0000008309,2024-06-16T06:05:38,ACC00002918,Credit,59.05,-1535630.58,GBP,Amazon
TXN0000008310,2024-09-26T15:46:41,ACC00000983,ATM,1557.13,-1537187.71,EUR,Restaurant
TXN0000008311,2024-10-06T23:13:36,ACC00005008,Credit,1405.3,-1535782.41,JPY,Grocery
TXN0000008312,2024-04-09T08:37:01,ACC00006914,Debit,495.74,-1536278.15,EUR,Online Store
TXN0000008313,2024-11-13T19:53:27,ACC00001725,Transfer,1604.8,-1534673.35,USD,Restaurant
TXN0000008314,2024-07-20T06:35:07,ACC00000775,ATM,1656.42,-1536329.77,GBP,Walmart
TXN0000008315,2024-10-11T12:57:16,ACC00002713,Credit,789.28,-1535540.49,JPY,Restaurant
TXN0000008316,2024-06-14T12:41:30,ACC00002126,Transfer,133.39,-1535407.1,USD,Grocery
TXN0000008317,2024-03-07T12:22:17,ACC00000610,Transfer,999.86,-1534407.24,GBP,Target
TXN0000008318,2024-04-12T16:36:20,ACC00009032,Transfer,1833.77,-1532573.47,JPY,Starbucks
TXN0000008319,2024-11-08T01:44:05,ACC00005847,Payment,760.63,-1533334.1,EUR,Online Store
TXN0000008320,2024-10-07T20:02:55,ACC00007659,Debit,1350.4,-1534684.5,EUR,Shell
TXN0000008321,2024-08-16T07:50:54,ACC00008583,Credit,241.59,-1534442.91,GBP,Shell
TXN0000008322,2024-09-30T20:24:12,ACC00008320,Payment,107.39,-1534550.3,EUR,Starbucks
TXN0000008323,2024-07-11T10:26:37,ACC00005156,Transfer,1149.53,-1533400.77,EUR,Walmart
TXN0000008324,2024-03-18T02:47:10,ACC00007644,Credit,525.31,-1532875.46,JPY,Starbucks
TXN0000008325,2024-05-30T18:14:58,ACC00005595,Credit,785.27,-1532090.19,EUR,Online Store
TXN0000008326,2024-08-23T22:39:25,ACC00000521,Credit,1821.39,-1530268.8,EUR,Target
TXN0000008327,2024-10-22T09:20:02,ACC00008212,Transfer,1879.59,-1528389.21,GBP,Grocery
TXN0000008328,2024-04-14T14:18:16,ACC00006845,Transfer,1638.75,-1526750.46,JPY,Walmart
TXN0000008329,2024-11-20T20:02:01,ACC00005805,Debit,1701.27,-1528451.73,USD,Target
TXN0000008330,2024-09-01T13:06:56,ACC00002198,Payment,274.91,-1528726.64,JPY,Online Store
TXN0000008331,2024-05-04T14:49:37,ACC00001754,Credit,843.04,-1527883.6,GBP,Target
TXN0000008332,2024-10-02T07:02:49,ACC00003481,Credit,567.34,-1527316.26,JPY,Shell
TXN0000008333,2024-07-21T10:26:03,ACC00008001,Payment,12.59,-1527328.85,GBP,Starbucks
TXN0000008334,2024-04-21T12:24:29,ACC00000165,ATM,1320.93,-1528649.78,EUR,Shell
TXN0000008335,2024-07-14T01:46:58,ACC00003801,Debit,154.62,-1528804.4,USD,Target
TXN0000008336,2024-07-22T01:28:21,ACC00005421,Credit,1813.45,-1526990.95,USD,Starbucks
TXN0000008337,2024-02-11T17:40:37,ACC00002626,Debit,343.64,-1527334.59,EUR,Grocery
TXN0000008338,2024-05-27T16:26:14,ACC00009954,Credit,504.37,-1526830.22,JPY,Restaurant
TXN0000008339,2024-12-24T20:06:00,ACC00001796,Credit,485.64,-1526344.58,USD,Amazon
TXN0000008340,2024-01-06T13:00:19,ACC00000930,Payment,1942.67,-1528287.25,GBP,Target
TXN0000008341,2024-10-29T09:41:39,ACC00006390,Payment,1716.44,-1530003.69,GBP,Shell
TXN0000008342,2024-01-19T10:42:04,ACC00006517,Transfer,1930.18,-1528073.51,USD,Walmart
TXN0000008343,2024-03-07T05:23:49,ACC00008539,Transfer,1533.39,-1526540.12,GBP,Grocery
TXN0000008344,2024-08-18T08:44:44,ACC00006484,ATM,1766.82,-1528306.94,EUR,Grocery
TXN0000008345,2024-11-28T22:25:59,ACC00008588,Transfer,739.62,-1527567.32,GBP,Online Store
TXN0000008346,2024-10-01T12:33:42,ACC00000022,ATM,1429.0,-1528996.32,GBP,Starbucks
TXN0000008347,2024-01-21T00:51:41,ACC00003829,ATM,1061.19,-1530057.51,EUR,Walmart
TXN0000008348,2024-01-31T03:38:34,ACC00009179,Transfer,1300.53,-1528756.98,USD,Amazon
TXN0000008349,2024-07-09T21:18:10,ACC00000762,ATM,930.09,-1529687.07,JPY,Restaurant
TXN0000008350,2024-11-12T03:48:03,ACC00000012,Transfer,755.71,-1528931.36,EUR,Amazon
TXN0000008351,2024-06-23T11:19:47,ACC00001652,ATM,1427.15,-1530358.51,USD,Shell
TXN0000008352,2024-03-24T22:36:02,ACC00006900,ATM,1049.85,-1531408.36,JPY,Shell
TXN0000008353,2024-12-03T11:24:55,ACC00006737,ATM,1186.35,-1532594.71,JPY,Amazon
TXN0000008354,2024-04-11T11:54:22,ACC00000406,Transfer,126.49,-1532468.22,EUR,Restaurant
TXN0000008355,2024-03-10T17:17:06,ACC00002240,Credit,1269.41,-1531198.81,USD,Grocery
TXN0000008356,2024-06-12T04:32:21,ACC00002500,Credit,134.95,-1531063.86,GBP,Target
TXN0000008357,2024-08-31T08:10:12,ACC00005036,Payment,158.65,-1531222.51,JPY,Online Store
TXN0000008358,2024-01-19T06:22:02,ACC00003047,Debit,752.61,-1531975.12,JPY,Amazon
TXN0000008359,2024-11-12T01:59:19,ACC00005973,Debit,1539.38,-1533514.5,GBP,Starbucks
TXN0000008360,2024-06-05T10:33:44,ACC00000953,ATM,351.14,-1533865.64,USD,Grocery
TXN0000008361,2024-07-03T07:58:45,ACC00001989,ATM,1892.21,-1535757.85,JPY,Restaurant
TXN0000008362,2024-12-02T18:05:33,ACC00005745,Credit,747.66,-1535010.19,JPY,Restaurant
TXN0000008363,2024-12-22T09:05:18,ACC00004729,Transfer,853.66,-1534156.53,JPY,Target
TXN0000008364,2024-12-21T15:30:05,ACC00005881,ATM,1808.15,-1535964.68,GBP,Shell
TXN0000008365,2024-08-15T07:23:54,ACC00007602,Credit,567.62,-1535397.06,EUR,Walmart
TXN0000008366,2024-11-28T11:41:57,ACC00003521,Transfer,260.27,-1535136.79,USD,Walmart
TXN0000008367,2024-03-11T02:05:23,ACC00001477,ATM,1453.92,-1536590.71,JPY,Shell
TXN0000008368,2024-11-14T14:47:11,ACC00001939,Transfer,1465.58,-1535125.13,EUR,Shell
TXN0000008369,2024-09-15T19:28:14,ACC00001839,Transfer,857.34,-1534267.79,EUR,Starbucks
TXN0000008370,2024-02-18T06:18:00,ACC00009284,Payment,91.11,-1534358.9,JPY,Shell
TXN0000008371,2024-08-05T02:24:00,ACC00005207,ATM,321.67,-1534680.57,GBP,Shell
TXN0000008372,2024-01-28T18:48:37,ACC00003086,ATM,1265.65,-1535946.22,EUR,Shell
TXN0000008373,2024-10-15T18:27:37,ACC00002906,Debit,1993.55,-1537939.77,GBP,Walmart
TXN0000008374,2024-03-30T18:25:10,ACC00004654,Payment,50.17,-1537989.94,EUR,Target
TXN0000008375,2024-08-30T15:44:55,ACC00008421,Credit,1655.07,-1536334.87,USD,Walmart
TXN0000008376,2024-06-16T18:27:03,ACC00004483,Transfer,897.7,-1535437.17,GBP,Restaurant
TXN0000008377,2024-08-17T07:00:19,ACC00001473,Transfer,1980.07,-1533457.1,EUR,Restaurant
TXN0000008378,2024-08-14T11:08:53,ACC00001457,Payment,1098.15,-1534555.25,JPY,Amazon
TXN0000008379,2024-03-21T11:06:41,ACC00002660,ATM,1055.67,-1535610.92,EUR,Walmart
TXN0000008380,2024-05-29T17:43:31,ACC00009114,Debit,906.06,-1536516.98,USD,Shell
TXN0000008381,2024-07-28T01:53:11,ACC00005024,Debit,1840.34,-1538357.32,USD,Starbucks
TXN0000008382,2024-07-02T08:30:37,ACC00004460,Transfer,1536.3,-1536821.02,GBP,Grocery
TXN0000008383,2024-01-28T12:27:10,ACC00009478,Payment,387.58,-1537208.6,JPY,Amazon
TXN0000008384,2024-05-31T17:43:26,ACC00005569,Credit,1651.6,-1535557.0,JPY,Grocery
TXN0000008385,2024-09-25T05:02:34,ACC00001577,ATM,1668.11,-1537225.11,JPY,Shell
TXN0000008386,2024-08-24T21:18:19,ACC00004742,Transfer,151.37,-1537073.74,EUR,Starbucks
TXN0000008387,2024-12-10T17:56:09,ACC00000335,Payment,403.63,-1537477.37,USD,Amazon
TXN0000008388,2024-03-27T01:22:45,ACC00009472,ATM,1328.98,-1538806.35,JPY,Restaurant
TXN0000008389,2024-08-18T16:28:09,ACC00008007,Credit,1016.08,-1537790.27,EUR,Target
TXN0000008390,2024-01-18T13:27:23,ACC00004261,Payment,134.01,-1537924.28,JPY,Starbucks
TXN0000008391,2024-10-11T10:23:21,ACC00005689,Transfer,1018.85,-1536905.43,USD,Starbucks
TXN0000008392,2024-05-13T18:50:03,ACC00008869,ATM,549.76,-1537455.19,JPY,Shell
TXN0000008393,2024-03-01T18:29:46,ACC00006667,Debit,1736.52,-1539191.71,EUR,Amazon
TXN0000008394,2024-12-05T07:43:41,ACC00008830,Credit,963.11,-1538228.6,USD,Grocery
TXN0000008395,2024-03-21T19:26:48,ACC00004924,Payment,914.68,-1539143.28,USD,Amazon
TXN0000008396,2024-02-23T11:18:34,ACC00000523,Credit,1081.6,-1538061.68,JPY,Restaurant
TXN0000008397,2024-01-06T22:34:48,ACC00003171,Credit,184.56,-1537877.12,JPY,Shell
TXN0000008398,2024-12-19T05:16:21,ACC00002970,ATM,1662.08,-1539539.2,USD,Shell
TXN0000008399,2024-07-12T03:50:46,ACC00005791,Payment,1070.87,-1540610.07,JPY,Walmart
TXN0000008400,2024-12-21T14:30:04,ACC00000597,Transfer,923.49,-1539686.58,EUR,Amazon
TXN0000008401,2024-01-09T12:35:57,ACC00001839,Payment,1753.88,-1541440.46,JPY,Starbucks
TXN0000008402,2024-03-27T09:13:06,ACC00000390,Payment,1643.01,-1543083.47,JPY,Starbucks
TXN0000008403,2024-11-29T23:01:27,ACC00002199,Transfer,667.63,-1542415.84,USD,Target
TXN0000008404,2024-04-12T19:16:48,ACC00007056,Debit,1203.35,-1543619.19,GBP,Shell
TXN0000008405,2024-11-11T10:20:16,ACC00000791,Payment,767.52,-1544386.71,EUR,Shell
TXN0000008406,2024-03-08T00:03:23,ACC00008821,ATM,510.68,-1544897.39,JPY,Grocery
TXN0000008407,2024-04-28T18:48:29,ACC00007515,Credit,1262.37,-1543635.02,JPY,Starbucks
TXN0000008408,2024-05-21T17:41:28,ACC00000021,Debit,987.49,-1544622.51,GBP,Shell
TXN0000008409,2024-07-10T10:47:20,ACC00006684,Credit,857.32,-1543765.19,GBP,Restaurant
TXN0000008410,2024-11-21T13:16:17,ACC00007285,Transfer,1039.22,-1542725.97,JPY,Shell
TXN0000008411,2024-12-30T17:41:00,ACC00003478,Transfer,434.34,-1542291.63,EUR,Restaurant
TXN0000008412,2024-11-18T14:28:10,ACC00005374,Debit,1959.95,-1544251.58,JPY,Shell
TXN0000008413,2024-01-19T10:14:41,ACC00004476,Transfer,634.8,-1543616.78,EUR,Amazon
TXN0000008414,2024-09-16T23:22:55,ACC00009121,Credit,1829.79,-1541786.99,EUR,Grocery
TXN0000008415,2024-12-08T20:34:54,ACC00006697,ATM,739.6,-1542526.59,GBP,Starbucks
TXN0000008416,2024-05-03T09:19:30,ACC00004626,Credit,686.53,-1541840.06,EUR,Grocery
TXN0000008417,2024-04-29T03:59:14,ACC00004435,Transfer,119.54,-1541720.52,JPY,Grocery
TXN0000008418,2024-05-10T07:51:05,ACC00007161,ATM,1175.39,-1542895.91,GBP,Walmart
TXN0000008419,2024-05-12T12:02:06,ACC00005830,Payment,1412.88,-1544308.79,EUR,Shell
TXN0000008420,2024-02-24T00:43:25,ACC00008399,ATM,1097.18,-1545405.97,JPY,Shell
TXN0000008421,2024-06-13T12:12:32,ACC00003539,ATM,346.9,-1545752.87,GBP,Walmart
TXN0000008422,2024-01-07T17:11:34,ACC00005799,Transfer,390.63,-1545362.24,JPY,Online Store
TXN0000008423,2024-05-08T20:28:00,ACC00008112,Transfer,1840.31,-1543521.93,JPY,Starbucks
TXN0000008424,2024-09-15T09:41:08,ACC00009903,Debit,609.72,-1544131.65,JPY,Starbucks
TXN0000008425,2024-08-02T12:44:27,ACC00002436,Transfer,1806.07,-1542325.58,USD,Walmart
TXN0000008426,2024-11-19T20:24:44,ACC00009248,ATM,1701.48,-1544027.06,USD,Grocery
TXN0000008427,2024-06-08T20:13:04,ACC00007266,ATM,1420.97,-1545448.03,USD,Amazon
TXN0000008428,2024-06-27T13:38:08,ACC00001886,ATM,728.13,-1546176.16,EUR,Target
TXN0000008429,2024-06-02T08:02:36,ACC00002714,Transfer,1334.35,-1544841.81,EUR,Walmart
TXN0000008430,2024-09-25T11:25:47,ACC00006401,ATM,429.27,-1545271.08,EUR,Starbucks
TXN0000008431,2024-08-31T21:28:44,ACC00007921,Payment,114.36,-1545385.44,EUR,Target
TXN0000008432,2024-06-07T13:55:17,ACC00004966,Payment,355.39,-1545740.83,EUR,Online Store
TXN0000008433,2024-04-15T04:59:07,ACC00005012,Transfer,1601.81,-1544139.02,USD,Amazon
TXN0000008434,2024-07-03T13:27:47,ACC00000960,Debit,906.3,-1545045.32,EUR,Walmart
TXN0000008435,2024-06-28T15:04:03,ACC00000160,Debit,1835.16,-1546880.48,GBP,Shell
TXN0000008436,2024-11-23T11:49:55,ACC00005763,ATM,1665.46,-1548545.94,GBP,Restaurant
TXN0000008437,2024-12-24T19:40:19,ACC00005368,Transfer,1968.02,-1546577.92,USD,Amazon
TXN0000008438,2024-02-01T07:26:36,ACC00008204,Debit,45.62,-1546623.54,USD,Shell
TXN0000008439,2024-11-11T15:36:50,ACC00004355,Debit,1368.05,-1547991.59,EUR,Amazon
TXN0000008440,2024-12-09T15:27:10,ACC00003662,ATM,368.69,-1548360.28,JPY,Shell
TXN0000008441,2024-06-04T18:20:06,ACC00005991,Payment,1357.23,-1549717.51,GBP,Target
TXN0000008442,2024-12-14T02:24:41,ACC00000345,Debit,508.17,-1550225.68,EUR,Online Store
TXN0000008443,2024-05-25T10:43:57,ACC00000930,Credit,1410.66,-1548815.02,GBP,Walmart
TXN0000008444,2024-01-26T02:50:10,ACC00009032,ATM,40.37,-1548855.39,JPY,Starbucks
TXN0000008445,2024-08-05T03:04:08,ACC00003672,Debit,1691.37,-1550546.76,JPY,Target
TXN0000008446,2024-11-28T05:14:17,ACC00007086,ATM,531.37,-1551078.13,JPY,Restaurant
TXN0000008447,2024-08-19T05:44:18,ACC00005221,ATM,641.15,-1551719.28,EUR,Starbucks
TXN0000008448,2024-03-02T06:21:46,ACC00007317,Payment,1693.1,-1553412.38,EUR,Starbucks
TXN0000008449,2024-06-24T21:35:00,ACC00006986,Transfer,592.88,-1552819.5,JPY,Starbucks
TXN0000008450,2024-11-24T06:41:25,ACC00004954,Payment,1187.01,-1554006.51,JPY,Walmart
TXN0000008451,2024-08-25T21:01:30,ACC00008838,Payment,304.56,-1554311.07,JPY,Online Store
TXN0000008452,2024-10-17T13:29:19,ACC00005265,Credit,514.58,-1553796.49,GBP,Walmart
TXN0000008453,2024-08-09T05:54:49,ACC00000285,ATM,1782.79,-1555579.28,GBP,Grocery
TXN0000008454,2024-10-28T06:27:41,ACC00007365,ATM,1514.68,-1557093.96,USD,Starbucks
TXN0000008455,2024-12-03T10:22:21,ACC00007571,Payment,1553.75,-1558647.71,EUR,Online Store
TXN0000008456,2024-06-28T17:19:15,ACC00003669,ATM,115.8,-1558763.51,JPY,Starbucks
TXN0000008457,2024-10-02T15:13:33,ACC00007735,Debit,1756.73,-1560520.24,JPY,Online Store
TXN0000008458,2024-07-31T13:20:43,ACC00003246,Credit,1395.43,-1559124.81,USD,Restaurant
TXN0000008459,2024-05-09T04:37:56,ACC00008208,Credit,456.96,-1558667.85,JPY,Shell
TXN0000008460,2024-06-13T11:51:25,ACC00004546,ATM,878.37,-1559546.22,GBP,Restaurant
TXN0000008461,2024-04-18T01:01:58,ACC00005129,Transfer,23.06,-1559523.16,USD,Restaurant
TXN0000008462,2024-10-02T00:31:00,ACC00009575,Debit,1024.23,-1560547.39,EUR,Target
TXN0000008463,2024-02-28T20:08:39,ACC00002693,Payment,691.9,-1561239.29,EUR,Target
TXN0000008464,2024-12-06T19:22:48,ACC00006797,Payment,190.15,-1561429.44,EUR,Amazon
TXN0000008465,2024-03-12T08:31:03,ACC00000558,Credit,216.84,-1561212.6,JPY,Restaurant
TXN0000008466,2024-12-07T04:38:37,ACC00007387,Payment,609.6,-1561822.2,USD,Target
TXN0000008467,2024-05-13T11:52:34,ACC00009949,Payment,1342.48,-1563164.68,JPY,Target
TXN0000008468,2024-06-16T17:40:15,ACC00000979,ATM,614.43,-1563779.11,JPY,Online Store
TXN0000008469,2024-07-08T19:09:41,ACC00005452,Debit,1323.04,-1565102.15,EUR,Shell
TXN0000008470,2024-05-10T07:28:57,ACC00000306,Transfer,141.07,-1564961.08,GBP,Walmart
TXN0000008471,2024-02-29T06:35:42,ACC00009925,ATM,1703.12,-1566664.2,EUR,Amazon
TXN0000008472,2024-08-18T02:05:12,ACC00001288,ATM,1568.84,-1568233.04,EUR,Starbucks
TXN0000008473,2024-09-20T06:14:25,ACC00009105,ATM,1104.85,-1569337.89,GBP,Shell
TXN0000008474,2024-04-24T04:31:14,ACC00009852,Transfer,1863.78,-1567474.11,EUR,Online Store
TXN0000008475,2024-10-06T02:11:08,ACC00005226,ATM,990.62,-1568464.73,JPY,Online Store
TXN0000008476,2024-02-12T12:04:59,ACC00000709,Debit,757.98,-1569222.71,JPY,Online Store
TXN0000008477,2024-04-13T06:19:19,ACC00007293,ATM,53.52,-1569276.23,EUR,Walmart
TXN0000008478,2024-04-12T22:51:42,ACC00003202,Payment,1432.0,-1570708.23,GBP,Starbucks
TXN0000008479,2024-11-27T04:26:57,ACC00008662,Debit,376.11,-1571084.34,GBP,Walmart
TXN0000008480,2024-07-23T14:34:15,ACC00001835,Debit,1897.47,-1572981.81,EUR,Online Store
TXN0000008481,2024-09-25T09:11:36,ACC00002642,Debit,127.72,-1573109.53,USD,Shell
TXN0000008482,2024-08-23T23:00:48,ACC00005520,ATM,1276.99,-1574386.52,USD,Grocery
TXN0000008483,2024-04-27T10:28:55,ACC00003772,Debit,488.9,-1574875.42,GBP,Starbucks
TXN0000008484,2024-12-12T11:37:28,ACC00008855,Payment,823.21,-1575698.63,EUR,Restaurant
TXN0000008485,2024-08-31T21:51:06,ACC00000658,Credit,293.7,-1575404.93,JPY,Target
TXN0000008486,2024-08-21T13:58:36,ACC00001235,Payment,459.81,-1575864.74,JPY,Online Store
TXN0000008487,2024-06-02T00:38:43,ACC00002514,Transfer,422.26,-1575442.48,GBP,Grocery
TXN0000008488,2024-02-09T08:51:30,ACC00008926,ATM,1280.96,-1576723.44,GBP,Amazon
TXN0000008489,2024-06-25T13:12:55,ACC00007004,Credit,517.79,-1576205.65,EUR,Amazon
TXN0000008490,2024-09-04T20:44:32,ACC00009739,ATM,283.27,-1576488.92,JPY,Target
TXN0000008491,2024-08-26T01:40:48,ACC00005008,Payment,1328.59,-1577817.51,JPY,Shell
TXN0000008492,2024-04-22T05:08:01,ACC00009770,Credit,1060.47,-1576757.04,USD,Restaurant
TXN0000008493,2024-03-12T15:08:05,ACC00007578,Payment,312.08,-1577069.12,JPY,Grocery
TXN0000008494,2024-08-07T16:45:00,ACC00007526,Transfer,458.89,-1576610.23,EUR,Grocery
TXN0000008495,2024-04-26T15:04:20,ACC00007145,Payment,67.23,-1576677.46,JPY,Amazon
TXN0000008496,2024-01-01T15:17:51,ACC00000171,ATM,487.59,-1577165.05,JPY,Online Store
TXN0000008497,2024-05-12T19:40:38,ACC00007071,Payment,1678.47,-1578843.52,EUR,Starbucks
TXN0000008498,2024-11-15T12:31:03,ACC00004722,Transfer,1678.86,-1577164.66,JPY,Amazon
TXN0000008499,2024-05-05T20:25:54,ACC00007401,ATM,1068.18,-1578232.84,GBP,Grocery
TXN0000008500,2024-02-28T09:07:03,ACC00007955,Payment,1247.96,-1579480.8,USD,Walmart
TXN0000008501,2024-06-08T14:41:42,ACC00006263,Payment,1601.21,-1581082.01,JPY,Online Store
TXN0000008502,2024-11-09T04:20:54,ACC00008366,Debit,1558.76,-1582640.77,USD,Shell
TXN0000008503,2024-07-15T00:59:49,ACC00000140,Debit,1428.72,-1584069.49,USD,Amazon
TXN0000008504,2024-02-18T14:54:54,ACC00001481,Debit,848.24,-1584917.73,USD,Target
TXN0000008505,2024-03-23T08:23:20,ACC00009403,Transfer,1316.72,-1583601.01,USD,Shell
TXN0000008506,2024-03-19T22:09:23,ACC00004567,Credit,1339.75,-1582261.26,GBP,Shell
TXN0000008507,2024-02-03T00:27:17,ACC00005729,Credit,1268.68,-1580992.58,JPY,Online Store
TXN0000008508,2024-01-26T17:43:53,ACC00006757,Debit,1983.62,-1582976.2,EUR,Shell
TXN0000008509,2024-07-03T03:02:21,ACC00000021,Payment,688.99,-1583665.19,GBP,Walmart
TXN0000008510,2024-02-08T11:26:13,ACC00007697,Credit,1528.01,-1582137.18,EUR,Walmart
TXN0000008511,2024-09-05T21:55:00,ACC00002188,Debit,1437.34,-1583574.52,JPY,Target
TXN0000008512,2024-01-19T05:33:33,ACC00007212,Payment,1380.19,-1584954.71,USD,Grocery
TXN0000008513,2024-02-05T10:58:22,ACC00007636,Payment,1098.84,-1586053.55,JPY,Online Store
TXN0000008514,2024-02-15T19:10:03,ACC00003495,Transfer,1216.86,-1584836.69,JPY,Restaurant
TXN0000008515,2024-09-02T23:58:29,ACC00000243,Credit,1643.41,-1583193.28,GBP,Online Store
TXN0000008516,2024-09-22T04:56:53,ACC00005523,Payment,1732.27,-1584925.55,EUR,Amazon
TXN0000008517,2024-08-09T07:27:41,ACC00004689,ATM,1516.84,-1586442.39,USD,Target
TXN0000008518,2024-10-18T10:57:27,ACC00000907,Payment,1089.09,-1587531.48,USD,Grocery
TXN0000008519,2024-01-30T07:34:04,ACC00000600,ATM,1717.46,-1589248.94,EUR,Amazon
TXN0000008520,2024-06-16T17:52:39,ACC00005929,Credit,734.82,-1588514.12,GBP,Online Store
TXN0000008521,2024-10-15T04:39:12,ACC00005102,Credit,1842.39,-1586671.73,JPY,Restaurant
TXN0000008522,2024-04-23T16:11:24,ACC00007043,Transfer,267.72,-1586404.01,USD,Restaurant
TXN0000008523,2024-03-21T17:41:46,ACC00009247,Credit,650.12,-1585753.89,USD,Shell
TXN0000008524,2024-04-01T08:59:27,ACC00001453,Transfer,1982.99,-1583770.9,JPY,Shell
TXN0000008525,2024-07-06T08:55:40,ACC00003918,Debit,466.54,-1584237.44,USD,Online Store
TXN0000008526,2024-05-30T15:04:00,ACC00008172,Payment,766.55,-1585003.99,GBP,Restaurant
TXN0000008527,2024-09-25T09:28:04,ACC00000390,ATM,208.92,-1585212.91,USD,Starbucks
TXN0000008528,2024-05-29T02:12:57,ACC00004977,Debit,880.52,-1586093.43,USD,Target
TXN0000008529,2024-06-20T13:31:56,ACC00000170,Debit,752.7,-1586846.13,GBP,Amazon
TXN0000008530,2024-02-20T17:02:31,ACC00002265,Credit,621.2,-1586224.93,GBP,Starbucks
TXN0000008531,2024-04-08T19:27:52,ACC00001645,Credit,633.86,-1585591.07,GBP,Online Store
TXN0000008532,2024-07-29T12:32:29,ACC00007385,Debit,121.63,-1585712.7,JPY,Restaurant
TXN0000008533,2024-06-11T14:08:54,ACC00005489,Debit,14.13,-1585726.83,USD,Starbucks
TXN0000008534,2024-05-11T07:34:54,ACC00000266,Credit,1498.0,-1584228.83,EUR,Walmart
TXN0000008535,2024-08-01T00:20:23,ACC00004506,Transfer,1842.51,-1582386.32,GBP,Walmart
TXN0000008536,2024-01-21T22:57:19,ACC00009452,Payment,304.28,-1582690.6,JPY,Amazon
TXN0000008537,2024-02-23T18:38:49,ACC00007122,Credit,217.74,-1582472.86,GBP,Amazon
TXN0000008538,2024-08-31T10:57:16,ACC00007619,Credit,655.79,-1581817.07,EUR,Online Store
TXN0000008539,2024-12-19T02:13:50,ACC00004840,Transfer,1331.97,-1580485.1,GBP,Walmart
TXN0000008540,2024-08-06T21:04:21,ACC00000406,Transfer,113.2,-1580371.9,JPY,Walmart
TXN0000008541,2024-04-08T13:28:28,ACC00008064,Debit,1250.57,-1581622.47,GBP,Shell
TXN0000008542,2024-10-25T07:10:39,ACC00001444,Debit,1903.72,-1583526.19,GBP,Grocery
TXN0000008543,2024-04-08T18:07:16,ACC00001153,Debit,524.19,-1584050.38,GBP,Starbucks
TXN0000008544,2024-07-18T12:52:01,ACC00002521,ATM,560.04,-1584610.42,JPY,Target
TXN0000008545,2024-03-15T15:06:47,ACC00008210,Transfer,1423.31,-1583187.11,JPY,Target
TXN0000008546,2024-10-27T13:09:00,ACC00003502,ATM,1183.5,-1584370.61,USD,Target
TXN0000008547,2024-03-25T16:16:51,ACC00000452,Credit,1528.95,-1582841.66,EUR,Shell
TXN0000008548,2024-12-16T20:47:34,ACC00001189,Payment,538.51,-1583380.17,EUR,Target
TXN0000008549,2024-07-21T01:24:43,ACC00000758,Transfer,848.19,-1582531.98,JPY,Grocery
TXN0000008550,2024-07-26T22:41:11,ACC00005516,Debit,1624.22,-1584156.2,EUR,Restaurant
TXN0000008551,2024-02-27T16:05:58,ACC00001715,ATM,120.15,-1584276.35,USD,Starbucks
TXN0000008552,2024-05-22T10:26:05,ACC00006520,Credit,1840.84,-1582435.51,JPY,Amazon
TXN0000008553,2024-08-31T18:40:51,ACC00008842,ATM,323.55,-1582759.06,EUR,Online Store
TXN0000008554,2024-07-29T12:22:47,ACC00003891,Credit,1675.25,-1581083.81,EUR,Walmart
TXN0000008555,2024-05-27T07:16:32,ACC00007088,Credit,1274.34,-1579809.47,GBP,Online Store
TXN0000008556,2024-10-14T15:39:19,ACC00008585,Transfer,341.91,-1579467.56,EUR,Target
TXN0000008557,2024-09-13T14:42:54,ACC00003593,Payment,940.83,-1580408.39,GBP,Restaurant
TXN0000008558,2024-12-07T03:10:57,ACC00005050,Payment,1772.23,-1582180.62,EUR,Walmart
TXN0000008559,2024-11-22T23:35:41,ACC00009958,Debit,1135.48,-1583316.1,GBP,Shell
TXN0000008560,2024-05-29T01:54:18,ACC00005520,Transfer,1905.55,-1581410.55,GBP,Amazon
TXN0000008561,2024-07-17T17:11:59,ACC00004546,ATM,1256.17,-1582666.72,JPY,Online Store
TXN0000008562,2024-07-09T11:53:40,ACC00008701,Transfer,413.02,-1582253.7,GBP,Starbucks
TXN0000008563,2024-11-19T14:44:27,ACC00000362,Payment,1645.3,-1583899.0,USD,Online Store
TXN0000008564,2024-11-28T09:27:35,ACC00003905,Credit,768.56,-1583130.44,GBP,Starbucks
TXN0000008565,2024-02-07T18:10:16,ACC00006072,Debit,1833.52,-1584963.96,GBP,Walmart
TXN0000008566,2024-05-02T18:28:34,ACC00003140,ATM,1315.22,-1586279.18,JPY,Grocery
TXN0000008567,2024-04-07T19:44:37,ACC00001771,Transfer,1901.72,-1584377.46,JPY,Starbucks
TXN0000008568,2024-09-05T00:38:30,ACC00005624,ATM,736.54,-1585114.0,EUR,Walmart
TXN0000008569,2024-09-27T22:56:10,ACC00006194,Payment,1943.21,-1587057.21,GBP,Amazon
TXN0000008570,2024-07-14T01:13:41,ACC00006765,Debit,1002.19,-1588059.4,JPY,Shell
TXN0000008571,2024-10-21T05:09:57,ACC00002344,Debit,577.91,-1588637.31,GBP,Starbucks
TXN0000008572,2024-03-24T11:33:51,ACC00007560,ATM,1689.31,-1590326.62,USD,Target
TXN0000008573,2024-02-15T02:34:28,ACC00005890,Debit,1353.64,-1591680.26,USD,Walmart
TXN0000008574,2024-06-19T07:14:18,ACC00000206,ATM,372.44,-1592052.7,USD,Grocery
TXN0000008575,2024-02-13T05:18:41,ACC00006348,Transfer,1025.91,-1591026.79,JPY,Starbucks
TXN0000008576,2024-04-14T13:04:21,ACC00008820,Payment,1616.34,-1592643.13,USD,Restaurant
TXN0000008577,2024-03-06T21:58:43,ACC00009395,Payment,1570.81,-1594213.94,EUR,Target
TXN0000008578,2024-08-12T19:52:41,ACC00008166,Credit,28.51,-1594185.43,USD,Amazon
TXN0000008579,2024-10-01T01:06:11,ACC00008466,Credit,716.25,-1593469.18,EUR,Walmart
TXN0000008580,2024-11-04T04:04:27,ACC00003823,Debit,762.49,-1594231.67,EUR,Grocery
TXN0000008581,2024-04-22T09:25:02,ACC00002056,Credit,782.84,-1593448.83,USD,Amazon
TXN0000008582,2024-07-02T23:41:07,ACC00002786,Credit,131.96,-1593316.87,EUR,Starbucks
TXN0000008583,2024-07-25T06:29:46,ACC00003338,Debit,1882.8,-1595199.67,GBP,Amazon
TXN0000008584,2024-06-23T02:33:04,ACC00000710,Credit,1871.46,-1593328.21,EUR,Target
TXN0000008585,2024-12-17T00:09:02,ACC00007763,Payment,1064.27,-1594392.48,USD,Walmart
TXN0000008586,2024-05-06T20:32:37,ACC00008941,ATM,862.2,-1595254.68,USD,Online Store
TXN0000008587,2024-06-11T11:43:54,ACC00005195,Credit,105.4,-1595149.28,GBP,Walmart
TXN0000008588,2024-04-21T15:49:18,ACC00008546,Transfer,855.55,-1594293.73,EUR,Walmart
TXN0000008589,2024-05-20T17:23:12,ACC00000898,Transfer,1966.01,-1592327.72,GBP,Grocery
TXN0000008590,2024-11-25T16:33:05,ACC00007558,Credit,911.94,-1591415.78,USD,Restaurant
TXN0000008591,2024-07-21T21:33:19,ACC00003371,Debit,1479.33,-1592895.11,JPY,Grocery
TXN0000008592,2024-05-11T20:07:17,ACC00002180,Payment,947.32,-1593842.43,EUR,Restaurant
TXN0000008593,2024-08-22T23:37:02,ACC00006879,Debit,523.89,-1594366.32,GBP,Grocery
TXN0000008594,2024-09-25T14:09:32,ACC00004358,Debit,1491.12,-1595857.44,GBP,Shell
TXN0000008595,2024-07-26T21:00:58,ACC00005659,ATM,426.65,-1596284.09,EUR,Target
TXN0000008596,2024-04-22T20:09:59,ACC00002897,Payment,1094.38,-1597378.47,GBP,Grocery
TXN0000008597,2024-06-03T05:36:22,ACC00004914,Credit,1523.74,-1595854.73,EUR,Starbucks
TXN0000008598,2024-05-07T16:34:30,ACC00006064,Transfer,512.83,-1595341.9,USD,Grocery
TXN0000008599,2024-04-19T13:37:06,ACC00004544,Transfer,923.56,-1594418.34,JPY,Shell
TXN0000008600,2024-08-20T14:29:56,ACC00003151,Transfer,681.34,-1593737.0,JPY,Target
TXN0000008601,2024-06-26T13:28:25,ACC00006138,Debit,1972.61,-1595709.61,JPY,Walmart
TXN0000008602,2024-12-10T11:18:54,ACC00003449,Debit,344.33,-1596053.94,JPY,Grocery
TXN0000008603,2024-06-03T11:03:15,ACC00000304,Payment,129.87,-1596183.81,USD,Amazon
TXN0000008604,2024-09-03T03:43:14,ACC00005884,Payment,458.61,-1596642.42,USD,Amazon
TXN0000008605,2024-01-17T14:28:00,ACC00000365,Debit,1688.9,-1598331.32,USD,Amazon
TXN0000008606,2024-04-06T22:15:08,ACC00003185,Credit,885.62,-1597445.7,USD,Walmart
TXN0000008607,2024-03-07T11:47:07,ACC00008889,Transfer,921.09,-1596524.61,JPY,Starbucks
TXN0000008608,2024-03-18T13:04:07,ACC00001713,Debit,485.46,-1597010.07,EUR,Restaurant
TXN0000008609,2024-08-19T21:08:41,ACC00005879,Debit,1240.25,-1598250.32,GBP,Shell
TXN0000008610,2024-04-05T17:52:08,ACC00008830,Transfer,1553.53,-1596696.79,USD,Starbucks
TXN0000008611,2024-10-19T06:33:44,ACC00009208,Credit,1340.29,-1595356.5,EUR,Shell
TXN0000008612,2024-10-30T19:43:03,ACC00004474,Transfer,1443.12,-1593913.38,EUR,Starbucks
TXN0000008613,2024-09-20T04:00:16,ACC00006993,Debit,1172.47,-1595085.85,EUR,Restaurant
TXN0000008614,2024-04-24T17:55:17,ACC00008128,Debit,719.62,-1595805.47,JPY,Shell
TXN0000008615,2024-10-11T05:34:55,ACC00002760,Payment,1224.18,-1597029.65,USD,Starbucks
TXN0000008616,2024-03-14T06:58:44,ACC00005718,Payment,1529.15,-1598558.8,USD,Amazon
TXN0000008617,2024-06-23T17:05:07,ACC00009641,ATM,896.63,-1599455.43,JPY,Online Store
TXN0000008618,2024-05-19T12:44:26,ACC00001163,Transfer,375.51,-1599079.92,USD,Shell
TXN0000008619,2024-06-04T23:57:12,ACC00001981,Credit,140.08,-1598939.84,JPY,Online Store
TXN0000008620,2024-04-18T23:03:38,ACC00009985,Debit,556.53,-1599496.37,JPY,Restaurant
TXN0000008621,2024-06-27T01:07:23,ACC00000449,Debit,1389.32,-1600885.69,GBP,Amazon
TXN0000008622,2024-01-05T10:09:02,ACC00002060,Credit,991.4,-1599894.29,USD,Walmart
TXN0000008623,2024-05-23T16:26:53,ACC00002028,Credit,189.88,-1599704.41,JPY,Shell
TXN0000008624,2024-07-09T02:00:59,ACC00001215,Transfer,342.97,-1599361.44,GBP,Grocery
TXN0000008625,2024-06-01T04:47:45,ACC00000116,Transfer,1224.27,-1598137.17,JPY,Online Store
TXN0000008626,2024-09-30T21:37:27,ACC00008711,Credit,395.49,-1597741.68,JPY,Restaurant
TXN0000008627,2024-04-13T16:16:38,ACC00000628,ATM,230.18,-1597971.86,JPY,Online Store
TXN0000008628,2024-03-06T00:50:02,ACC00009828,ATM,1016.51,-1598988.37,EUR,Starbucks
TXN0000008629,2024-04-22T00:55:12,ACC00008457,Transfer,425.48,-1598562.89,USD,Walmart
TXN0000008630,2024-10-24T10:37:39,ACC00004137,Debit,738.1,-1599300.99,USD,Restaurant
TXN0000008631,2024-10-09T13:03:57,ACC00000212,ATM,428.05,-1599729.04,USD,Online Store
TXN0000008632,2024-09-07T20:04:57,ACC00005314,Debit,536.14,-1600265.18,JPY,Shell
TXN0000008633,2024-09-07T02:28:29,ACC00007467,Payment,173.36,-1600438.54,GBP,Target
TXN0000008634,2024-10-17T17:51:19,ACC00002867,Credit,1170.46,-1599268.08,EUR,Target
TXN0000008635,2024-12-26T05:24:17,ACC00003532,ATM,565.0,-1599833.08,USD,Amazon
TXN0000008636,2024-04-04T07:54:28,ACC00002841,Credit,413.59,-1599419.49,GBP,Restaurant
TXN0000008637,2024-12-02T01:55:40,ACC00006216,Credit,1521.18,-1597898.31,GBP,Online Store
TXN0000008638,2024-10-04T13:40:38,ACC00008112,ATM,1783.34,-1599681.65,JPY,Starbucks
TXN0000008639,2024-02-26T18:11:39,ACC00008876,Debit,831.54,-1600513.19,JPY,Amazon
TXN0000008640,2024-12-01T22:06:33,ACC00005511,ATM,1348.83,-1601862.02,USD,Restaurant
TXN0000008641,2024-09-17T21:29:34,ACC00001747,Payment,766.58,-1602628.6,GBP,Starbucks
TXN0000008642,2024-11-23T20:47:43,ACC00004031,Debit,606.43,-1603235.03,USD,Shell
TXN0000008643,2024-06-29T15:33:50,ACC00006455,ATM,1369.29,-1604604.32,USD,Amazon
TXN0000008644,2024-06-03T13:06:10,ACC00000111,Debit,794.03,-1605398.35,USD,Shell
TXN0000008645,2024-12-04T10:12:00,ACC00004811,Payment,306.89,-1605705.24,EUR,Shell
TXN0000008646,2024-06-03T15:12:24,ACC00008512,Transfer,1890.92,-1603814.32,GBP,Grocery
TXN0000008647,2024-03-24T17:26:09,ACC00003009,Credit,1591.2,-1602223.12,JPY,Shell
TXN0000008648,2024-03-12T03:11:58,ACC00000655,Transfer,1730.42,-1600492.7,GBP,Walmart
TXN0000008649,2024-05-06T08:18:08,ACC00003245,Credit,685.72,-1599806.98,EUR,Shell
TXN0000008650,2024-02-27T13:03:51,ACC00001346,Transfer,1706.35,-1598100.63,USD,Shell
TXN0000008651,2024-12-01T17:14:16,ACC00005880,Credit,1002.67,-1597097.96,EUR,Amazon
TXN0000008652,2024-11-26T21:05:38,ACC00001465,Payment,165.68,-1597263.64,EUR,Starbucks
TXN0000008653,2024-07-25T21:57:01,ACC00001144,Transfer,1385.8,-1595877.84,GBP,Online Store
TXN0000008654,2024-09-04T11:47:47,ACC00000672,Debit,468.38,-1596346.22,USD,Amazon
TXN0000008655,2024-01-13T18:05:20,ACC00006359,Credit,1361.15,-1594985.07,JPY,Target
TXN0000008656,2024-02-07T10:41:56,ACC00004498,Debit,203.33,-1595188.4,USD,Starbucks
TXN0000008657,2024-11-19T00:34:46,ACC00009866,Debit,520.88,-1595709.28,EUR,Amazon
TXN0000008658,2024-07-23T04:53:13,ACC00000915,Credit,705.58,-1595003.7,JPY,Target
TXN0000008659,2024-02-23T12:36:04,ACC00004209,Credit,728.45,-1594275.25,EUR,Restaurant
TXN0000008660,2024-08-30T13:32:35,ACC00007406,Transfer,941.08,-1593334.17,GBP,Target
TXN0000008661,2024-12-29T13:49:09,ACC00002278,Payment,1089.21,-1594423.38,GBP,Restaurant
TXN0000008662,2024-08-05T13:42:07,ACC00000843,Debit,44.12,-1594467.5,USD,Online Store
TXN0000008663,2024-09-15T09:42:21,ACC00007367,ATM,309.1,-1594776.6,USD,Walmart
TXN0000008664,2024-08-17T17:49:28,ACC00003647,Credit,65.21,-1594711.39,GBP,Amazon
TXN0000008665,2024-08-24T01:23:51,ACC00007855,Debit,883.05,-1595594.44,USD,Online Store
TXN0000008666,2024-10-11T20:59:42,ACC00000355,Transfer,300.31,-1595294.13,GBP,Restaurant
TXN0000008667,2024-09-24T06:13:06,ACC00005693,Debit,1135.49,-1596429.62,USD,Starbucks
TXN0000008668,2024-12-04T17:04:05,ACC00008604,Debit,1706.84,-1598136.46,JPY,Amazon
TXN0000008669,2024-03-24T20:28:59,ACC00006541,Credit,1646.68,-1596489.78,EUR,Online Store
TXN0000008670,2024-01-03T03:28:45,ACC00001096,ATM,462.28,-1596952.06,GBP,Shell
TXN0000008671,2024-10-28T00:51:19,ACC00004376,Payment,1334.92,-1598286.98,EUR,Target
TXN0000008672,2024-03-19T03:10:14,ACC00001678,Payment,1354.83,-1599641.81,USD,Online Store
TXN0000008673,2024-10-10T05:51:26,ACC00007810,Debit,799.8,-1600441.61,GBP,Starbucks
TXN0000008674,2024-12-18T15:53:57,ACC00001368,Credit,755.09,-1599686.52,JPY,Starbucks
TXN0000008675,2024-04-07T20:28:38,ACC00006137,Debit,878.87,-1600565.39,GBP,Grocery
TXN0000008676,2024-09-06T13:54:26,ACC00006138,Credit,912.9,-1599652.49,JPY,Starbucks
TXN0000008677,2024-08-24T05:01:43,ACC00003707,Transfer,973.0,-1598679.49,JPY,Amazon
TXN0000008678,2024-10-13T08:29:18,ACC00008066,Transfer,1540.79,-1597138.7,JPY,Grocery
TXN0000008679,2024-09-22T00:48:28,ACC00005258,Transfer,1827.09,-1595311.61,USD,Shell
TXN0000008680,2024-10-18T19:21:23,ACC00005509,Credit,460.83,-1594850.78,EUR,Shell
TXN0000008681,2024-12-02T15:54:17,ACC00009716,Debit,552.67,-1595403.45,EUR,Grocery
TXN0000008682,2024-04-22T21:06:49,ACC00005895,Payment,659.56,-1596063.01,JPY,Starbucks
TXN0000008683,2024-10-24T23:00:10,ACC00003517,Debit,1038.54,-1597101.55,GBP,Amazon
TXN0000008684,2024-03-18T13:28:39,ACC00007859,Payment,125.86,-1597227.41,GBP,Online Store
TXN0000008685,2024-11-27T03:42:52,ACC00001008,Debit,1357.69,-1598585.1,USD,Starbucks
TXN0000008686,2024-03-20T23:51:09,ACC00007616,Credit,1582.22,-1597002.88,USD,Amazon
TXN0000008687,2024-06-15T00:02:40,ACC00007496,Payment,630.53,-1597633.41,EUR,Starbucks
TXN0000008688,2024-04-18T10:52:39,ACC00005906,Transfer,1082.45,-1596550.96,GBP,Restaurant
TXN0000008689,2024-01-28T00:55:45,ACC00001779,Credit,1855.73,-1594695.23,JPY,Amazon
TXN0000008690,2024-12-29T01:50:20,ACC00002908,Transfer,1862.59,-1592832.64,JPY,Walmart
TXN0000008691,2024-10-19T12:30:53,ACC00007056,Credit,625.96,-1592206.68,JPY,Shell
TXN0000008692,2024-08-04T15:26:45,ACC00007177,Payment,29.63,-1592236.31,GBP,Restaurant
TXN0000008693,2024-11-22T13:57:36,ACC00001081,Debit,1607.72,-1593844.03,JPY,Starbucks
TXN0000008694,2024-04-08T11:00:21,ACC00001728,Transfer,1285.39,-1592558.64,USD,Online Store
TXN0000008695,2024-10-08T12:59:06,ACC00005845,ATM,279.27,-1592837.91,GBP,Shell
TXN0000008696,2024-04-27T02:13:22,ACC00003099,Transfer,1295.81,-1591542.1,USD,Grocery
TXN0000008697,2024-07-04T09:51:53,ACC00009718,Debit,1294.91,-1592837.01,USD,Online Store
TXN0000008698,2024-12-30T22:38:46,ACC00002066,Debit,271.13,-1593108.14,USD,Online Store
TXN0000008699,2024-08-01T02:56:00,ACC00005363,Debit,1031.0,-1594139.14,JPY,Target
TXN0000008700,2024-12-01T21:32:42,ACC00003725,ATM,543.94,-1594683.08,JPY,Amazon
TXN0000008701,2024-03-30T09:41:01,ACC00008611,Payment,1163.9,-1595846.98,JPY,Online Store
TXN0000008702,2024-04-24T00:04:43,ACC00006907,Transfer,1223.79,-1594623.19,GBP,Restaurant
TXN0000008703,2024-10-10T21:47:36,ACC00003724,Transfer,1949.75,-1592673.44,EUR,Starbucks
TXN0000008704,2024-03-25T04:34:03,ACC00000581,Transfer,206.82,-1592466.62,JPY,Restaurant
TXN0000008705,2024-08-01T19:57:12,ACC00002968,Payment,375.13,-1592841.75,GBP,Target
TXN0000008706,2024-11-16T03:05:07,ACC00004418,Payment,1900.78,-1594742.53,EUR,Restaurant
TXN0000008707,2024-04-16T01:58:14,ACC00005425,ATM,578.34,-1595320.87,GBP,Walmart
TXN0000008708,2024-10-28T21:30:38,ACC00003425,Transfer,1357.11,-1593963.76,GBP,Target
TXN0000008709,2024-05-09T13:43:55,ACC00003340,Transfer,1767.7,-1592196.06,JPY,Grocery
TXN0000008710,2024-01-30T23:42:53,ACC00006196,Transfer,11.95,-1592184.11,USD,Restaurant
TXN0000008711,2024-08-28T06:30:31,ACC00004243,Transfer,1895.83,-1590288.28,JPY,Walmart
TXN0000008712,2024-11-23T07:40:57,ACC00002107,Debit,655.65,-1590943.93,USD,Amazon
TXN0000008713,2024-03-25T20:25:18,ACC00000926,Debit,735.36,-1591679.29,GBP,Amazon
TXN0000008714,2024-01-14T09:21:49,ACC00009899,Debit,1212.86,-1592892.15,EUR,Restaurant
TXN0000008715,2024-07-09T09:03:52,ACC00009589,Transfer,1472.48,-1591419.67,USD,Grocery
TXN0000008716,2024-10-28T01:41:13,ACC00008802,Debit,775.73,-1592195.4,GBP,Target
TXN0000008717,2024-06-19T05:39:12,ACC00008630,Debit,405.63,-1592601.03,EUR,Restaurant
TXN0000008718,2024-11-19T11:22:06,ACC00004638,ATM,1325.56,-1593926.59,JPY,Walmart
TXN0000008719,2024-12-30T02:01:56,ACC00008836,ATM,1260.31,-1595186.9,EUR,Amazon
TXN0000008720,2024-06-23T08:38:26,ACC00001080,Payment,846.56,-1596033.46,EUR,Target
TXN0000008721,2024-10-11T07:15:34,ACC00000830,Transfer,515.94,-1595517.52,JPY,Walmart
TXN0000008722,2024-07-24T09:01:41,ACC00003970,Payment,1649.43,-1597166.95,JPY,Online Store
TXN0000008723,2024-05-09T20:02:27,ACC00006368,Payment,1788.27,-1598955.22,GBP,Starbucks
TXN0000008724,2024-02-02T02:00:02,ACC00001430,Payment,172.4,-1599127.62,GBP,Starbucks
TXN0000008725,2024-02-26T09:18:15,ACC00000703,Debit,60.62,-1599188.24,EUR,Restaurant
TXN0000008726,2024-04-13T11:52:24,ACC00001729,ATM,303.22,-1599491.46,JPY,Grocery
TXN0000008727,2024-12-29T09:42:33,ACC00001248,ATM,925.38,-1600416.84,GBP,Amazon
TXN0000008728,2024-01-15T13:09:30,ACC00006246,ATM,537.48,-1600954.32,JPY,Online Store
TXN0000008729,2024-04-11T20:27:56,ACC00006747,ATM,1482.48,-1602436.8,EUR,Shell
TXN0000008730,2024-04-19T18:46:08,ACC00002493,Debit,208.33,-1602645.13,GBP,Online Store
TXN0000008731,2024-11-07T17:08:07,ACC00005959,Transfer,1383.63,-1601261.5,USD,Amazon
TXN0000008732,2024-06-09T05:11:13,ACC00000799,ATM,1821.47,-1603082.97,GBP,Restaurant
TXN0000008733,2024-04-12T21:46:38,ACC00001511,Transfer,979.47,-1602103.5,GBP,Walmart
TXN0000008734,2024-11-29T05:47:07,ACC00002679,Credit,226.02,-1601877.48,JPY,Restaurant
TXN0000008735,2024-03-29T22:03:12,ACC00004014,Transfer,1525.93,-1600351.55,JPY,Grocery
TXN0000008736,2024-07-28T13:24:29,ACC00001158,Debit,1039.82,-1601391.37,GBP,Amazon
TXN0000008737,2024-03-20T23:05:38,ACC00000354,Debit,43.9,-1601435.27,JPY,Online Store
TXN0000008738,2024-12-05T12:48:00,ACC00008247,Debit,592.85,-1602028.12,EUR,Starbucks
TXN0000008739,2024-01-02T21:28:19,ACC00002077,Transfer,501.23,-1601526.89,GBP,Amazon
TXN0000008740,2024-11-11T17:18:12,ACC00000769,Credit,1642.25,-1599884.64,GBP,Grocery
TXN0000008741,2024-11-29T13:43:03,ACC00008987,Transfer,502.28,-1599382.36,GBP,Walmart
TXN0000008742,2024-10-26T16:43:15,ACC00002060,ATM,1133.32,-1600515.68,GBP,Grocery
TXN0000008743,2024-12-02T11:55:18,ACC00005631,Transfer,1478.96,-1599036.72,USD,Grocery
TXN0000008744,2024-08-01T08:25:37,ACC00005525,ATM,1923.94,-1600960.66,EUR,Walmart
TXN0000008745,2024-05-17T09:36:35,ACC00008397,Transfer,1157.55,-1599803.11,EUR,Walmart
TXN0000008746,2024-09-15T06:08:51,ACC00000828,ATM,77.52,-1599880.63,GBP,Online Store
TXN0000008747,2024-10-30T11:02:04,ACC00009747,Transfer,1586.42,-1598294.21,USD,Walmart
TXN0000008748,2024-05-23T07:02:26,ACC00000683,Debit,586.16,-1598880.37,USD,Walmart
TXN0000008749,2024-07-18T05:36:07,ACC00002986,Credit,1470.55,-1597409.82,USD,Walmart
TXN0000008750,2024-03-16T12:12:56,ACC00001926,Credit,1401.07,-1596008.75,JPY,Walmart
TXN0000008751,2024-11-19T19:30:48,ACC00000358,Payment,1693.07,-1597701.82,GBP,Target
TXN0000008752,2024-09-06T10:31:44,ACC00001654,ATM,960.94,-1598662.76,GBP,Grocery
TXN0000008753,2024-03-14T16:19:35,ACC00007912,Transfer,1867.54,-1596795.22,USD,Restaurant
TXN0000008754,2024-04-25T09:27:44,ACC00004910,Debit,679.19,-1597474.41,EUR,Starbucks
TXN0000008755,2024-10-19T03:08:52,ACC00007149,Credit,529.65,-1596944.76,GBP,Online Store
TXN0000008756,2024-02-19T00:59:17,ACC00002896,ATM,908.7,-1597853.46,USD,Restaurant
TXN0000008757,2024-10-09T04:34:18,ACC00008540,Transfer,1086.81,-1596766.65,USD,Grocery
TXN0000008758,2024-10-04T03:16:52,ACC00007009,Debit,1571.3,-1598337.95,EUR,Amazon
TXN0000008759,2024-02-18T12:30:57,ACC00005366,Transfer,76.45,-1598261.5,USD,Starbucks
TXN0000008760,2024-04-15T18:19:53,ACC00001021,ATM,1955.09,-1600216.59,JPY,Grocery
TXN0000008761,2024-07-03T05:16:31,ACC00003202,Transfer,1740.26,-1598476.33,JPY,Target
TXN0000008762,2024-12-12T14:59:28,ACC00007544,Transfer,303.47,-1598172.86,USD,Grocery
TXN0000008763,2024-08-21T01:44:44,ACC00002208,Debit,945.53,-1599118.39,GBP,Grocery
TXN0000008764,2024-05-21T22:02:25,ACC00002204,Credit,1981.11,-1597137.28,USD,Grocery
TXN0000008765,2024-07-28T17:41:36,ACC00008203,Transfer,1248.01,-1595889.27,USD,Online Store
TXN0000008766,2024-04-04T05:02:32,ACC00001855,Transfer,189.49,-1595699.78,JPY,Walmart
TXN0000008767,2024-02-01T22:38:51,ACC00005417,ATM,73.56,-1595773.34,GBP,Walmart
TXN0000008768,2024-08-10T20:15:13,ACC00007716,Transfer,1771.8,-1594001.54,EUR,Starbucks
TXN0000008769,2024-12-26T14:23:52,ACC00005626,Payment,1675.33,-1595676.87,EUR,Restaurant
TXN0000008770,2024-10-26T18:10:16,ACC00005523,Credit,1552.83,-1594124.04,JPY,Online Store
TXN0000008771,2024-08-23T18:22:04,ACC00006920,Payment,1248.18,-1595372.22,EUR,Target
TXN0000008772,2024-10-09T01:13:30,ACC00009239,Debit,910.48,-1596282.7,EUR,Shell
TXN0000008773,2024-09-08T02:25:48,ACC00005619,Payment,643.85,-1596926.55,GBP,Starbucks
TXN0000008774,2024-04-26T20:10:34,ACC00001883,ATM,1933.61,-1598860.16,EUR,Target
TXN0000008775,2024-09-04T16:10:39,ACC00008254,ATM,1785.09,-1600645.25,USD,Walmart
TXN0000008776,2024-09-28T12:07:33,ACC00009236,Transfer,102.09,-1600543.16,JPY,Walmart
TXN0000008777,2024-05-30T07:52:15,ACC00006008,Credit,1136.94,-1599406.22,USD,Walmart
TXN0000008778,2024-09-05T06:04:22,ACC00004437,Payment,1215.1,-1600621.32,EUR,Target
TXN0000008779,2024-11-01T09:50:43,ACC00000746,Debit,380.57,-1601001.89,JPY,Restaurant
TXN0000008780,2024-12-13T01:33:36,ACC00003896,Payment,36.49,-1601038.38,GBP,Grocery
TXN0000008781,2024-10-05T17:55:08,ACC00009445,Credit,1332.12,-1599706.26,EUR,Amazon
TXN0000008782,2024-10-22T11:57:56,ACC00001708,Credit,695.2,-1599011.06,JPY,Amazon
TXN0000008783,2024-04-01T16:14:25,ACC00009543,Debit,901.74,-1599912.8,EUR,Online Store
TXN0000008784,2024-06-11T07:58:36,ACC00007195,Credit,679.4,-1599233.4,GBP,Grocery
TXN0000008785,2024-03-15T02:21:46,ACC00002139,Credit,638.33,-1598595.07,EUR,Shell
TXN0000008786,2024-09-24T18:58:54,ACC00008015,Credit,209.71,-1598385.36,GBP,Walmart
TXN0000008787,2024-07-17T07:23:31,ACC00000519,Payment,13.39,-1598398.75,USD,Starbucks
TXN0000008788,2024-04-19T11:10:47,ACC00008781,Credit,960.84,-1597437.91,GBP,Starbucks
TXN0000008789,2024-07-30T10:02:47,ACC00000186,ATM,1647.5,-1599085.41,JPY,Target
TXN0000008790,2024-02-08T07:10:56,ACC00004244,Payment,1507.33,-1600592.74,EUR,Online Store
TXN0000008791,2024-07-14T19:00:43,ACC00007243,ATM,427.43,-1601020.17,JPY,Target
TXN0000008792,2024-04-01T13:51:03,ACC00001526,Credit,343.36,-1600676.81,JPY,Grocery
TXN0000008793,2024-08-03T00:14:31,ACC00006324,ATM,1980.38,-1602657.19,GBP,Restaurant
TXN0000008794,2024-06-12T00:48:27,ACC00003452,ATM,764.17,-1603421.36,JPY,Walmart
TXN0000008795,2024-05-10T22:08:32,ACC00000041,Credit,1053.88,-1602367.48,JPY,Amazon
TXN0000008796,2024-11-21T13:35:39,ACC00008080,Debit,878.15,-1603245.63,USD,Shell
TXN0000008797,2024-04-02T18:58:05,ACC00009212,Transfer,1002.89,-1602242.74,USD,Walmart
TXN0000008798,2024-02-26T05:34:54,ACC00000365,Credit,86.59,-1602156.15,JPY,Restaurant
TXN0000008799,2024-01-12T13:24:14,ACC00001995,Debit,328.06,-1602484.21,USD,Starbucks
TXN0000008800,2024-06-03T14:48:12,ACC00002437,ATM,816.35,-1603300.56,USD,Restaurant
TXN0000008801,2024-09-14T20:10:42,ACC00006432,Debit,198.05,-1603498.61,JPY,Starbucks
TXN0000008802,2024-07-16T16:05:48,ACC00009270,Payment,489.67,-1603988.28,GBP,Walmart
TXN0000008803,2024-08-23T07:46:17,ACC00000270,Transfer,295.13,-1603693.15,GBP,Amazon
TXN0000008804,2024-05-01T17:17:30,ACC00006664,ATM,1781.85,-1605475.0,GBP,Target
TXN0000008805,2024-05-31T20:46:49,ACC00005177,Transfer,1509.23,-1603965.77,GBP,Starbucks
TXN0000008806,2024-04-25T18:19:12,ACC00007277,Credit,106.23,-1603859.54,USD,Online Store
TXN0000008807,2024-05-22T11:12:20,ACC00007376,Debit,1730.98,-1605590.52,GBP,Walmart
TXN0000008808,2024-12-11T05:09:13,ACC00009174,ATM,815.85,-1606406.37,EUR,Shell
TXN0000008809,2024-01-22T23:35:25,ACC00009672,Payment,508.95,-1606915.32,JPY,Target
TXN0000008810,2024-03-30T01:49:31,ACC00000335,ATM,528.47,-1607443.79,JPY,Amazon
TXN0000008811,2024-05-05T02:27:01,ACC00007666,Debit,1137.3,-1608581.09,USD,Amazon
TXN0000008812,2024-09-19T08:20:20,ACC00009568,Credit,483.05,-1608098.04,EUR,Starbucks
TXN0000008813,2024-11-13T07:46:22,ACC00008095,Payment,1430.9,-1609528.94,USD,Online Store
TXN0000008814,2024-01-26T01:48:10,ACC00008396,Transfer,353.35,-1609175.59,JPY,Amazon
TXN0000008815,2024-04-28T03:15:42,ACC00005016,Credit,1398.22,-1607777.37,GBP,Walmart
TXN0000008816,2024-10-31T00:29:42,ACC00009126,Credit,570.33,-1607207.04,USD,Online Store
TXN0000008817,2024-02-16T04:53:50,ACC00008849,Credit,1710.16,-1605496.88,JPY,Target
TXN0000008818,2024-11-13T12:18:40,ACC00000821,Debit,641.57,-1606138.45,EUR,Amazon
TXN0000008819,2024-07-30T01:53:27,ACC00000820,Transfer,980.98,-1605157.47,EUR,Shell
TXN0000008820,2024-10-27T10:25:44,ACC00001463,ATM,666.02,-1605823.49,EUR,Restaurant
TXN0000008821,2024-12-10T02:01:11,ACC00004686,Payment,1367.65,-1607191.14,EUR,Walmart
TXN0000008822,2024-06-17T18:07:02,ACC00009412,Credit,1274.76,-1605916.38,EUR,Shell
TXN0000008823,2024-11-12T18:29:19,ACC00001409,Debit,305.56,-1606221.94,GBP,Shell
TXN0000008824,2024-02-22T00:08:53,ACC00007135,Debit,871.88,-1607093.82,GBP,Target
TXN0000008825,2024-11-21T22:42:22,ACC00002942,ATM,1906.53,-1609000.35,JPY,Online Store
TXN0000008826,2024-06-06T12:52:49,ACC00001245,Debit,1103.59,-1610103.94,GBP,Restaurant
TXN0000008827,2024-01-01T09:04:45,ACC00006357,Debit,159.72,-1610263.66,EUR,Grocery
TXN0000008828,2024-01-19T23:39:11,ACC00007799,Credit,1883.64,-1608380.02,GBP,Restaurant
TXN0000008829,2024-12-24T23:09:17,ACC00002361,Credit,1888.36,-1606491.66,JPY,Amazon
TXN0000008830,2024-09-30T19:53:26,ACC00007970,ATM,1534.53,-1608026.19,USD,Grocery
TXN0000008831,2024-04-25T09:30:43,ACC00002411,ATM,1026.1,-1609052.29,EUR,Amazon
TXN0000008832,2024-05-06T05:18:26,ACC00001725,Debit,797.65,-1609849.94,JPY,Target
TXN0000008833,2024-08-12T01:52:53,ACC00000721,Transfer,1492.16,-1608357.78,USD,Target
TXN0000008834,2024-05-02T18:36:33,ACC00003499,Debit,1512.89,-1609870.67,GBP,Walmart
TXN0000008835,2024-06-21T23:30:31,ACC00005692,Credit,80.64,-1609790.03,JPY,Walmart
TXN0000008836,2024-05-15T05:40:07,ACC00005950,ATM,1105.27,-1610895.3,JPY,Shell
TXN0000008837,2024-09-19T05:42:36,ACC00003157,Credit,347.39,-1610547.91,JPY,Grocery
TXN0000008838,2024-07-05T06:06:21,ACC00005675,ATM,652.51,-1611200.42,EUR,Starbucks
TXN0000008839,2024-06-08T15:06:24,ACC00004154,Credit,712.33,-1610488.09,GBP,Online Store
TXN0000008840,2024-07-26T21:06:48,ACC00006266,ATM,161.12,-1610649.21,JPY,Amazon
TXN0000008841,2024-09-21T09:33:22,ACC00009932,Credit,1617.23,-1609031.98,EUR,Walmart
TXN0000008842,2024-03-10T09:42:14,ACC00004774,Credit,1623.6,-1607408.38,JPY,Grocery
TXN0000008843,2024-11-01T07:08:06,ACC00004727,Debit,757.21,-1608165.59,USD,Restaurant
TXN0000008844,2024-08-29T10:26:41,ACC00003262,ATM,1483.93,-1609649.52,USD,Target
TXN0000008845,2024-12-01T18:54:43,ACC00008206,Transfer,21.44,-1609628.08,USD,Walmart
TXN0000008846,2024-03-14T23:03:04,ACC00008299,Credit,901.67,-1608726.41,USD,Online Store
TXN0000008847,2024-05-31T12:18:40,ACC00002647,ATM,211.61,-1608938.02,JPY,Grocery
TXN0000008848,2024-04-25T18:23:38,ACC00000401,Debit,1713.21,-1610651.23,JPY,Restaurant
TXN0000008849,2024-07-09T17:47:02,ACC00006812,Transfer,446.19,-1610205.04,EUR,Amazon
TXN0000008850,2024-11-04T12:21:24,ACC00002251,ATM,1736.48,-1611941.52,EUR,Restaurant
TXN0000008851,2024-11-05T04:14:25,ACC00007874,ATM,1024.35,-1612965.87,USD,Amazon
TXN0000008852,2024-01-24T03:36:36,ACC00009943,Transfer,1420.76,-1611545.11,EUR,Grocery
TXN0000008853,2024-10-08T04:48:57,ACC00003053,Payment,1463.03,-1613008.14,JPY,Grocery
TXN0000008854,2024-09-18T07:53:59,ACC00001989,Payment,1899.73,-1614907.87,JPY,Grocery
TXN0000008855,2024-03-13T23:48:17,ACC00004709,Payment,714.0,-1615621.87,GBP,Grocery
TXN0000008856,2024-05-08T06:03:01,ACC00006839,Credit,990.51,-1614631.36,USD,Restaurant
TXN0000008857,2024-04-06T06:48:20,ACC00005250,Credit,831.63,-1613799.73,GBP,Starbucks
TXN0000008858,2024-07-14T03:52:22,ACC00002139,Transfer,419.35,-1613380.38,GBP,Grocery
TXN0000008859,2024-10-05T04:35:44,ACC00003107,Credit,393.81,-1612986.57,EUR,Target
TXN0000008860,2024-04-23T09:17:48,ACC00001234,ATM,182.65,-1613169.22,GBP,Starbucks
TXN0000008861,2024-03-10T06:56:04,ACC00004210,Debit,531.61,-1613700.83,USD,Shell
TXN0000008862,2024-11-09T07:17:37,ACC00007666,ATM,171.31,-1613872.14,GBP,Restaurant
TXN0000008863,2024-11-18T13:19:59,ACC00003224,Debit,79.04,-1613951.18,GBP,Grocery
TXN0000008864,2024-12-26T13:28:13,ACC00007124,Credit,446.23,-1613504.95,USD,Starbucks
TXN0000008865,2024-12-29T03:33:29,ACC00003684,Transfer,1687.32,-1611817.63,GBP,Restaurant
TXN0000008866,2024-11-14T18:40:32,ACC00007954,ATM,1226.96,-1613044.59,USD,Walmart
TXN0000008867,2024-03-12T22:00:51,ACC00004285,Transfer,68.98,-1612975.61,USD,Restaurant
TXN0000008868,2024-11-24T23:03:42,ACC00006055,Credit,620.08,-1612355.53,GBP,Amazon
TXN0000008869,2024-09-09T08:34:06,ACC00004801,Credit,1192.38,-1611163.15,EUR,Starbucks
TXN0000008870,2024-06-14T15:00:51,ACC00007361,Credit,1509.98,-1609653.17,GBP,Shell
TXN0000008871,2024-03-02T16:53:13,ACC00006152,ATM,867.13,-1610520.3,GBP,Starbucks
TXN0000008872,2024-06-24T06:06:23,ACC00003246,ATM,1366.27,-1611886.57,GBP,Starbucks
TXN0000008873,2024-05-06T17:53:23,ACC00003098,Transfer,710.83,-1611175.74,EUR,Starbucks
TXN0000008874,2024-06-11T13:45:32,ACC00007074,Payment,933.52,-1612109.26,USD,Online Store
TXN0000008875,2024-06-09T15:22:31,ACC00001014,Debit,145.97,-1612255.23,USD,Target
TXN0000008876,2024-08-12T09:39:53,ACC00009670,Debit,1508.43,-1613763.66,EUR,Amazon
TXN0000008877,2024-05-24T08:11:05,ACC00005466,ATM,1562.94,-1615326.6,GBP,Shell
TXN0000008878,2024-04-14T21:04:49,ACC00003287,Credit,1197.44,-1614129.16,EUR,Grocery
TXN0000008879,2024-02-05T15:24:17,ACC00001340,Credit,1382.1,-1612747.06,EUR,Restaurant
TXN0000008880,2024-06-22T23:18:05,ACC00005593,ATM,1370.04,-1614117.1,USD,Target
TXN0000008881,2024-10-08T22:04:13,ACC00003444,Transfer,138.62,-1613978.48,JPY,Starbucks
TXN0000008882,2024-07-03T04:11:40,ACC00003766,ATM,1295.09,-1615273.57,USD,Target
TXN0000008883,2024-02-28T08:01:41,ACC00001055,ATM,172.04,-1615445.61,GBP,Online Store
TXN0000008884,2024-03-06T06:31:24,ACC00008010,Credit,707.45,-1614738.16,JPY,Starbucks
TXN0000008885,2024-08-23T01:45:44,ACC00002744,ATM,343.63,-1615081.79,USD,Walmart
TXN0000008886,2024-02-04T15:03:16,ACC00003338,ATM,1561.47,-1616643.26,GBP,Shell
TXN0000008887,2024-07-09T15:03:28,ACC00009611,Credit,1541.99,-1615101.27,USD,Grocery
TXN0000008888,2024-08-15T18:07:27,ACC00005244,Payment,1005.89,-1616107.16,JPY,Restaurant
TXN0000008889,2024-05-10T01:28:33,ACC00005651,ATM,685.74,-1616792.9,JPY,Amazon
TXN0000008890,2024-02-04T09:47:37,ACC00007972,Debit,350.15,-1617143.05,JPY,Amazon
TXN0000008891,2024-05-09T02:47:25,ACC00006403,Credit,1553.53,-1615589.52,EUR,Grocery
TXN0000008892,2024-07-19T20:43:38,ACC00004743,Transfer,129.07,-1615460.45,USD,Starbucks
TXN0000008893,2024-03-14T00:24:40,ACC00001964,Debit,144.13,-1615604.58,GBP,Walmart
TXN0000008894,2024-07-18T12:48:42,ACC00005510,ATM,1736.72,-1617341.3,JPY,Online Store
TXN0000008895,2024-09-12T20:57:05,ACC00009463,Debit,1546.25,-1618887.55,USD,Walmart
TXN0000008896,2024-06-08T04:50:39,ACC00005077,Debit,173.04,-1619060.59,JPY,Online Store
TXN0000008897,2024-03-31T06:40:47,ACC00005754,Transfer,637.24,-1618423.35,JPY,Target
TXN0000008898,2024-10-19T23:00:46,ACC00001934,Payment,640.2,-1619063.55,USD,Shell
TXN0000008899,2024-06-25T09:18:31,ACC00001812,Payment,408.35,-1619471.9,USD,Shell
TXN0000008900,2024-04-29T05:18:20,ACC00004550,Transfer,1895.48,-1617576.42,GBP,Walmart
TXN0000008901,2024-12-19T07:07:04,ACC00002766,ATM,297.41,-1617873.83,JPY,Walmart
TXN0000008902,2024-01-05T00:25:56,ACC00009723,Transfer,1468.67,-1616405.16,JPY,Starbucks
TXN0000008903,2024-03-25T02:30:13,ACC00009493,Payment,1703.85,-1618109.01,GBP,Restaurant
TXN0000008904,2024-04-04T20:10:21,ACC00002599,Debit,781.47,-1618890.48,USD,Restaurant
TXN0000008905,2024-03-09T08:43:07,ACC00009918,Debit,359.82,-1619250.3,JPY,Online Store
TXN0000008906,2024-10-19T06:57:07,ACC00006309,Debit,603.47,-1619853.77,JPY,Grocery
TXN0000008907,2024-03-25T10:05:38,ACC00007500,Transfer,1628.89,-1618224.88,USD,Grocery
TXN0000008908,2024-03-16T12:10:57,ACC00006418,Transfer,1668.43,-1616556.45,USD,Amazon
TXN0000008909,2024-03-04T23:49:03,ACC00005088,Transfer,1881.92,-1614674.53,EUR,Amazon
TXN0000008910,2024-07-29T09:05:50,ACC00007815,Transfer,152.25,-1614522.28,USD,Online Store
TXN0000008911,2024-07-16T00:07:35,ACC00008738,Payment,836.37,-1615358.65,JPY,Walmart
TXN0000008912,2024-09-03T17:19:31,ACC00006641,Transfer,1797.84,-1613560.81,GBP,Amazon
TXN0000008913,2024-05-10T19:53:07,ACC00003175,Transfer,565.6,-1612995.21,GBP,Restaurant
TXN0000008914,2024-05-17T21:05:36,ACC00005881,Payment,729.21,-1613724.42,JPY,Amazon
TXN0000008915,2024-03-23T09:14:51,ACC00000059,Debit,1657.32,-1615381.74,USD,Starbucks
TXN0000008916,2024-10-05T20:19:52,ACC00007378,ATM,92.32,-1615474.06,EUR,Target
TXN0000008917,2024-12-19T12:38:39,ACC00002931,Credit,1155.79,-1614318.27,GBP,Amazon
TXN0000008918,2024-08-20T07:31:55,ACC00003584,Credit,1155.01,-1613163.26,JPY,Target
TXN0000008919,2024-03-07T05:23:50,ACC00009162,Debit,1634.9,-1614798.16,JPY,Walmart
TXN0000008920,2024-01-05T01:35:39,ACC00002902,Credit,130.35,-1614667.81,GBP,Shell
TXN0000008921,2024-07-17T05:42:52,ACC00000804,ATM,413.87,-1615081.68,EUR,Walmart
TXN0000008922,2024-04-30T06:17:44,ACC00009128,ATM,1258.01,-1616339.69,GBP,Restaurant
TXN0000008923,2024-06-28T06:49:05,ACC00004828,Payment,964.12,-1617303.81,JPY,Target
TXN0000008924,2024-10-24T18:45:51,ACC00001557,Credit,616.33,-1616687.48,EUR,Grocery
TXN0000008925,2024-10-23T23:45:38,ACC00003186,ATM,1722.73,-1618410.21,EUR,Starbucks
TXN0000008926,2024-06-10T13:18:28,ACC00007366,ATM,733.94,-1619144.15,JPY,Starbucks
TXN0000008927,2024-05-28T07:48:12,ACC00001641,Debit,1664.98,-1620809.13,EUR,Amazon
TXN0000008928,2024-05-06T17:12:46,ACC00007747,Payment,573.08,-1621382.21,EUR,Shell
TXN0000008929,2024-11-20T01:22:13,ACC00008110,Credit,434.35,-1620947.86,JPY,Amazon
TXN0000008930,2024-04-24T06:45:14,ACC00003102,Credit,712.61,-1620235.25,JPY,Amazon
TXN0000008931,2024-11-03T23:25:02,ACC00004346,Debit,345.24,-1620580.49,EUR,Shell
TXN0000008932,2024-09-18T12:09:55,ACC00002192,Credit,59.04,-1620521.45,GBP,Online Store
TXN0000008933,2024-01-23T06:16:10,ACC00009993,Payment,1661.3,-1622182.75,GBP,Online Store
TXN0000008934,2024-04-20T16:48:40,ACC00009014,Payment,54.69,-1622237.44,JPY,Walmart
TXN0000008935,2024-04-10T01:14:24,ACC00000082,Payment,129.02,-1622366.46,GBP,Amazon
TXN0000008936,2024-06-14T12:36:21,ACC00000234,Payment,510.17,-1622876.63,JPY,Grocery
TXN0000008937,2024-10-10T06:59:18,ACC00008896,Transfer,683.61,-1622193.02,USD,Walmart
TXN0000008938,2024-02-14T03:45:22,ACC00004326,Transfer,1145.62,-1621047.4,GBP,Shell
TXN0000008939,2024-09-28T10:13:41,ACC00000035,ATM,1963.61,-1623011.01,GBP,Online Store
TXN0000008940,2024-08-29T05:45:08,ACC00004642,Payment,1789.14,-1624800.15,GBP,Walmart
TXN0000008941,2024-11-16T19:26:52,ACC00000942,ATM,883.37,-1625683.52,EUR,Target
TXN0000008942,2024-02-21T10:47:41,ACC00009502,Debit,1762.14,-1627445.66,EUR,Shell
TXN0000008943,2024-07-29T22:45:50,ACC00003443,Transfer,1186.94,-1626258.72,GBP,Restaurant
TXN0000008944,2024-05-06T04:49:31,ACC00005625,Debit,1755.96,-1628014.68,GBP,Grocery
TXN0000008945,2024-09-21T06:36:25,ACC00001972,Payment,1766.66,-1629781.34,EUR,Amazon
TXN0000008946,2024-08-21T07:01:01,ACC00003562,Debit,669.46,-1630450.8,GBP,Target
TXN0000008947,2024-03-23T04:54:50,ACC00005691,Debit,525.5,-1630976.3,EUR,Grocery
TXN0000008948,2024-05-09T07:20:36,ACC00007104,Transfer,1632.62,-1629343.68,JPY,Starbucks
TXN0000008949,2024-03-13T00:25:45,ACC00009988,Debit,448.8,-1629792.48,USD,Target
TXN0000008950,2024-09-04T20:28:15,ACC00007925,Transfer,1148.87,-1628643.61,USD,Walmart
TXN0000008951,2024-10-15T20:28:19,ACC00003312,ATM,751.99,-1629395.6,USD,Starbucks
TXN0000008952,2024-08-21T15:07:13,ACC00004386,Payment,1754.13,-1631149.73,USD,Shell
TXN0000008953,2024-05-21T11:28:26,ACC00002789,ATM,1513.83,-1632663.56,GBP,Walmart
TXN0000008954,2024-03-28T13:48:45,ACC00006001,Credit,1515.87,-1631147.69,EUR,Amazon
TXN0000008955,2024-01-12T08:28:31,ACC00005737,Debit,1363.83,-1632511.52,USD,Online Store
TXN0000008956,2024-09-17T07:51:09,ACC00005193,Payment,1917.77,-1634429.29,GBP,Shell
TXN0000008957,2024-07-09T17:51:39,ACC00001876,Payment,766.56,-1635195.85,EUR,Shell
TXN0000008958,2024-05-07T03:46:50,ACC00002642,Transfer,710.01,-1634485.84,JPY,Shell
TXN0000008959,2024-06-14T11:35:48,ACC00005109,ATM,60.76,-1634546.6,EUR,Starbucks
TXN0000008960,2024-01-01T03:55:50,ACC00001335,Transfer,986.79,-1633559.81,JPY,Amazon
TXN0000008961,2024-03-17T23:57:33,ACC00005908,ATM,1420.97,-1634980.78,GBP,Online Store
TXN0000008962,2024-08-15T19:31:30,ACC00008043,Transfer,725.61,-1634255.17,JPY,Walmart
TXN0000008963,2024-04-26T10:46:28,ACC00006556,ATM,896.89,-1635152.06,GBP,Shell
TXN0000008964,2024-02-06T23:53:37,ACC00003861,Payment,1659.46,-1636811.52,GBP,Grocery
TXN0000008965,2024-05-20T17:46:26,ACC00009628,Debit,1748.33,-1638559.85,GBP,Amazon
TXN0000008966,2024-11-19T11:05:20,ACC00006133,Transfer,846.92,-1637712.93,JPY,Online Store
TXN0000008967,2024-03-28T05:27:53,ACC00006565,Transfer,1273.74,-1636439.19,USD,Restaurant
TXN0000008968,2024-02-11T02:05:43,ACC00004328,Transfer,1729.47,-1634709.72,EUR,Starbucks
TXN0000008969,2024-02-19T14:40:26,ACC00000743,Transfer,1378.97,-1633330.75,JPY,Starbucks
TXN0000008970,2024-08-09T23:19:22,ACC00000386,ATM,1236.66,-1634567.41,GBP,Target
TXN0000008971,2024-01-06T23:42:20,ACC00005985,Transfer,263.29,-1634304.12,JPY,Amazon
TXN0000008972,2024-10-24T10:28:52,ACC00009248,Debit,168.3,-1634472.42,EUR,Walmart
TXN0000008973,2024-08-13T05:12:28,ACC00008854,Credit,930.47,-1633541.95,USD,Walmart
TXN0000008974,2024-04-23T16:05:19,ACC00008324,Transfer,574.42,-1632967.53,GBP,Shell
TXN0000008975,2024-09-08T02:03:24,ACC00002150,Debit,1550.36,-1634517.89,USD,Target
TXN0000008976,2024-06-16T11:21:02,ACC00002697,Credit,1027.86,-1633490.03,USD,Online Store
TXN0000008977,2024-05-28T11:25:00,ACC00004747,Credit,262.0,-1633228.03,EUR,Shell
TXN0000008978,2024-08-14T22:57:51,ACC00000591,Debit,323.2,-1633551.23,USD,Online Store
TXN0000008979,2024-06-04T08:37:45,ACC00007265,ATM,966.82,-1634518.05,EUR,Starbucks
TXN0000008980,2024-08-16T20:27:16,ACC00003728,ATM,1692.88,-1636210.93,GBP,Amazon
TXN0000008981,2024-09-22T03:01:14,ACC00002778,ATM,1075.24,-1637286.17,JPY,Target
TXN0000008982,2024-04-21T06:47:02,ACC00003671,Debit,1032.32,-1638318.49,EUR,Walmart
TXN0000008983,2024-10-20T04:55:04,ACC00005544,Debit,438.98,-1638757.47,EUR,Walmart
TXN0000008984,2024-06-29T22:53:23,ACC00003749,ATM,1516.65,-1640274.12,JPY,Amazon
TXN0000008985,2024-01-15T15:46:15,ACC00009897,ATM,1394.81,-1641668.93,EUR,Restaurant
TXN0000008986,2024-05-02T13:27:56,ACC00008431,ATM,321.61,-1641990.54,USD,Restaurant
TXN0000008987,2024-08-05T10:45:57,ACC00001683,Debit,1907.63,-1643898.17,GBP,Grocery
TXN0000008988,2024-12-18T08:25:47,ACC00004787,Credit,110.79,-1643787.38,USD,Target
TXN0000008989,2024-09-29T17:25:35,ACC00009634,Credit,1358.15,-1642429.23,EUR,Shell
TXN0000008990,2024-10-25T00:26:57,ACC00002948,Transfer,671.73,-1641757.5,EUR,Amazon
TXN0000008991,2024-10-22T21:34:00,ACC00003649,Credit,899.83,-1640857.67,JPY,Restaurant
TXN0000008992,2024-08-29T04:54:49,ACC00006825,ATM,96.43,-1640954.1,USD,Shell
TXN0000008993,2024-06-16T03:19:56,ACC00000426,Transfer,871.35,-1640082.75,GBP,Amazon
TXN0000008994,2024-05-04T08:22:10,ACC00000449,ATM,785.39,-1640868.14,JPY,Walmart
TXN0000008995,2024-11-25T18:35:40,ACC00003818,Credit,453.72,-1640414.42,USD,Starbucks
TXN0000008996,2024-12-23T05:17:02,ACC00000401,ATM,1532.62,-1641947.04,JPY,Grocery
TXN0000008997,2024-06-03T10:35:33,ACC00003762,Debit,168.04,-1642115.08,JPY,Online Store
TXN0000008998,2024-05-04T11:54:43,ACC00005215,Credit,96.77,-1642018.31,EUR,Starbucks
TXN0000008999,2024-10-12T09:37:57,ACC00002341,Payment,372.95,-1642391.26,JPY,Starbucks
TXN0000009000,2024-09-15T03:30:01,ACC00005159,Credit,183.02,-1642208.24,EUR,Online Store
TXN0000009001,2024-09-21T22:48:19,ACC00006207,ATM,1944.76,-1644153.0,USD,Target
TXN0000009002,2024-08-09T10:56:32,ACC00002362,Debit,621.63,-1644774.63,GBP,Walmart
TXN0000009003,2024-02-08T05:56:39,ACC00005228,Debit,530.52,-1645305.15,USD,Shell
TXN0000009004,2024-12-27T21:05:07,ACC00003076,ATM,800.41,-1646105.56,EUR,Amazon
TXN0000009005,2024-08-13T18:05:18,ACC00003774,Debit,1984.23,-1648089.79,EUR,Walmart
TXN0000009006,2024-04-11T17:45:09,ACC00007122,ATM,1537.21,-1649627.0,GBP,Grocery
TXN0000009007,2024-01-28T10:30:07,ACC00002549,Payment,1923.55,-1651550.55,USD,Walmart
TXN0000009008,2024-01-03T21:39:00,ACC00007567,Credit,1001.99,-1650548.56,USD,Target
TXN0000009009,2024-10-05T00:35:02,ACC00008096,Transfer,228.31,-1650320.25,JPY,Shell
TXN0000009010,2024-10-23T01:10:29,ACC00000638,Transfer,72.23,-1650248.02,USD,Grocery
TXN0000009011,2024-05-16T08:06:13,ACC00009137,Debit,872.98,-1651121.0,USD,Restaurant
TXN0000009012,2024-07-08T00:30:08,ACC00006270,Payment,1272.67,-1652393.67,USD,Walmart
TXN0000009013,2024-05-16T04:42:48,ACC00009257,Debit,620.93,-1653014.6,GBP,Starbucks
TXN0000009014,2024-05-15T06:08:42,ACC00005334,Payment,377.61,-1653392.21,GBP,Restaurant
TXN0000009015,2024-09-11T01:43:59,ACC00009854,Credit,135.95,-1653256.26,GBP,Walmart
TXN0000009016,2024-05-13T13:27:35,ACC00007105,Debit,1207.58,-1654463.84,GBP,Restaurant
TXN0000009017,2024-07-16T04:35:53,ACC00007274,Transfer,552.93,-1653910.91,GBP,Shell
TXN0000009018,2024-07-20T22:53:22,ACC00006420,ATM,389.63,-1654300.54,EUR,Amazon
TXN0000009019,2024-04-08T09:44:37,ACC00008501,Debit,543.64,-1654844.18,JPY,Shell
TXN0000009020,2024-03-17T08:05:27,ACC00009355,Debit,165.38,-1655009.56,USD,Grocery
TXN0000009021,2024-08-25T08:51:33,ACC00004853,Debit,281.86,-1655291.42,USD,Amazon
TXN0000009022,2024-03-05T20:18:15,ACC00005131,Transfer,536.02,-1654755.4,GBP,Starbucks
TXN0000009023,2024-06-06T15:53:02,ACC00007731,Debit,1610.6,-1656366.0,USD,Grocery
TXN0000009024,2024-09-14T03:56:42,ACC00007390,ATM,880.29,-1657246.29,JPY,Shell
TXN0000009025,2024-02-21T10:35:07,ACC00002775,Credit,1369.45,-1655876.84,GBP,Restaurant
TXN0000009026,2024-10-15T17:14:48,ACC00002084,Transfer,737.87,-1655138.97,JPY,Grocery
TXN0000009027,2024-10-20T09:04:07,ACC00001890,ATM,213.55,-1655352.52,USD,Walmart
TXN0000009028,2024-07-28T02:11:20,ACC00000585,ATM,717.0,-1656069.52,EUR,Restaurant
TXN0000009029,2024-09-05T17:30:37,ACC00003457,ATM,422.26,-1656491.78,EUR,Amazon
TXN0000009030,2024-07-22T04:33:35,ACC00004489,Payment,423.5,-1656915.28,JPY,Target
TXN0000009031,2024-02-23T01:31:14,ACC00008538,Credit,1665.45,-1655249.83,GBP,Grocery
TXN0000009032,2024-07-28T03:50:03,ACC00000582,Credit,1852.73,-1653397.1,USD,Starbucks
TXN0000009033,2024-04-05T14:43:37,ACC00008760,ATM,981.3,-1654378.4,GBP,Amazon
TXN0000009034,2024-09-12T23:16:11,ACC00001342,Transfer,103.15,-1654275.25,USD,Amazon
TXN0000009035,2024-09-14T17:34:31,ACC00009738,Transfer,609.4,-1653665.85,JPY,Grocery
TXN0000009036,2024-04-22T02:35:34,ACC00006857,ATM,38.4,-1653704.25,JPY,Grocery
TXN0000009037,2024-02-14T07:01:20,ACC00005904,Payment,1598.4,-1655302.65,EUR,Online Store
TXN0000009038,2024-08-07T11:05:35,ACC00002904,ATM,1411.31,-1656713.96,USD,Amazon
TXN0000009039,2024-02-16T23:17:22,ACC00006107,Payment,946.78,-1657660.74,USD,Restaurant
TXN0000009040,2024-11-09T20:42:26,ACC00002007,ATM,934.1,-1658594.84,GBP,Amazon
TXN0000009041,2024-03-10T18:46:59,ACC00000672,ATM,818.05,-1659412.89,JPY,Amazon
TXN0000009042,2024-07-11T18:06:56,ACC00001815,Payment,326.92,-1659739.81,EUR,Walmart
TXN0000009043,2024-09-24T07:44:41,ACC00003140,Credit,343.83,-1659395.98,GBP,Online Store
TXN0000009044,2024-10-02T16:33:45,ACC00001266,Transfer,1823.29,-1657572.69,EUR,Walmart
TXN0000009045,2024-03-17T21:58:49,ACC00001748,Debit,543.37,-1658116.06,USD,Grocery
TXN0000009046,2024-09-12T17:39:33,ACC00004760,Credit,1357.03,-1656759.03,GBP,Online Store
TXN0000009047,2024-11-10T05:23:06,ACC00008562,Credit,124.33,-1656634.7,USD,Amazon
TXN0000009048,2024-11-15T21:10:47,ACC00007969,Debit,940.59,-1657575.29,USD,Amazon
TXN0000009049,2024-09-15T09:36:17,ACC00000395,ATM,1503.52,-1659078.81,JPY,Restaurant
TXN0000009050,2024-06-15T16:07:41,ACC00007122,ATM,1642.81,-1660721.62,USD,Shell
TXN0000009051,2024-07-28T22:04:05,ACC00001880,ATM,344.06,-1661065.68,JPY,Grocery
TXN0000009052,2024-10-20T00:57:45,ACC00000444,ATM,291.35,-1661357.03,USD,Target
TXN0000009053,2024-09-20T11:26:27,ACC00009518,Debit,371.53,-1661728.56,GBP,Starbucks
TXN0000009054,2024-07-02T05:03:30,ACC00009829,Debit,295.03,-1662023.59,EUR,Target
TXN0000009055,2024-05-29T22:08:32,ACC00005055,Debit,226.04,-1662249.63,USD,Restaurant
TXN0000009056,2024-08-09T02:02:47,ACC00008231,Debit,797.74,-1663047.37,USD,Target
TXN0000009057,2024-06-27T23:35:55,ACC00007632,Debit,1638.46,-1664685.83,JPY,Restaurant
TXN0000009058,2024-10-31T14:53:32,ACC00002087,Payment,1582.04,-1666267.87,USD,Restaurant
TXN0000009059,2024-11-10T22:43:20,ACC00001812,Debit,1889.9,-1668157.77,USD,Amazon
TXN0000009060,2024-11-07T11:12:16,ACC00008695,Transfer,417.88,-1667739.89,JPY,Grocery
TXN0000009061,2024-11-21T15:49:42,ACC00001930,Payment,712.25,-1668452.14,USD,Amazon
TXN0000009062,2024-11-12T02:43:29,ACC00005942,ATM,1787.38,-1670239.52,USD,Starbucks
TXN0000009063,2024-03-19T01:46:42,ACC00005962,Debit,1121.44,-1671360.96,GBP,Amazon
TXN0000009064,2024-08-10T01:16:01,ACC00005823,Credit,629.16,-1670731.8,EUR,Restaurant
TXN0000009065,2024-08-04T14:59:05,ACC00007715,Debit,1943.63,-1672675.43,USD,Walmart
TXN0000009066,2024-08-17T23:58:53,ACC00007452,ATM,573.39,-1673248.82,GBP,Restaurant
TXN0000009067,2024-12-19T11:57:27,ACC00000136,Transfer,904.96,-1672343.86,USD,Shell
TXN0000009068,2024-11-23T05:22:26,ACC00002388,Transfer,251.18,-1672092.68,JPY,Restaurant
TXN0000009069,2024-03-01T21:14:11,ACC00004289,Transfer,1523.3,-1670569.38,JPY,Shell
TXN0000009070,2024-09-12T08:59:28,ACC00001673,Credit,425.78,-1670143.6,EUR,Grocery
TXN0000009071,2024-12-28T22:00:58,ACC00003777,Credit,1557.87,-1668585.73,JPY,Target
TXN0000009072,2024-10-18T22:30:35,ACC00006462,Debit,928.89,-1669514.62,USD,Grocery
TXN0000009073,2024-09-11T03:41:06,ACC00006376,Transfer,1283.0,-1668231.62,GBP,Walmart
TXN0000009074,2024-12-13T13:31:25,ACC00002132,Credit,1293.18,-1666938.44,GBP,Grocery
TXN0000009075,2024-08-31T19:53:36,ACC00003331,Transfer,100.17,-1666838.27,EUR,Shell
TXN0000009076,2024-06-23T16:13:21,ACC00005342,Payment,1695.69,-1668533.96,JPY,Grocery
TXN0000009077,2024-07-16T06:53:38,ACC00004901,Debit,1035.65,-1669569.61,GBP,Shell
TXN0000009078,2024-09-24T15:37:00,ACC00001157,Debit,160.85,-1669730.46,GBP,Target
TXN0000009079,2024-02-05T08:44:37,ACC00000328,Transfer,687.18,-1669043.28,EUR,Amazon
TXN0000009080,2024-10-19T18:03:47,ACC00001498,Payment,1203.71,-1670246.99,USD,Online Store
TXN0000009081,2024-05-30T09:12:43,ACC00001769,Credit,1779.37,-1668467.62,GBP,Grocery
TXN0000009082,2024-11-02T14:23:13,ACC00009520,Debit,708.55,-1669176.17,JPY,Walmart
TXN0000009083,2024-01-31T09:11:26,ACC00009258,Debit,75.26,-1669251.43,EUR,Restaurant
TXN0000009084,2024-01-28T09:33:40,ACC00000702,Credit,694.48,-1668556.95,EUR,Restaurant
TXN0000009085,2024-02-29T04:28:57,ACC00002858,Payment,1148.36,-1669705.31,USD,Walmart
TXN0000009086,2024-07-06T11:09:01,ACC00007575,Debit,576.59,-1670281.9,EUR,Walmart
TXN0000009087,2024-11-24T18:05:30,ACC00005531,Transfer,284.55,-1669997.35,EUR,Grocery
TXN0000009088,2024-02-06T06:37:30,ACC00008278,ATM,1872.27,-1671869.62,GBP,Starbucks
TXN0000009089,2024-08-06T20:28:00,ACC00003314,Debit,271.98,-1672141.6,JPY,Starbucks
TXN0000009090,2024-12-24T22:39:06,ACC00009819,Transfer,226.76,-1671914.84,JPY,Amazon
TXN0000009091,2024-12-09T22:17:57,ACC00008353,Transfer,324.54,-1671590.3,JPY,Restaurant
TXN0000009092,2024-12-27T08:47:43,ACC00003119,Transfer,735.89,-1670854.41,JPY,Starbucks
TXN0000009093,2024-11-17T16:03:24,ACC00007176,Credit,717.97,-1670136.44,USD,Online Store
TXN0000009094,2024-09-23T09:01:39,ACC00005602,Debit,52.01,-1670188.45,USD,Walmart
TXN0000009095,2024-04-30T23:12:26,ACC00004148,Debit,884.79,-1671073.24,GBP,Amazon
TXN0000009096,2024-07-05T17:15:06,ACC00002781,Debit,895.54,-1671968.78,JPY,Amazon
TXN0000009097,2024-05-25T09:42:10,ACC00007442,Credit,43.67,-1671925.11,GBP,Amazon
TXN0000009098,2024-10-13T14:58:28,ACC00002211,Debit,223.56,-1672148.67,USD,Restaurant
TXN0000009099,2024-08-14T18:31:20,ACC00004552,Debit,416.54,-1672565.21,GBP,Online Store
TXN0000009100,2024-05-26T01:23:22,ACC00007778,Credit,386.22,-1672178.99,JPY,Amazon
TXN0000009101,2024-03-16T11:16:20,ACC00008295,ATM,909.71,-1673088.7,GBP,Restaurant
TXN0000009102,2024-04-03T11:42:45,ACC00009342,ATM,1525.9,-1674614.6,EUR,Walmart
TXN0000009103,2024-04-17T11:02:56,ACC00004171,Debit,190.64,-1674805.24,JPY,Restaurant
TXN0000009104,2024-04-26T12:47:34,ACC00004123,Payment,825.85,-1675631.09,JPY,Walmart
TXN0000009105,2024-08-12T09:23:18,ACC00007222,Debit,247.96,-1675879.05,JPY,Starbucks
TXN0000009106,2024-11-04T00:25:20,ACC00001014,Payment,94.59,-1675973.64,GBP,Restaurant
TXN0000009107,2024-03-16T18:36:06,ACC00000517,Debit,440.06,-1676413.7,USD,Grocery
TXN0000009108,2024-05-09T03:20:51,ACC00003010,ATM,1051.68,-1677465.38,JPY,Target
TXN0000009109,2024-09-06T17:29:33,ACC00006212,Credit,1135.96,-1676329.42,JPY,Restaurant
TXN0000009110,2024-03-15T03:13:21,ACC00007358,ATM,1187.11,-1677516.53,EUR,Shell
TXN0000009111,2024-01-09T16:16:00,ACC00009128,Credit,419.31,-1677097.22,USD,Online Store
TXN0000009112,2024-02-17T07:08:25,ACC00008217,ATM,1047.39,-1678144.61,JPY,Restaurant
TXN0000009113,2024-10-04T11:25:45,ACC00003315,Debit,691.74,-1678836.35,USD,Target
TXN0000009114,2024-04-15T15:49:59,ACC00002790,Payment,779.92,-1679616.27,JPY,Starbucks
TXN0000009115,2024-12-21T15:01:37,ACC00009481,Transfer,485.93,-1679130.34,EUR,Online Store
TXN0000009116,2024-04-05T15:25:47,ACC00009419,ATM,698.38,-1679828.72,JPY,Target
TXN0000009117,2024-01-23T23:03:43,ACC00001328,Credit,1611.13,-1678217.59,JPY,Target
TXN0000009118,2024-07-10T18:44:40,ACC00006503,ATM,428.51,-1678646.1,GBP,Shell
TXN0000009119,2024-12-09T00:50:32,ACC00000486,Payment,154.01,-1678800.11,JPY,Target
TXN0000009120,2024-02-04T16:12:05,ACC00006032,Debit,523.78,-1679323.89,GBP,Restaurant
TXN0000009121,2024-04-30T11:36:34,ACC00004238,Transfer,50.37,-1679273.52,EUR,Amazon
TXN0000009122,2024-09-28T15:11:35,ACC00002507,Debit,1372.22,-1680645.74,JPY,Walmart
TXN0000009123,2024-10-04T02:46:23,ACC00009815,Transfer,1874.46,-1678771.28,GBP,Target
TXN0000009124,2024-06-25T22:05:15,ACC00005184,Payment,1039.67,-1679810.95,GBP,Online Store
TXN0000009125,2024-09-16T04:02:32,ACC00000388,Credit,1971.81,-1677839.14,GBP,Shell
TXN0000009126,2024-09-25T05:21:50,ACC00004884,Debit,100.73,-1677939.87,GBP,Amazon
TXN0000009127,2024-06-16T15:01:10,ACC00001121,Payment,692.08,-1678631.95,GBP,Shell
TXN0000009128,2024-12-12T13:20:31,ACC00008689,Transfer,1218.37,-1677413.58,GBP,Starbucks
TXN0000009129,2024-08-26T21:45:06,ACC00001318,Debit,912.96,-1678326.54,EUR,Amazon
TXN0000009130,2024-02-23T13:38:09,ACC00008248,Debit,1732.03,-1680058.57,JPY,Restaurant
TXN0000009131,2024-08-11T15:28:06,ACC00000830,Transfer,1029.88,-1679028.69,EUR,Restaurant
TXN0000009132,2024-08-10T21:29:28,ACC00009107,Debit,1578.97,-1680607.66,USD,Shell
TXN0000009133,2024-04-29T14:57:05,ACC00002015,Payment,1741.04,-1682348.7,GBP,Starbucks
TXN0000009134,2024-09-30T13:59:38,ACC00000065,Debit,180.11,-1682528.81,EUR,Starbucks
TXN0000009135,2024-02-06T01:03:08,ACC00008198,Payment,1506.18,-1684034.99,EUR,Walmart
TXN0000009136,2024-10-17T19:35:16,ACC00001191,Credit,1380.41,-1682654.58,EUR,Amazon
TXN0000009137,2024-08-14T15:40:17,ACC00004787,ATM,1528.37,-1684182.95,USD,Walmart
TXN0000009138,2024-08-10T12:17:34,ACC00005564,ATM,35.48,-1684218.43,EUR,Target
TXN0000009139,2024-02-16T12:39:54,ACC00009383,Payment,140.45,-1684358.88,GBP,Amazon
TXN0000009140,2024-06-05T01:00:55,ACC00007023,Debit,1116.31,-1685475.19,USD,Amazon
TXN0000009141,2024-11-13T12:16:05,ACC00003178,Transfer,1382.35,-1684092.84,JPY,Target
TXN0000009142,2024-01-14T23:51:21,ACC00004690,Credit,606.75,-1683486.09,EUR,Restaurant
TXN0000009143,2024-06-29T19:42:30,ACC00002328,ATM,1640.55,-1685126.64,USD,Restaurant
TXN0000009144,2024-10-01T04:35:08,ACC00003606,Debit,341.54,-1685468.18,GBP,Starbucks
TXN0000009145,2024-12-17T01:20:21,ACC00001616,Debit,170.35,-1685638.53,USD,Online Store
TXN0000009146,2024-01-08T07:18:00,ACC00008334,Payment,1798.31,-1687436.84,EUR,Amazon
TXN0000009147,2024-02-04T20:30:47,ACC00005612,Debit,1431.19,-1688868.03,GBP,Starbucks
TXN0000009148,2024-04-01T13:09:52,ACC00006459,Debit,1496.03,-1690364.06,EUR,Walmart
TXN0000009149,2024-12-22T05:46:35,ACC00005785,Debit,1300.74,-1691664.8,EUR,Online Store
TXN0000009150,2024-03-23T03:19:49,ACC00001738,Transfer,1565.29,-1690099.51,JPY,Online Store
TXN0000009151,2024-10-30T17:38:59,ACC00005481,ATM,1173.62,-1691273.13,USD,Online Store
TXN0000009152,2024-05-28T06:52:30,ACC00008436,Transfer,1833.79,-1689439.34,GBP,Online Store
TXN0000009153,2024-06-04T21:30:35,ACC00008971,Credit,1398.8,-1688040.54,GBP,Restaurant
TXN0000009154,2024-09-08T00:18:50,ACC00002240,Credit,1677.77,-1686362.77,JPY,Restaurant
TXN0000009155,2024-11-27T17:36:09,ACC00004040,Debit,1523.01,-1687885.78,EUR,Walmart
TXN0000009156,2024-12-24T01:08:26,ACC00008568,Payment,1125.18,-1689010.96,EUR,Restaurant
TXN0000009157,2024-02-25T03:14:31,ACC00003335,Debit,145.8,-1689156.76,JPY,Target
TXN0000009158,2024-05-15T05:00:12,ACC00009554,ATM,62.46,-1689219.22,USD,Restaurant
TXN0000009159,2024-03-04T20:34:33,ACC00003159,Credit,476.98,-1688742.24,EUR,Grocery
TXN0000009160,2024-12-24T11:34:27,ACC00001190,Transfer,1883.96,-1686858.28,JPY,Starbucks
TXN0000009161,2024-08-29T09:38:11,ACC00005582,Credit,1849.1,-1685009.18,JPY,Amazon
TXN0000009162,2024-04-30T14:13:12,ACC00002943,ATM,1520.98,-1686530.16,JPY,Shell
TXN0000009163,2024-11-07T03:01:19,ACC00003451,ATM,1224.49,-1687754.65,JPY,Starbucks
TXN0000009164,2024-04-08T02:12:17,ACC00009760,Payment,1674.62,-1689429.27,EUR,Online Store
TXN0000009165,2024-11-30T13:52:45,ACC00003222,Credit,1548.55,-1687880.72,GBP,Walmart
TXN0000009166,2024-07-10T15:52:39,ACC00005066,Transfer,1455.96,-1686424.76,USD,Target
TXN0000009167,2024-01-05T07:49:14,ACC00001189,ATM,342.46,-1686767.22,JPY,Grocery
TXN0000009168,2024-05-28T07:37:39,ACC00005969,Debit,62.97,-1686830.19,EUR,Starbucks
TXN0000009169,2024-10-08T14:31:39,ACC00004631,Transfer,150.45,-1686679.74,GBP,Starbucks
TXN0000009170,2024-02-16T12:22:30,ACC00000762,Payment,1225.7,-1687905.44,EUR,Grocery
TXN0000009171,2024-12-02T21:24:56,ACC00001808,ATM,495.34,-1688400.78,USD,Amazon
TXN0000009172,2024-01-16T03:57:03,ACC00008591,Payment,490.61,-1688891.39,EUR,Walmart
TXN0000009173,2024-03-23T11:10:04,ACC00002503,Payment,1137.54,-1690028.93,JPY,Online Store
TXN0000009174,2024-10-22T20:08:12,ACC00006034,Debit,944.78,-1690973.71,USD,Restaurant
TXN0000009175,2024-02-11T09:11:31,ACC00006120,Debit,953.89,-1691927.6,EUR,Target
TXN0000009176,2024-06-01T16:38:36,ACC00009178,Transfer,243.51,-1691684.09,GBP,Starbucks
TXN0000009177,2024-02-29T08:14:43,ACC00002459,ATM,939.63,-1692623.72,EUR,Restaurant
TXN0000009178,2024-06-07T20:46:02,ACC00009546,Transfer,1284.26,-1691339.46,JPY,Shell
TXN0000009179,2024-11-09T15:16:23,ACC00006143,ATM,189.62,-1691529.08,JPY,Restaurant
TXN0000009180,2024-08-16T13:07:17,ACC00003379,Credit,801.1,-1690727.98,USD,Shell
TXN0000009181,2024-09-15T09:25:52,ACC00008461,ATM,789.73,-1691517.71,EUR,Online Store
TXN0000009182,2024-01-16T18:30:19,ACC00003151,Transfer,1274.54,-1690243.17,EUR,Walmart
TXN0000009183,2024-06-27T13:01:47,ACC00000844,Payment,849.09,-1691092.26,GBP,Shell
TXN0000009184,2024-12-30T13:00:21,ACC00006885,Debit,998.65,-1692090.91,GBP,Restaurant
TXN0000009185,2024-05-04T10:19:37,ACC00001195,Payment,1941.81,-1694032.72,EUR,Amazon
TXN0000009186,2024-08-24T03:02:39,ACC00001434,Transfer,331.2,-1693701.52,JPY,Grocery
TXN0000009187,2024-05-09T10:21:43,ACC00008340,Credit,1880.85,-1691820.67,JPY,Shell
TXN0000009188,2024-05-15T18:35:00,ACC00003291,Transfer,1460.55,-1690360.12,JPY,Amazon
TXN0000009189,2024-04-27T11:35:20,ACC00005104,ATM,1054.23,-1691414.35,JPY,Grocery
TXN0000009190,2024-03-29T02:28:43,ACC00009443,Credit,1780.01,-1689634.34,USD,Shell
TXN0000009191,2024-09-27T23:34:10,ACC00004851,Payment,372.71,-1690007.05,EUR,Shell
TXN0000009192,2024-11-11T04:08:50,ACC00005907,Payment,957.65,-1690964.7,EUR,Restaurant
TXN0000009193,2024-09-24T11:58:48,ACC00009119,Debit,1606.23,-1692570.93,USD,Target
TXN0000009194,2024-03-21T01:27:43,ACC00001538,Transfer,1087.15,-1691483.78,GBP,Online Store
TXN0000009195,2024-12-02T03:46:12,ACC00009650,Transfer,1532.36,-1689951.42,EUR,Grocery
TXN0000009196,2024-06-23T18:02:46,ACC00001879,Payment,1243.16,-1691194.58,EUR,Walmart
TXN0000009197,2024-10-17T18:37:37,ACC00006346,Debit,1033.1,-1692227.68,JPY,Amazon
TXN0000009198,2024-02-09T07:04:17,ACC00002609,Transfer,1007.36,-1691220.32,GBP,Grocery
TXN0000009199,2024-06-16T19:19:11,ACC00003555,ATM,1215.85,-1692436.17,JPY,Walmart
TXN0000009200,2024-12-24T07:21:46,ACC00002969,Credit,1579.5,-1690856.67,EUR,Amazon
TXN0000009201,2024-11-06T16:12:56,ACC00002184,Payment,1416.73,-1692273.4,JPY,Restaurant
TXN0000009202,2024-03-01T11:49:19,ACC00006852,Payment,1141.2,-1693414.6,JPY,Starbucks
TXN0000009203,2024-10-21T09:40:14,ACC00006280,Transfer,1986.75,-1691427.85,EUR,Grocery
TXN0000009204,2024-08-17T23:49:57,ACC00001780,Transfer,643.68,-1690784.17,GBP,Amazon
TXN0000009205,2024-08-05T22:09:06,ACC00005400,ATM,434.33,-1691218.5,EUR,Online Store
TXN0000009206,2024-04-13T15:41:06,ACC00002299,ATM,1718.47,-1692936.97,USD,Target
TXN0000009207,2024-11-13T19:45:41,ACC00008389,ATM,863.71,-1693800.68,USD,Grocery
TXN0000009208,2024-08-20T23:50:41,ACC00009233,Transfer,850.69,-1692949.99,JPY,Walmart
TXN0000009209,2024-09-30T04:36:51,ACC00000081,Debit,1557.71,-1694507.7,USD,Online Store
TXN0000009210,2024-03-19T16:08:04,ACC00004751,Debit,1667.85,-1696175.55,EUR,Restaurant
TXN0000009211,2024-08-02T19:01:45,ACC00004381,Transfer,752.45,-1695423.1,GBP,Target
TXN0000009212,2024-01-20T05:39:50,ACC00001542,Payment,1760.24,-1697183.34,USD,Starbucks
TXN0000009213,2024-09-20T23:13:08,ACC00005639,Payment,1535.4,-1698718.74,JPY,Grocery
TXN0000009214,2024-06-30T18:21:03,ACC00004084,Transfer,1525.49,-1697193.25,USD,Restaurant
TXN0000009215,2024-01-01T14:02:04,ACC00000665,Debit,1813.63,-1699006.88,GBP,Online Store
TXN0000009216,2024-01-04T18:13:35,ACC00003006,Payment,1473.81,-1700480.69,JPY,Target
TXN0000009217,2024-02-21T16:12:56,ACC00006419,ATM,1275.41,-1701756.1,GBP,Online Store
TXN0000009218,2024-07-10T07:13:09,ACC00009542,Payment,1422.46,-1703178.56,GBP,Target
TXN0000009219,2024-01-03T06:17:26,ACC00002721,Transfer,117.52,-1703061.04,GBP,Walmart
TXN0000009220,2024-02-15T15:49:16,ACC00004963,ATM,347.55,-1703408.59,GBP,Walmart
TXN0000009221,2024-03-13T03:16:16,ACC00005539,Credit,137.47,-1703271.12,JPY,Amazon
TXN0000009222,2024-08-06T19:23:16,ACC00000900,Transfer,245.63,-1703025.49,EUR,Restaurant
TXN0000009223,2024-04-09T20:38:38,ACC00006834,Credit,1847.62,-1701177.87,USD,Shell
TXN0000009224,2024-03-13T17:50:26,ACC00003886,Transfer,1543.72,-1699634.15,GBP,Online Store
TXN0000009225,2024-02-15T22:20:02,ACC00007315,Transfer,86.93,-1699547.22,USD,Walmart
TXN0000009226,2024-03-29T07:19:37,ACC00002058,Payment,82.4,-1699629.62,EUR,Target
TXN0000009227,2024-10-04T01:45:53,ACC00006399,Transfer,1206.86,-1698422.76,EUR,Shell
TXN0000009228,2024-03-26T08:31:02,ACC00004406,Payment,656.94,-1699079.7,EUR,Target
TXN0000009229,2024-02-10T07:38:20,ACC00007611,Payment,1432.33,-1700512.03,JPY,Online Store
TXN0000009230,2024-08-12T03:10:56,ACC00001251,Transfer,1889.36,-1698622.67,JPY,Target
TXN0000009231,2024-11-22T19:37:45,ACC00003234,Credit,525.63,-1698097.04,GBP,Grocery
TXN0000009232,2024-11-25T13:06:42,ACC00009287,Debit,713.14,-1698810.18,GBP,Restaurant
TXN0000009233,2024-02-12T18:10:58,ACC00007598,Credit,984.61,-1697825.57,GBP,Starbucks
TXN0000009234,2024-10-14T10:06:48,ACC00001150,Debit,1279.31,-1699104.88,EUR,Amazon
TXN0000009235,2024-07-03T10:02:55,ACC00000644,Payment,397.6,-1699502.48,EUR,Starbucks
TXN0000009236,2024-05-04T13:23:29,ACC00009094,Transfer,90.66,-1699411.82,EUR,Target
TXN0000009237,2024-08-18T08:11:07,ACC00005413,Payment,1807.79,-1701219.61,EUR,Target
TXN0000009238,2024-09-26T02:12:34,ACC00007757,ATM,1413.42,-1702633.03,USD,Amazon
TXN0000009239,2024-03-23T23:18:44,ACC00006446,Debit,1260.68,-1703893.71,GBP,Online Store
TXN0000009240,2024-08-17T12:47:32,ACC00007201,Transfer,1833.85,-1702059.86,GBP,Shell
TXN0000009241,2024-01-30T07:57:47,ACC00003505,ATM,154.92,-1702214.78,GBP,Restaurant
TXN0000009242,2024-07-25T15:51:13,ACC00004013,Debit,460.39,-1702675.17,USD,Walmart
TXN0000009243,2024-09-26T11:39:55,ACC00006631,Transfer,127.02,-1702548.15,USD,Online Store
TXN0000009244,2024-08-03T18:13:53,ACC00004891,ATM,970.59,-1703518.74,GBP,Amazon
TXN0000009245,2024-01-31T11:56:03,ACC00006251,Transfer,619.0,-1702899.74,GBP,Walmart
TXN0000009246,2024-02-10T06:27:01,ACC00008378,Transfer,1424.52,-1701475.22,JPY,Grocery
TXN0000009247,2024-08-23T07:17:42,ACC00006727,Transfer,1448.51,-1700026.71,GBP,Target
TXN0000009248,2024-06-21T16:28:55,ACC00009312,Credit,1575.94,-1698450.77,GBP,Shell
TXN0000009249,2024-06-20T23:25:43,ACC00003602,Debit,1433.13,-1699883.9,GBP,Amazon
TXN0000009250,2024-07-13T08:43:56,ACC00002179,Transfer,342.19,-1699541.71,GBP,Restaurant
TXN0000009251,2024-07-25T07:14:17,ACC00004162,Payment,585.5,-1700127.21,GBP,Shell
TXN0000009252,2024-10-16T22:30:40,ACC00008568,Credit,1670.43,-1698456.78,GBP,Starbucks
TXN0000009253,2024-04-27T07:39:35,ACC00005939,Debit,597.39,-1699054.17,GBP,Shell
TXN0000009254,2024-03-19T05:10:21,ACC00006196,ATM,1028.57,-1700082.74,JPY,Starbucks
TXN0000009255,2024-06-30T05:38:15,ACC00008929,Payment,293.54,-1700376.28,USD,Restaurant
TXN0000009256,2024-05-24T18:15:03,ACC00008659,Debit,1014.4,-1701390.68,JPY,Target
TXN0000009257,2024-02-10T00:12:58,ACC00003090,Debit,807.76,-1702198.44,GBP,Amazon
TXN0000009258,2024-04-04T20:38:35,ACC00002322,Debit,586.76,-1702785.2,USD,Walmart
TXN0000009259,2024-02-29T14:09:23,ACC00001656,Debit,179.07,-1702964.27,JPY,Shell
TXN0000009260,2024-05-22T04:56:26,ACC00002779,Payment,614.93,-1703579.2,GBP,Starbucks
TXN0000009261,2024-05-19T18:54:35,ACC00000734,Credit,955.08,-1702624.12,USD,Target
TXN0000009262,2024-11-06T23:49:23,ACC00001569,Payment,534.45,-1703158.57,GBP,Target
TXN0000009263,2024-11-04T18:08:17,ACC00007209,Debit,575.74,-1703734.31,JPY,Grocery
TXN0000009264,2024-04-22T01:11:44,ACC00004610,Credit,1281.75,-1702452.56,USD,Grocery
TXN0000009265,2024-07-16T03:42:23,ACC00002700,Transfer,512.39,-1701940.17,JPY,Target
TXN0000009266,2024-10-20T09:49:11,ACC00008386,Transfer,193.95,-1701746.22,GBP,Target
TXN0000009267,2024-08-10T04:11:06,ACC00007710,Debit,1973.99,-1703720.21,EUR,Target
TXN0000009268,2024-08-09T16:04:46,ACC00008623,ATM,456.62,-1704176.83,JPY,Starbucks
TXN0000009269,2024-01-14T08:29:56,ACC00004204,Credit,1847.15,-1702329.68,USD,Amazon
TXN0000009270,2024-07-15T17:59:55,ACC00009033,Credit,15.07,-1702314.61,GBP,Starbucks
TXN0000009271,2024-11-08T19:23:24,ACC00006174,ATM,284.95,-1702599.56,USD,Target
TXN0000009272,2024-04-29T14:41:38,ACC00001043,Debit,205.7,-1702805.26,EUR,Grocery
TXN0000009273,2024-11-03T16:27:34,ACC00009934,ATM,1348.87,-1704154.13,JPY,Amazon
TXN0000009274,2024-11-21T09:44:55,ACC00007947,ATM,1005.35,-1705159.48,JPY,Shell
TXN0000009275,2024-03-15T09:58:45,ACC00004315,Transfer,1174.9,-1703984.58,EUR,Grocery
TXN0000009276,2024-09-01T18:32:33,ACC00008112,Payment,116.07,-1704100.65,USD,Online Store
TXN0000009277,2024-08-10T14:47:42,ACC00008679,Debit,1276.61,-1705377.26,JPY,Restaurant
TXN0000009278,2024-09-17T06:28:14,ACC00007867,Payment,1816.42,-1707193.68,EUR,Grocery
TXN0000009279,2024-07-08T13:24:12,ACC00005903,Credit,696.59,-1706497.09,USD,Walmart
TXN0000009280,2024-02-24T23:33:25,ACC00003513,Transfer,604.49,-1705892.6,GBP,Shell
TXN0000009281,2024-05-25T22:10:57,ACC00003211,Transfer,175.46,-1705717.14,GBP,Online Store
TXN0000009282,2024-09-11T22:45:14,ACC00005708,Debit,572.94,-1706290.08,EUR,Grocery
TXN0000009283,2024-07-31T16:12:24,ACC00004302,Credit,76.52,-1706213.56,JPY,Online Store
TXN0000009284,2024-10-31T10:29:54,ACC00002446,Credit,1549.56,-1704664.0,EUR,Online Store
TXN0000009285,2024-10-09T21:36:06,ACC00003729,Debit,1764.03,-1706428.03,JPY,Walmart
TXN0000009286,2024-10-29T17:02:24,ACC00003097,ATM,394.07,-1706822.1,GBP,Grocery
TXN0000009287,2024-09-06T09:17:36,ACC00001823,Credit,153.94,-1706668.16,EUR,Amazon
TXN0000009288,2024-08-04T23:49:38,ACC00007156,Debit,164.7,-1706832.86,EUR,Shell
TXN0000009289,2024-07-04T05:35:55,ACC00001896,Payment,913.83,-1707746.69,JPY,Target
TXN0000009290,2024-04-11T12:04:46,ACC00004485,Transfer,1278.31,-1706468.38,JPY,Walmart
TXN0000009291,2024-07-13T15:33:23,ACC00007972,Credit,1381.49,-1705086.89,JPY,Walmart
TXN0000009292,2024-10-08T22:47:42,ACC00000717,ATM,986.61,-1706073.5,JPY,Online Store
TXN0000009293,2024-01-12T21:18:25,ACC00002279,ATM,719.06,-1706792.56,USD,Walmart
TXN0000009294,2024-10-23T21:46:16,ACC00009115,ATM,1674.56,-1708467.12,GBP,Starbucks
TXN0000009295,2024-06-14T00:15:52,ACC00002190,Transfer,399.1,-1708068.02,GBP,Target
TXN0000009296,2024-11-27T06:39:47,ACC00005569,Payment,1851.09,-1709919.11,JPY,Grocery
TXN0000009297,2024-12-26T07:56:56,ACC00005997,ATM,1392.32,-1711311.43,USD,Online Store
TXN0000009298,2024-08-08T05:12:47,ACC00009119,Payment,833.29,-1712144.72,EUR,Online Store
TXN0000009299,2024-08-17T18:31:41,ACC00008993,Debit,1913.73,-1714058.45,GBP,Target
TXN0000009300,2024-11-16T16:09:26,ACC00001547,Transfer,1604.72,-1712453.73,JPY,Shell
TXN0000009301,2024-03-31T07:43:58,ACC00005487,ATM,587.66,-1713041.39,JPY,Restaurant
TXN0000009302,2024-12-25T20:00:07,ACC00004827,ATM,1490.25,-1714531.64,USD,Target
TXN0000009303,2024-04-07T22:04:51,ACC00004727,Credit,1612.96,-1712918.68,USD,Shell
TXN0000009304,2024-04-03T05:14:26,ACC00005710,Credit,584.33,-1712334.35,GBP,Starbucks
TXN0000009305,2024-06-11T16:56:38,ACC00002827,ATM,727.32,-1713061.67,GBP,Amazon
TXN0000009306,2024-05-11T07:31:56,ACC00004775,Debit,1481.46,-1714543.13,USD,Shell
TXN0000009307,2024-02-25T20:30:34,ACC00001196,Payment,200.78,-1714743.91,USD,Walmart
TXN0000009308,2024-02-13T16:16:03,ACC00003080,Transfer,667.16,-1714076.75,USD,Amazon
TXN0000009309,2024-11-29T11:58:04,ACC00000509,Credit,1808.59,-1712268.16,JPY,Target
TXN0000009310,2024-08-12T00:26:03,ACC00001597,Payment,1422.29,-1713690.45,USD,Starbucks
TXN0000009311,2024-11-14T12:50:50,ACC00004278,Transfer,823.78,-1712866.67,USD,Restaurant
TXN0000009312,2024-11-04T02:16:47,ACC00000709,ATM,154.34,-1713021.01,EUR,Walmart
TXN0000009313,2024-06-21T06:08:55,ACC00008337,Credit,1354.19,-1711666.82,JPY,Restaurant
TXN0000009314,2024-08-14T01:22:12,ACC00003732,ATM,1041.57,-1712708.39,GBP,Starbucks
TXN0000009315,2024-05-31T08:40:49,ACC00000482,Transfer,505.93,-1712202.46,EUR,Grocery
TXN0000009316,2024-11-01T22:12:40,ACC00008595,Credit,993.83,-1711208.63,USD,Shell
TXN0000009317,2024-10-19T13:47:33,ACC00004310,Transfer,1911.73,-1709296.9,EUR,Grocery
TXN0000009318,2024-09-08T14:59:31,ACC00004587,Credit,533.63,-1708763.27,USD,Online Store
TXN0000009319,2024-05-23T09:34:21,ACC00001386,Transfer,1471.3,-1707291.97,GBP,Amazon
TXN0000009320,2024-11-18T13:44:55,ACC00005280,Payment,39.87,-1707331.84,JPY,Grocery
TXN0000009321,2024-04-26T04:01:30,ACC00006260,Payment,636.76,-1707968.6,EUR,Restaurant
TXN0000009322,2024-03-14T07:26:42,ACC00009948,Payment,1754.36,-1709722.96,JPY,Shell
TXN0000009323,2024-08-14T07:01:34,ACC00006740,ATM,208.3,-1709931.26,EUR,Walmart
TXN0000009324,2024-09-09T15:08:00,ACC00003823,Payment,298.57,-1710229.83,USD,Restaurant
TXN0000009325,2024-12-10T13:22:52,ACC00003315,Debit,1728.84,-1711958.67,EUR,Online Store
TXN0000009326,2024-06-25T01:59:00,ACC00006896,Transfer,937.01,-1711021.66,GBP,Shell
TXN0000009327,2024-07-23T07:46:59,ACC00002725,Credit,847.77,-1710173.89,EUR,Walmart
TXN0000009328,2024-03-15T09:51:52,ACC00006968,Credit,1438.15,-1708735.74,EUR,Online Store
TXN0000009329,2024-05-20T13:26:16,ACC00009319,Transfer,1308.4,-1707427.34,JPY,Restaurant
TXN0000009330,2024-06-15T15:02:16,ACC00006629,Credit,89.68,-1707337.66,USD,Shell
TXN0000009331,2024-07-08T05:48:57,ACC00005079,Transfer,1570.61,-1705767.05,USD,Starbucks
TXN0000009332,2024-12-08T19:29:44,ACC00006075,ATM,584.38,-1706351.43,GBP,Online Store
TXN0000009333,2024-05-03T02:50:09,ACC00007765,ATM,723.4,-1707074.83,USD,Restaurant
TXN0000009334,2024-09-24T01:54:43,ACC00007684,Transfer,99.17,-1706975.66,GBP,Starbucks
TXN0000009335,2024-05-19T15:14:38,ACC00006447,Payment,1844.09,-1708819.75,GBP,Walmart
TXN0000009336,2024-03-04T04:54:26,ACC00002084,Payment,465.82,-1709285.57,GBP,Starbucks
TXN0000009337,2024-05-29T22:09:25,ACC00003479,Payment,1756.45,-1711042.02,USD,Grocery
TXN0000009338,2024-02-25T00:15:08,ACC00005057,Transfer,1580.05,-1709461.97,EUR,Target
TXN0000009339,2024-04-27T17:21:00,ACC00005383,Credit,910.16,-1708551.81,EUR,Walmart
TXN0000009340,2024-12-27T10:28:39,ACC00009858,Payment,1644.46,-1710196.27,USD,Walmart
TXN0000009341,2024-12-17T18:51:07,ACC00007819,Credit,1820.99,-1708375.28,JPY,Amazon
TXN0000009342,2024-03-02T01:10:44,ACC00002828,Credit,1381.52,-1706993.76,EUR,Restaurant
TXN0000009343,2024-04-07T01:55:47,ACC00000846,Transfer,999.61,-1705994.15,USD,Starbucks
TXN0000009344,2024-06-15T23:28:59,ACC00004685,ATM,1756.6,-1707750.75,GBP,Starbucks
TXN0000009345,2024-09-08T06:10:28,ACC00006144,ATM,1720.93,-1709471.68,EUR,Target
TXN0000009346,2024-03-29T02:35:45,ACC00007637,Debit,732.22,-1710203.9,GBP,Target
TXN0000009347,2024-07-11T16:54:11,ACC00001645,Payment,878.75,-1711082.65,GBP,Starbucks
TXN0000009348,2024-04-01T12:11:10,ACC00001629,Debit,1280.01,-1712362.66,USD,Walmart
TXN0000009349,2024-07-05T15:08:40,ACC00001445,Transfer,1835.4,-1710527.26,JPY,Grocery
TXN0000009350,2024-01-18T21:30:45,ACC00006768,Debit,998.69,-1711525.95,EUR,Grocery
TXN0000009351,2024-06-14T09:50:52,ACC00001117,ATM,136.79,-1711662.74,USD,Shell
TXN0000009352,2024-05-13T04:34:55,ACC00001429,Transfer,964.09,-1710698.65,GBP,Shell
TXN0000009353,2024-12-03T07:02:37,ACC00001498,Payment,1608.7,-1712307.35,GBP,Target
TXN0000009354,2024-11-21T05:46:22,ACC00007828,Debit,1317.7,-1713625.05,GBP,Starbucks
TXN0000009355,2024-03-27T07:43:04,ACC00008726,Credit,919.93,-1712705.12,GBP,Walmart
TXN0000009356,2024-05-29T07:39:34,ACC00000206,Transfer,701.18,-1712003.94,JPY,Amazon
TXN0000009357,2024-04-05T23:28:20,ACC00006028,Credit,122.36,-1711881.58,GBP,Starbucks
TXN0000009358,2024-05-27T19:01:48,ACC00009799,Transfer,1500.79,-1710380.79,USD,Starbucks
TXN0000009359,2024-10-27T13:01:51,ACC00009330,ATM,952.03,-1711332.82,EUR,Online Store
TXN0000009360,2024-05-22T13:24:22,ACC00004846,Debit,311.33,-1711644.15,EUR,Shell
TXN0000009361,2024-03-02T07:27:25,ACC00006012,ATM,1268.65,-1712912.8,EUR,Shell
TXN0000009362,2024-10-08T22:25:15,ACC00007989,Debit,814.47,-1713727.27,EUR,Walmart
TXN0000009363,2024-02-26T10:54:04,ACC00003251,Transfer,1593.51,-1712133.76,USD,Grocery
TXN0000009364,2024-09-18T04:19:32,ACC00001157,ATM,494.75,-1712628.51,JPY,Shell
TXN0000009365,2024-02-04T23:43:47,ACC00002527,Debit,865.35,-1713493.86,JPY,Amazon
TXN0000009366,2024-05-22T08:36:38,ACC00002612,Debit,34.19,-1713528.05,USD,Restaurant
TXN0000009367,2024-08-16T19:40:10,ACC00005729,Payment,70.95,-1713599.0,EUR,Restaurant
TXN0000009368,2024-10-05T13:16:28,ACC00002329,Credit,1801.99,-1711797.01,EUR,Shell
TXN0000009369,2024-04-09T11:15:57,ACC00003936,ATM,723.17,-1712520.18,JPY,Grocery
TXN0000009370,2024-09-02T05:58:41,ACC00002593,Transfer,1608.17,-1710912.01,EUR,Starbucks
TXN0000009371,2024-06-11T02:45:30,ACC00005358,ATM,349.16,-1711261.17,JPY,Shell
TXN0000009372,2024-03-28T03:45:53,ACC00008512,Transfer,625.92,-1710635.25,JPY,Amazon
TXN0000009373,2024-11-12T10:07:56,ACC00002595,Payment,1984.11,-1712619.36,GBP,Shell
TXN0000009374,2024-08-03T12:10:20,ACC00008573,Payment,1286.23,-1713905.59,USD,Starbucks
TXN0000009375,2024-03-21T23:21:27,ACC00001849,Credit,1343.08,-1712562.51,USD,Shell
TXN0000009376,2024-11-18T00:58:03,ACC00004387,Credit,1208.78,-1711353.73,JPY,Target
TXN0000009377,2024-07-08T17:39:51,ACC00004278,Transfer,841.93,-1710511.8,GBP,Amazon
TXN0000009378,2024-10-26T13:33:24,ACC00004456,Payment,1085.44,-1711597.24,USD,Starbucks
TXN0000009379,2024-06-26T03:24:28,ACC00006959,Payment,140.62,-1711737.86,EUR,Walmart
TXN0000009380,2024-02-05T06:07:14,ACC00007367,Transfer,1684.02,-1710053.84,JPY,Target
TXN0000009381,2024-09-22T14:09:15,ACC00003066,Credit,796.44,-1709257.4,GBP,Target
TXN0000009382,2024-04-02T23:06:12,ACC00004155,Debit,1812.87,-1711070.27,JPY,Walmart
TXN0000009383,2024-12-23T18:58:28,ACC00004787,Transfer,73.02,-1710997.25,GBP,Walmart
TXN0000009384,2024-01-04T19:36:58,ACC00002009,Debit,371.9,-1711369.15,USD,Amazon
TXN0000009385,2024-01-25T08:52:43,ACC00008681,Transfer,1165.54,-1710203.61,EUR,Shell
TXN0000009386,2024-06-29T13:49:21,ACC00008519,Transfer,1298.02,-1708905.59,EUR,Amazon
TXN0000009387,2024-09-20T19:51:31,ACC00003139,Credit,1577.82,-1707327.77,GBP,Restaurant
TXN0000009388,2024-03-02T05:52:10,ACC00004915,Transfer,870.16,-1706457.61,JPY,Restaurant
TXN0000009389,2024-02-29T01:46:34,ACC00001898,Payment,372.91,-1706830.52,EUR,Online Store
TXN0000009390,2024-12-13T04:10:58,ACC00007698,Credit,1466.99,-1705363.53,JPY,Restaurant
TXN0000009391,2024-01-08T11:52:10,ACC00008528,Payment,1720.76,-1707084.29,USD,Restaurant
TXN0000009392,2024-03-16T02:21:46,ACC00000894,Debit,1214.32,-1708298.61,USD,Online Store
TXN0000009393,2024-04-12T11:48:03,ACC00008114,Credit,1070.06,-1707228.55,JPY,Amazon
TXN0000009394,2024-08-09T04:39:09,ACC00008706,Transfer,1109.48,-1706119.07,EUR,Amazon
TXN0000009395,2024-08-16T13:48:08,ACC00003149,ATM,622.43,-1706741.5,JPY,Starbucks
TXN0000009396,2024-09-10T13:37:44,ACC00001769,Credit,249.75,-1706491.75,USD,Shell
TXN0000009397,2024-09-08T08:54:20,ACC00000007,Payment,521.23,-1707012.98,GBP,Walmart
TXN0000009398,2024-01-17T04:17:45,ACC00007964,Credit,192.08,-1706820.9,EUR,Amazon
TXN0000009399,2024-08-01T21:31:23,ACC00004802,Debit,1112.01,-1707932.91,USD,Online Store
TXN0000009400,2024-01-26T23:12:22,ACC00005309,Transfer,973.96,-1706958.95,EUR,Amazon
TXN0000009401,2024-07-20T09:48:03,ACC00004670,Transfer,1207.19,-1705751.76,JPY,Restaurant
TXN0000009402,2024-10-02T04:18:47,ACC00006688,Credit,980.93,-1704770.83,EUR,Online Store
TXN0000009403,2024-06-07T10:50:45,ACC00002437,ATM,1627.19,-1706398.02,JPY,Shell
TXN0000009404,2024-09-02T15:05:57,ACC00008904,Debit,868.3,-1707266.32,EUR,Grocery
TXN0000009405,2024-06-11T00:11:37,ACC00002159,Credit,1060.8,-1706205.52,USD,Grocery
TXN0000009406,2024-06-21T11:46:42,ACC00006112,ATM,1107.55,-1707313.07,JPY,Walmart
TXN0000009407,2024-08-13T00:44:24,ACC00003839,Payment,1971.0,-1709284.07,JPY,Amazon
TXN0000009408,2024-07-27T14:02:42,ACC00009672,Credit,1665.43,-1707618.64,JPY,Walmart
TXN0000009409,2024-07-27T04:42:41,ACC00002693,Transfer,785.37,-1706833.27,USD,Amazon
TXN0000009410,2024-07-03T08:39:59,ACC00005831,ATM,901.82,-1707735.09,USD,Online Store
TXN0000009411,2024-02-15T07:55:36,ACC00005120,Payment,679.57,-1708414.66,USD,Starbucks
TXN0000009412,2024-12-15T19:26:50,ACC00009801,Transfer,1757.87,-1706656.79,JPY,Grocery
TXN0000009413,2024-10-13T12:21:06,ACC00003009,Payment,1114.84,-1707771.63,USD,Starbucks
TXN0000009414,2024-12-15T17:24:23,ACC00009798,ATM,1035.45,-1708807.08,GBP,Restaurant
TXN0000009415,2024-03-28T19:15:30,ACC00002399,Payment,407.41,-1709214.49,GBP,Grocery
TXN0000009416,2024-11-16T15:36:29,ACC00003628,Credit,719.24,-1708495.25,EUR,Target
TXN0000009417,2024-02-29T18:12:13,ACC00009589,ATM,1098.18,-1709593.43,EUR,Target
TXN0000009418,2024-04-26T14:26:40,ACC00000802,Transfer,521.3,-1709072.13,USD,Restaurant
TXN0000009419,2024-03-03T09:42:35,ACC00007220,ATM,1927.66,-1710999.79,GBP,Amazon
TXN0000009420,2024-01-12T11:47:12,ACC00003795,Debit,295.95,-1711295.74,EUR,Shell
TXN0000009421,2024-06-21T19:04:27,ACC00005390,Transfer,1366.01,-1709929.73,EUR,Starbucks
TXN0000009422,2024-08-02T03:55:20,ACC00001260,ATM,291.51,-1710221.24,GBP,Grocery
TXN0000009423,2024-06-03T21:46:24,ACC00008384,Transfer,157.51,-1710063.73,USD,Amazon
TXN0000009424,2024-06-04T07:03:41,ACC00004135,ATM,460.16,-1710523.89,USD,Grocery
TXN0000009425,2024-04-08T22:56:17,ACC00009187,Debit,1227.28,-1711751.17,JPY,Online Store
TXN0000009426,2024-07-06T16:11:25,ACC00005860,Transfer,197.69,-1711553.48,USD,Grocery
TXN0000009427,2024-10-23T19:16:21,ACC00009657,Transfer,1391.92,-1710161.56,USD,Target
TXN0000009428,2024-12-19T13:01:34,ACC00009715,Payment,1864.21,-1712025.77,GBP,Target
TXN0000009429,2024-03-04T12:55:37,ACC00004513,ATM,887.47,-1712913.24,EUR,Amazon
TXN0000009430,2024-06-15T08:13:26,ACC00004454,Debit,51.65,-1712964.89,EUR,Amazon
TXN0000009431,2024-03-05T16:43:53,ACC00005946,ATM,1747.63,-1714712.52,USD,Online Store
TXN0000009432,2024-04-02T16:30:05,ACC00000055,ATM,1678.06,-1716390.58,GBP,Grocery
TXN0000009433,2024-05-20T10:48:20,ACC00008815,ATM,434.35,-1716824.93,GBP,Shell
TXN0000009434,2024-06-05T21:20:51,ACC00001894,Credit,557.96,-1716266.97,GBP,Restaurant
TXN0000009435,2024-09-30T19:16:08,ACC00001161,Transfer,1864.69,-1714402.28,EUR,Target
TXN0000009436,2024-03-09T10:54:05,ACC00007637,Debit,1226.37,-1715628.65,GBP,Restaurant
TXN0000009437,2024-01-05T16:18:07,ACC00008654,Transfer,1022.51,-1714606.14,USD,Amazon
TXN0000009438,2024-11-28T09:12:20,ACC00009824,Payment,1160.23,-1715766.37,GBP,Starbucks
TXN0000009439,2024-10-15T20:26:57,ACC00003625,Credit,827.91,-1714938.46,EUR,Walmart
TXN0000009440,2024-12-21T18:38:21,ACC00004155,Debit,1789.11,-1716727.57,GBP,Shell
TXN0000009441,2024-01-05T04:42:01,ACC00009483,ATM,1353.48,-1718081.05,JPY,Amazon
TXN0000009442,2024-11-21T05:37:44,ACC00007939,Payment,974.4,-1719055.45,USD,Online Store
TXN0000009443,2024-01-14T17:35:16,ACC00006775,Payment,825.44,-1719880.89,GBP,Shell
TXN0000009444,2024-03-04T11:12:09,ACC00000743,Transfer,1827.0,-1718053.89,USD,Shell
TXN0000009445,2024-03-03T18:41:00,ACC00001950,ATM,1086.2,-1719140.09,JPY,Grocery
TXN0000009446,2024-03-28T09:56:16,ACC00007454,ATM,1758.9,-1720898.99,GBP,Amazon
TXN0000009447,2024-03-14T16:49:26,ACC00004538,Credit,1904.7,-1718994.29,USD,Grocery
TXN0000009448,2024-06-08T14:42:55,ACC00006523,Debit,172.8,-1719167.09,EUR,Online Store
TXN0000009449,2024-05-17T20:38:08,ACC00002022,ATM,559.87,-1719726.96,USD,Online Store
TXN0000009450,2024-01-21T14:31:47,ACC00001940,Transfer,1685.99,-1718040.97,JPY,Amazon
TXN0000009451,2024-04-27T12:22:47,ACC00005058,Debit,1374.79,-1719415.76,GBP,Shell
TXN0000009452,2024-02-26T03:10:17,ACC00009553,Debit,1830.25,-1721246.01,USD,Amazon
TXN0000009453,2024-06-28T12:57:22,ACC00003516,Payment,1127.32,-1722373.33,EUR,Shell
TXN0000009454,2024-01-13T08:30:53,ACC00004203,Debit,1215.46,-1723588.79,EUR,Amazon
TXN0000009455,2024-04-15T04:07:55,ACC00001372,Debit,142.68,-1723731.47,USD,Target
TXN0000009456,2024-12-19T07:27:53,ACC00009712,ATM,1242.65,-1724974.12,JPY,Restaurant
TXN0000009457,2024-04-02T08:06:59,ACC00001016,Transfer,1507.73,-1723466.39,GBP,Grocery
TXN0000009458,2024-08-10T19:23:27,ACC00001560,Payment,275.41,-1723741.8,JPY,Restaurant
TXN0000009459,2024-06-27T09:14:13,ACC00001707,ATM,1769.24,-1725511.04,EUR,Restaurant
TXN0000009460,2024-05-03T06:03:05,ACC00002704,Credit,1485.97,-1724025.07,JPY,Restaurant
TXN0000009461,2024-04-05T10:05:28,ACC00003597,ATM,293.18,-1724318.25,GBP,Amazon
TXN0000009462,2024-02-25T19:53:28,ACC00005144,Credit,1649.73,-1722668.52,GBP,Online Store
TXN0000009463,2024-12-23T04:01:58,ACC00007365,Debit,476.12,-1723144.64,GBP,Grocery
TXN0000009464,2024-04-05T18:04:04,ACC00006491,ATM,756.61,-1723901.25,GBP,Grocery
TXN0000009465,2024-11-30T10:35:28,ACC00005110,Credit,1949.88,-1721951.37,EUR,Shell
TXN0000009466,2024-09-10T17:15:44,ACC00005601,Payment,1973.66,-1723925.03,JPY,Restaurant
TXN0000009467,2024-09-18T17:06:53,ACC00000112,Payment,1368.84,-1725293.87,GBP,Target
TXN0000009468,2024-03-16T21:21:50,ACC00005951,Credit,1581.32,-1723712.55,EUR,Amazon
TXN0000009469,2024-11-29T16:58:56,ACC00004930,Debit,1258.04,-1724970.59,EUR,Grocery
TXN0000009470,2024-03-01T19:36:19,ACC00008143,Payment,1511.93,-1726482.52,USD,Walmart
TXN0000009471,2024-10-15T20:49:00,ACC00002160,Credit,989.05,-1725493.47,JPY,Amazon
TXN0000009472,2024-11-26T06:44:21,ACC00004292,Transfer,695.66,-1724797.81,JPY,Online Store
TXN0000009473,2024-06-16T01:07:13,ACC00000674,Credit,1329.97,-1723467.84,EUR,Shell
TXN0000009474,2024-04-02T19:25:32,ACC00006818,Debit,391.6,-1723859.44,USD,Online Store
TXN0000009475,2024-03-03T22:49:11,ACC00001042,Debit,1364.23,-1725223.67,JPY,Grocery
TXN0000009476,2024-12-30T21:12:47,ACC00005535,ATM,685.21,-1725908.88,USD,Starbucks
TXN0000009477,2024-11-28T02:04:06,ACC00001971,Debit,1088.23,-1726997.11,JPY,Amazon
TXN0000009478,2024-12-16T10:59:46,ACC00005179,Credit,1208.72,-1725788.39,EUR,Online Store
TXN0000009479,2024-07-20T21:52:02,ACC00003848,Transfer,30.09,-1725758.3,JPY,Target
TXN0000009480,2024-05-19T05:32:11,ACC00002828,ATM,164.39,-1725922.69,EUR,Walmart
TXN0000009481,2024-12-25T02:50:42,ACC00009643,Transfer,832.33,-1725090.36,JPY,Shell
TXN0000009482,2024-01-01T16:54:36,ACC00009275,Transfer,300.71,-1724789.65,USD,Starbucks
TXN0000009483,2024-01-19T19:20:41,ACC00002429,Debit,834.78,-1725624.43,GBP,Shell
TXN0000009484,2024-06-13T18:12:39,ACC00003793,Payment,1289.76,-1726914.19,EUR,Target
TXN0000009485,2024-08-10T08:37:25,ACC00007192,Transfer,1579.45,-1725334.74,EUR,Starbucks
TXN0000009486,2024-09-03T00:52:12,ACC00006908,Payment,636.63,-1725971.37,EUR,Target
TXN0000009487,2024-03-27T19:26:46,ACC00007505,Payment,1569.96,-1727541.33,USD,Restaurant
TXN0000009488,2024-11-15T13:22:55,ACC00003498,Transfer,1013.02,-1726528.31,EUR,Starbucks
TXN0000009489,2024-08-19T21:37:00,ACC00004229,Transfer,1083.79,-1725444.52,EUR,Online Store
TXN0000009490,2024-01-12T15:56:06,ACC00008470,ATM,1065.4,-1726509.92,JPY,Grocery
TXN0000009491,2024-12-01T19:35:00,ACC00002224,Credit,148.56,-1726361.36,EUR,Grocery
TXN0000009492,2024-08-25T08:04:27,ACC00006227,Debit,1655.45,-1728016.81,EUR,Walmart
TXN0000009493,2024-05-28T22:42:16,ACC00004217,Transfer,257.19,-1727759.62,JPY,Target
TXN0000009494,2024-09-08T02:43:29,ACC00001764,Transfer,45.1,-1727714.52,EUR,Starbucks
TXN0000009495,2024-05-27T00:34:51,ACC00003507,Transfer,1919.39,-1725795.13,GBP,Target
TXN0000009496,2024-09-10T06:01:47,ACC00005738,Debit,416.07,-1726211.2,EUR,Restaurant
TXN0000009497,2024-03-24T17:31:00,ACC00007720,Payment,480.48,-1726691.68,JPY,Grocery
TXN0000009498,2024-02-24T10:05:46,ACC00000257,Payment,1088.5,-1727780.18,GBP,Restaurant
TXN0000009499,2024-09-24T06:54:27,ACC00000653,Debit,829.07,-1728609.25,JPY,Target
TXN0000009500,2024-06-06T23:23:05,ACC00000156,Credit,1990.26,-1726618.99,EUR,Starbucks
TXN0000009501,2024-05-27T15:37:31,ACC00007692,Payment,697.38,-1727316.37,EUR,Amazon
TXN0000009502,2024-08-06T20:38:12,ACC00005676,Transfer,255.87,-1727060.5,JPY,Grocery
TXN0000009503,2024-08-05T07:19:49,ACC00008802,ATM,1300.01,-1728360.51,EUR,Grocery
TXN0000009504,2024-12-07T21:43:10,ACC00002329,Payment,253.75,-1728614.26,JPY,Walmart
TXN0000009505,2024-04-23T03:49:29,ACC00001855,Credit,558.62,-1728055.64,USD,Shell
TXN0000009506,2024-01-24T00:57:51,ACC00008747,Payment,1561.76,-1729617.4,USD,Amazon
TXN0000009507,2024-06-22T08:46:55,ACC00000256,Transfer,300.8,-1729316.6,EUR,Walmart
TXN0000009508,2024-01-11T11:38:00,ACC00003789,Transfer,1665.45,-1727651.15,GBP,Restaurant
TXN0000009509,2024-10-28T11:26:33,ACC00007189,ATM,158.19,-1727809.34,GBP,Starbucks
TXN0000009510,2024-04-13T12:33:46,ACC00006662,Credit,73.85,-1727735.49,GBP,Online Store
TXN0000009511,2024-10-02T10:02:05,ACC00008037,Debit,1042.93,-1728778.42,GBP,Grocery
TXN0000009512,2024-10-14T02:46:47,ACC00007995,Payment,170.78,-1728949.2,USD,Target
TXN0000009513,2024-05-07T06:19:14,ACC00001321,ATM,333.85,-1729283.05,USD,Starbucks
TXN0000009514,2024-11-05T19:32:50,ACC00009557,ATM,1654.95,-1730938.0,EUR,Target
TXN0000009515,2024-01-18T10:33:55,ACC00005451,ATM,514.65,-1731452.65,GBP,Walmart
TXN0000009516,2024-12-23T13:37:27,ACC00006182,Payment,1921.73,-1733374.38,USD,Shell
TXN0000009517,2024-05-03T10:45:19,ACC00001797,Credit,273.8,-1733100.58,EUR,Grocery
TXN0000009518,2024-07-28T15:42:28,ACC00007555,Transfer,1530.29,-1731570.29,USD,Online Store
TXN0000009519,2024-05-03T15:41:56,ACC00006642,ATM,424.8,-1731995.09,USD,Starbucks
TXN0000009520,2024-07-14T10:42:22,ACC00000775,ATM,1274.1,-1733269.19,EUR,Walmart
TXN0000009521,2024-12-07T13:49:05,ACC00001925,Payment,1018.57,-1734287.76,GBP,Restaurant
TXN0000009522,2024-01-23T09:59:39,ACC00008704,Debit,1584.03,-1735871.79,JPY,Target
TXN0000009523,2024-07-21T07:30:36,ACC00001625,Credit,1396.22,-1734475.57,JPY,Grocery
TXN0000009524,2024-08-29T08:43:15,ACC00002542,ATM,1413.58,-1735889.15,USD,Walmart
TXN0000009525,2024-11-24T00:00:31,ACC00003865,Payment,679.29,-1736568.44,USD,Starbucks
TXN0000009526,2024-02-11T11:04:20,ACC00004970,Credit,1599.1,-1734969.34,JPY,Online Store
TXN0000009527,2024-03-24T22:06:53,ACC00009725,Credit,213.69,-1734755.65,GBP,Amazon
TXN0000009528,2024-09-27T20:30:16,ACC00001923,ATM,404.31,-1735159.96,EUR,Restaurant
TXN0000009529,2024-11-20T11:12:16,ACC00000275,ATM,1589.09,-1736749.05,GBP,Online Store
TXN0000009530,2024-04-03T14:47:57,ACC00005923,ATM,536.12,-1737285.17,USD,Restaurant
TXN0000009531,2024-10-31T11:40:32,ACC00007834,Payment,350.27,-1737635.44,EUR,Amazon
TXN0000009532,2024-06-14T06:15:21,ACC00004735,Credit,73.27,-1737562.17,USD,Starbucks
TXN0000009533,2024-12-24T20:33:16,ACC00007519,Transfer,1113.66,-1736448.51,EUR,Restaurant
TXN0000009534,2024-07-24T16:20:32,ACC00004748,Credit,1482.75,-1734965.76,JPY,Shell
TXN0000009535,2024-11-28T16:03:02,ACC00007268,ATM,865.4,-1735831.16,USD,Starbucks
TXN0000009536,2024-02-18T20:24:00,ACC00005237,Debit,1342.07,-1737173.23,EUR,Amazon
TXN0000009537,2024-03-17T23:25:17,ACC00002742,Debit,1823.74,-1738996.97,GBP,Starbucks
TXN0000009538,2024-03-15T18:42:35,ACC00000610,Transfer,1334.16,-1737662.81,GBP,Target
TXN0000009539,2024-05-06T21:09:30,ACC00002618,ATM,508.63,-1738171.44,GBP,Grocery
TXN0000009540,2024-07-18T21:26:38,ACC00000970,Transfer,432.02,-1737739.42,EUR,Online Store
TXN0000009541,2024-12-05T06:10:17,ACC00003396,ATM,1150.6,-1738890.02,JPY,Walmart
TXN0000009542,2024-03-11T16:51:26,ACC00002514,Credit,68.85,-1738821.17,USD,Restaurant
TXN0000009543,2024-11-09T23:09:33,ACC00008306,ATM,996.94,-1739818.11,GBP,Amazon
TXN0000009544,2024-06-16T11:55:07,ACC00004679,Credit,1208.5,-1738609.61,EUR,Restaurant
TXN0000009545,2024-03-20T21:30:47,ACC00006549,Credit,808.73,-1737800.88,USD,Online Store
TXN0000009546,2024-02-23T11:12:35,ACC00001503,Credit,240.15,-1737560.73,EUR,Online Store
TXN0000009547,2024-11-27T23:34:37,ACC00005638,Credit,1919.06,-1735641.67,USD,Restaurant
TXN0000009548,2024-02-18T21:27:49,ACC00006664,ATM,1250.07,-1736891.74,EUR,Restaurant
TXN0000009549,2024-03-29T07:20:24,ACC00005461,Transfer,1787.87,-1735103.87,GBP,Online Store
TXN0000009550,2024-05-17T23:53:35,ACC00005723,Payment,531.91,-1735635.78,USD,Target
TXN0000009551,2024-06-24T00:00:13,ACC00003751,Payment,1457.45,-1737093.23,JPY,Target
TXN0000009552,2024-10-27T11:14:41,ACC00002732,Credit,1530.92,-1735562.31,JPY,Walmart
TXN0000009553,2024-09-11T04:05:43,ACC00000968,Credit,1828.24,-1733734.07,USD,Target
TXN0000009554,2024-08-28T22:57:09,ACC00009634,Transfer,934.22,-1732799.85,GBP,Restaurant
TXN0000009555,2024-11-25T05:19:52,ACC00001860,Payment,105.28,-1732905.13,EUR,Target
TXN0000009556,2024-02-02T18:32:32,ACC00005937,ATM,1856.26,-1734761.39,JPY,Walmart
TXN0000009557,2024-11-22T03:27:24,ACC00006105,Debit,1983.25,-1736744.64,USD,Target
TXN0000009558,2024-04-12T12:22:44,ACC00000177,ATM,1756.85,-1738501.49,JPY,Shell
TXN0000009559,2024-04-10T17:04:43,ACC00007698,Transfer,1585.92,-1736915.57,EUR,Restaurant
TXN0000009560,2024-10-08T03:18:09,ACC00008536,Debit,1364.21,-1738279.78,JPY,Online Store
TXN0000009561,2024-06-12T17:00:30,ACC00008553,Payment,1654.48,-1739934.26,EUR,Online Store
TXN0000009562,2024-02-09T18:41:11,ACC00009729,ATM,1943.93,-1741878.19,GBP,Starbucks
TXN0000009563,2024-04-11T02:28:37,ACC00003942,Debit,755.69,-1742633.88,JPY,Starbucks
TXN0000009564,2024-09-02T16:39:29,ACC00005671,Credit,413.39,-1742220.49,GBP,Shell
TXN0000009565,2024-01-27T07:43:02,ACC00003709,ATM,193.78,-1742414.27,JPY,Amazon
TXN0000009566,2024-04-25T07:54:10,ACC00000979,ATM,617.56,-1743031.83,JPY,Grocery
TXN0000009567,2024-06-12T15:42:46,ACC00006514,ATM,310.03,-1743341.86,JPY,Walmart
TXN0000009568,2024-01-21T02:17:47,ACC00007205,Transfer,1745.45,-1741596.41,JPY,Shell
TXN0000009569,2024-08-14T21:30:45,ACC00000709,Debit,747.99,-1742344.4,GBP,Grocery
TXN0000009570,2024-11-07T11:18:04,ACC00004497,Transfer,1960.42,-1740383.98,JPY,Shell
TXN0000009571,2024-08-21T03:40:15,ACC00000416,Payment,1594.58,-1741978.56,EUR,Walmart
TXN0000009572,2024-10-11T13:16:40,ACC00009058,ATM,1056.05,-1743034.61,EUR,Shell
TXN0000009573,2024-03-28T05:49:59,ACC00006511,Transfer,1327.13,-1741707.48,EUR,Shell
TXN0000009574,2024-03-21T23:20:25,ACC00001659,Debit,1889.41,-1743596.89,JPY,Online Store
TXN0000009575,2024-05-10T16:49:13,ACC00000558,Transfer,710.03,-1742886.86,USD,Amazon
TXN0000009576,2024-04-25T08:43:39,ACC00001794,Credit,609.2,-1742277.66,GBP,Amazon
TXN0000009577,2024-12-13T22:30:29,ACC00009736,ATM,718.88,-1742996.54,JPY,Amazon
TXN0000009578,2024-07-28T05:05:37,ACC00005973,Payment,1556.59,-1744553.13,JPY,Walmart
TXN0000009579,2024-02-29T20:27:14,ACC00009163,Debit,1143.35,-1745696.48,USD,Online Store
TXN0000009580,2024-03-17T06:29:50,ACC00004903,Payment,361.32,-1746057.8,USD,Amazon
TXN0000009581,2024-07-31T22:03:00,ACC00007876,Payment,1266.88,-1747324.68,USD,Starbucks
TXN0000009582,2024-09-11T21:08:11,ACC00004774,Debit,1754.67,-1749079.35,JPY,Walmart
TXN0000009583,2024-04-15T09:44:49,ACC00005083,Transfer,411.98,-1748667.37,GBP,Walmart
TXN0000009584,2024-04-25T11:36:59,ACC00002783,Payment,591.3,-1749258.67,JPY,Starbucks
TXN0000009585,2024-02-28T19:26:32,ACC00006304,Transfer,50.0,-1749208.67,EUR,Grocery
TXN0000009586,2024-11-14T13:37:27,ACC00001008,Debit,1205.77,-1750414.44,GBP,Starbucks
TXN0000009587,2024-02-17T01:18:25,ACC00004373,ATM,1034.63,-1751449.07,USD,Grocery
TXN0000009588,2024-04-25T01:43:28,ACC00007348,ATM,1092.66,-1752541.73,EUR,Starbucks
TXN0000009589,2024-10-02T06:13:05,ACC00006763,Credit,1617.19,-1750924.54,JPY,Starbucks
TXN0000009590,2024-05-09T13:36:29,ACC00004363,Debit,707.17,-1751631.71,USD,Target
TXN0000009591,2024-07-24T03:58:43,ACC00001532,ATM,541.79,-1752173.5,JPY,Shell
TXN0000009592,2024-08-03T23:50:36,ACC00006182,Debit,535.99,-1752709.49,EUR,Amazon
TXN0000009593,2024-07-31T20:44:56,ACC00004573,Transfer,1873.69,-1750835.8,EUR,Walmart
TXN0000009594,2024-10-16T04:41:21,ACC00006453,Transfer,133.62,-1750702.18,GBP,Grocery
TXN0000009595,2024-02-22T09:56:00,ACC00000736,Credit,1696.55,-1749005.63,EUR,Amazon
TXN0000009596,2024-08-10T18:36:41,ACC00006875,Payment,1808.16,-1750813.79,USD,Shell
TXN0000009597,2024-06-25T16:37:30,ACC00007010,ATM,359.93,-1751173.72,JPY,Shell
TXN0000009598,2024-03-29T09:47:59,ACC00007686,Debit,1398.33,-1752572.05,GBP,Target
TXN0000009599,2024-07-13T11:30:38,ACC00002989,Transfer,468.53,-1752103.52,EUR,Starbucks
TXN0000009600,2024-04-09T23:29:51,ACC00003826,Payment,510.95,-1752614.47,GBP,Amazon
TXN0000009601,2024-05-12T08:29:55,ACC00008338,Debit,1227.11,-1753841.58,GBP,Starbucks
TXN0000009602,2024-07-16T03:16:32,ACC00009108,Debit,1920.48,-1755762.06,GBP,Online Store
TXN0000009603,2024-10-16T12:46:13,ACC00002550,Transfer,1629.82,-1754132.24,USD,Restaurant
TXN0000009604,2024-01-14T20:48:15,ACC00001584,Debit,1384.34,-1755516.58,USD,Amazon
TXN0000009605,2024-02-17T23:58:50,ACC00003460,Debit,1361.45,-1756878.03,EUR,Online Store
TXN0000009606,2024-11-20T10:12:31,ACC00008724,Transfer,1460.73,-1755417.3,JPY,Walmart
TXN0000009607,2024-09-17T01:29:24,ACC00003366,ATM,688.57,-1756105.87,USD,Grocery
TXN0000009608,2024-07-06T12:11:32,ACC00002994,Debit,1774.26,-1757880.13,JPY,Walmart
TXN0000009609,2024-08-09T14:00:02,ACC00009739,ATM,431.68,-1758311.81,USD,Grocery
TXN0000009610,2024-11-05T12:58:39,ACC00006030,Debit,1269.4,-1759581.21,JPY,Grocery
TXN0000009611,2024-06-27T21:11:53,ACC00006737,Debit,1286.68,-1760867.89,EUR,Online Store
TXN0000009612,2024-04-15T11:35:33,ACC00002888,Transfer,285.83,-1760582.06,GBP,Shell
TXN0000009613,2024-07-17T14:00:33,ACC00005380,Debit,1339.11,-1761921.17,USD,Walmart
TXN0000009614,2024-04-15T18:35:49,ACC00004459,Payment,1624.2,-1763545.37,USD,Restaurant
TXN0000009615,2024-07-21T18:10:32,ACC00004671,Transfer,1069.28,-1762476.09,USD,Grocery
TXN0000009616,2024-01-09T09:46:45,ACC00008439,Credit,102.06,-1762374.03,EUR,Starbucks
TXN0000009617,2024-12-02T15:35:35,ACC00004925,Debit,1483.11,-1763857.14,GBP,Starbucks
TXN0000009618,2024-11-13T13:39:36,ACC00005492,Payment,1142.72,-1764999.86,USD,Restaurant
TXN0000009619,2024-03-20T15:04:26,ACC00002705,Credit,1819.64,-1763180.22,GBP,Restaurant
TXN0000009620,2024-09-11T19:33:37,ACC00000313,Transfer,915.33,-1762264.89,JPY,Walmart
TXN0000009621,2024-06-06T09:17:25,ACC00008669,Credit,673.75,-1761591.14,JPY,Shell
TXN0000009622,2024-08-02T04:08:45,ACC00009383,Debit,1707.26,-1763298.4,GBP,Walmart
TXN0000009623,2024-10-03T12:13:54,ACC00007408,Payment,1500.5,-1764798.9,USD,Walmart
TXN0000009624,2024-09-21T14:15:46,ACC00008673,Transfer,590.81,-1764208.09,GBP,Target
TXN0000009625,2024-11-23T14:34:21,ACC00008627,Credit,1117.6,-1763090.49,EUR,Restaurant
TXN0000009626,2024-03-20T22:30:55,ACC00000782,ATM,525.24,-1763615.73,USD,Walmart
TXN0000009627,2024-01-30T05:59:10,ACC00002312,Debit,1874.71,-1765490.44,GBP,Starbucks
TXN0000009628,2024-01-29T12:15:13,ACC00003744,Payment,1077.77,-1766568.21,EUR,Starbucks
TXN0000009629,2024-06-01T23:51:55,ACC00004048,Payment,587.39,-1767155.6,JPY,Target
TXN0000009630,2024-05-05T06:49:50,ACC00002962,Credit,567.81,-1766587.79,EUR,Starbucks
TXN0000009631,2024-11-10T05:42:16,ACC00003104,Transfer,1216.21,-1765371.58,USD,Shell
TXN0000009632,2024-12-12T14:10:49,ACC00006372,Payment,1982.74,-1767354.32,EUR,Walmart
TXN0000009633,2024-09-17T22:06:52,ACC00007259,Transfer,488.07,-1766866.25,USD,Grocery
TXN0000009634,2024-03-01T15:12:06,ACC00004674,Payment,1553.63,-1768419.88,GBP,Starbucks
TXN0000009635,2024-04-30T00:55:35,ACC00002727,Transfer,223.95,-1768195.93,EUR,Target
TXN0000009636,2024-11-25T19:12:00,ACC00007792,Credit,1044.62,-1767151.31,EUR,Starbucks
TXN0000009637,2024-08-12T04:30:03,ACC00007262,ATM,1847.53,-1768998.84,JPY,Starbucks
TXN0000009638,2024-05-10T19:56:40,ACC00009818,Transfer,366.16,-1768632.68,USD,Restaurant
TXN0000009639,2024-12-28T11:19:32,ACC00009179,Transfer,785.66,-1767847.02,USD,Grocery
TXN0000009640,2024-09-07T18:22:37,ACC00007153,Debit,1038.07,-1768885.09,GBP,Online Store
TXN0000009641,2024-08-21T15:27:04,ACC00002775,Credit,876.84,-1768008.25,JPY,Grocery
TXN0000009642,2024-05-14T09:07:19,ACC00003875,Payment,66.19,-1768074.44,EUR,Walmart
TXN0000009643,2024-08-17T10:33:14,ACC00005809,Payment,1406.11,-1769480.55,JPY,Restaurant
TXN0000009644,2024-07-12T19:16:07,ACC00001854,Transfer,1834.54,-1767646.01,USD,Amazon
TXN0000009645,2024-12-20T03:55:22,ACC00008123,Payment,1980.44,-1769626.45,GBP,Walmart
TXN0000009646,2024-03-06T23:42:50,ACC00007201,Debit,1402.98,-1771029.43,JPY,Target
TXN0000009647,2024-04-23T10:43:10,ACC00001155,ATM,1006.13,-1772035.56,EUR,Target
TXN0000009648,2024-04-04T21:50:50,ACC00006359,ATM,262.42,-1772297.98,EUR,Starbucks
TXN0000009649,2024-11-14T03:24:04,ACC00005758,Transfer,1108.69,-1771189.29,JPY,Walmart
TXN0000009650,2024-04-20T16:43:10,ACC00005607,ATM,1806.16,-1772995.45,EUR,Grocery
TXN0000009651,2024-06-14T01:58:33,ACC00002204,Transfer,980.19,-1772015.26,EUR,Target
TXN0000009652,2024-06-29T05:06:09,ACC00004162,Transfer,700.01,-1771315.25,JPY,Online Store
TXN0000009653,2024-06-04T06:35:04,ACC00008450,Payment,1856.94,-1773172.19,USD,Shell
TXN0000009654,2024-06-18T13:22:43,ACC00002782,Payment,1520.43,-1774692.62,USD,Walmart
TXN0000009655,2024-06-30T20:47:19,ACC00005390,ATM,1733.83,-1776426.45,GBP,Grocery
TXN0000009656,2024-01-18T11:39:08,ACC00004695,Payment,352.86,-1776779.31,JPY,Amazon
TXN0000009657,2024-06-17T17:34:31,ACC00005198,Transfer,897.07,-1775882.24,GBP,Shell
TXN0000009658,2024-01-28T13:31:17,ACC00000392,Debit,1396.62,-1777278.86,USD,Target
TXN0000009659,2024-11-22T08:34:10,ACC00000387,Transfer,1507.21,-1775771.65,JPY,Grocery
TXN0000009660,2024-04-01T02:19:23,ACC00008393,Credit,919.4,-1774852.25,EUR,Restaurant
TXN0000009661,2024-02-02T20:07:24,ACC00007560,Transfer,1355.47,-1773496.78,GBP,Grocery
TXN0000009662,2024-11-01T00:39:56,ACC00008931,Transfer,1595.68,-1771901.1,EUR,Restaurant
TXN0000009663,2024-01-31T08:39:50,ACC00007090,Credit,1504.09,-1770397.01,JPY,Restaurant
TXN0000009664,2024-09-18T21:31:11,ACC00008222,Payment,488.04,-1770885.05,USD,Grocery
TXN0000009665,2024-04-17T09:57:27,ACC00005583,ATM,123.5,-1771008.55,EUR,Walmart
TXN0000009666,2024-04-04T11:45:06,ACC00008176,Credit,1876.61,-1769131.94,USD,Grocery
TXN0000009667,2024-11-26T02:54:23,ACC00002505,Transfer,1153.72,-1767978.22,EUR,Online Store
TXN0000009668,2024-05-02T07:48:55,ACC00004472,Debit,1619.85,-1769598.07,GBP,Shell
TXN0000009669,2024-06-10T11:07:39,ACC00000119,Transfer,1494.14,-1768103.93,EUR,Target
TXN0000009670,2024-05-02T19:56:45,ACC00008191,Transfer,1997.57,-1766106.36,GBP,Amazon
TXN0000009671,2024-05-26T10:56:36,ACC00004329,Payment,1346.32,-1767452.68,JPY,Online Store
TXN0000009672,2024-05-06T19:39:27,ACC00005626,Debit,638.22,-1768090.9,JPY,Amazon
TXN0000009673,2024-05-08T19:51:05,ACC00002905,Transfer,933.13,-1767157.77,USD,Online Store
TXN0000009674,2024-02-06T01:47:02,ACC00003694,Credit,1153.36,-1766004.41,JPY,Amazon
TXN0000009675,2024-01-09T14:45:01,ACC00005276,Debit,734.78,-1766739.19,JPY,Target
TXN0000009676,2024-05-11T19:01:58,ACC00002265,Payment,1233.86,-1767973.05,GBP,Online Store
TXN0000009677,2024-07-07T18:11:39,ACC00009737,Payment,1157.03,-1769130.08,GBP,Shell
TXN0000009678,2024-06-23T04:35:07,ACC00000077,Transfer,1105.61,-1768024.47,USD,Amazon
TXN0000009679,2024-10-30T23:01:23,ACC00001251,Debit,1617.88,-1769642.35,GBP,Walmart
TXN0000009680,2024-04-09T08:13:43,ACC00007110,ATM,233.99,-1769876.34,GBP,Online Store
TXN0000009681,2024-04-29T12:18:25,ACC00008852,Payment,1439.85,-1771316.19,JPY,Restaurant
TXN0000009682,2024-10-19T22:55:39,ACC00002051,Payment,490.58,-1771806.77,JPY,Restaurant
TXN0000009683,2024-02-01T03:40:49,ACC00000479,Transfer,1770.83,-1770035.94,JPY,Amazon
TXN0000009684,2024-09-26T04:53:10,ACC00003100,Credit,1221.19,-1768814.75,USD,Grocery
TXN0000009685,2024-04-22T07:04:07,ACC00007833,Credit,1135.55,-1767679.2,JPY,Shell
TXN0000009686,2024-07-31T10:27:44,ACC00009255,Debit,1442.04,-1769121.24,GBP,Restaurant
TXN0000009687,2024-01-08T03:28:27,ACC00009662,Credit,1776.28,-1767344.96,GBP,Walmart
TXN0000009688,2024-10-27T03:12:33,ACC00001109,Transfer,1253.39,-1766091.57,USD,Starbucks
TXN0000009689,2024-09-01T19:09:32,ACC00000410,Debit,550.16,-1766641.73,JPY,Target
TXN0000009690,2024-05-08T23:40:02,ACC00009798,Credit,1728.84,-1764912.89,EUR,Restaurant
TXN0000009691,2024-06-01T14:32:14,ACC00000303,Transfer,207.58,-1764705.31,JPY,Amazon
TXN0000009692,2024-03-25T17:45:23,ACC00002873,Debit,199.62,-1764904.93,JPY,Restaurant
TXN0000009693,2024-09-15T06:45:24,ACC00000674,Transfer,1230.05,-1763674.88,EUR,Starbucks
TXN0000009694,2024-02-09T15:40:31,ACC00000058,Transfer,1704.95,-1761969.93,EUR,Target
TXN0000009695,2024-11-22T09:15:08,ACC00002572,Transfer,1943.03,-1760026.9,USD,Restaurant
TXN0000009696,2024-02-04T14:19:58,ACC00001869,Debit,550.25,-1760577.15,USD,Walmart
TXN0000009697,2024-01-27T23:41:40,ACC00000031,Debit,453.54,-1761030.69,JPY,Amazon
TXN0000009698,2024-09-20T08:41:34,ACC00004543,Payment,1090.42,-1762121.11,JPY,Walmart
TXN0000009699,2024-01-29T05:06:47,ACC00006480,Payment,1226.95,-1763348.06,EUR,Restaurant
TXN0000009700,2024-08-03T03:06:12,ACC00001861,Payment,162.27,-1763510.33,EUR,Starbucks
TXN0000009701,2024-03-22T20:23:23,ACC00008264,Transfer,900.59,-1762609.74,JPY,Shell
TXN0000009702,2024-08-04T21:11:28,ACC00006644,Credit,1838.65,-1760771.09,JPY,Amazon
TXN0000009703,2024-03-10T23:05:09,ACC00001225,ATM,1514.84,-1762285.93,USD,Online Store
TXN0000009704,2024-10-04T20:28:32,ACC00000821,Credit,1170.39,-1761115.54,USD,Grocery
TXN0000009705,2024-12-14T21:14:55,ACC00002054,Payment,1998.19,-1763113.73,USD,Shell
TXN0000009706,2024-05-10T06:17:48,ACC00002978,Payment,217.31,-1763331.04,EUR,Starbucks
TXN0000009707,2024-07-16T16:33:09,ACC00001793,Transfer,99.57,-1763231.47,EUR,Target
TXN0000009708,2024-12-03T14:21:15,ACC00009861,Credit,1420.52,-1761810.95,EUR,Starbucks
TXN0000009709,2024-01-12T02:41:05,ACC00000846,ATM,1246.58,-1763057.53,JPY,Shell
TXN0000009710,2024-08-05T20:11:10,ACC00003740,Payment,892.79,-1763950.32,USD,Grocery
TXN0000009711,2024-05-04T09:45:07,ACC00000230,ATM,1626.83,-1765577.15,EUR,Amazon
TXN0000009712,2024-10-08T15:44:03,ACC00004393,Payment,1440.91,-1767018.06,GBP,Starbucks
TXN0000009713,2024-10-23T12:47:38,ACC00003582,Payment,478.59,-1767496.65,GBP,Shell
TXN0000009714,2024-12-05T15:50:14,ACC00001295,Debit,1464.72,-1768961.37,JPY,Amazon
TXN0000009715,2024-12-19T20:08:27,ACC00009221,Credit,626.73,-1768334.64,JPY,Shell
TXN0000009716,2024-08-06T09:14:21,ACC00002165,Transfer,1207.48,-1767127.16,GBP,Walmart
TXN0000009717,2024-01-20T09:44:49,ACC00002212,Payment,679.33,-1767806.49,JPY,Restaurant
TXN0000009718,2024-11-16T04:14:26,ACC00004260,Payment,1290.48,-1769096.97,JPY,Walmart
TXN0000009719,2024-06-14T14:40:33,ACC00001048,Payment,701.92,-1769798.89,GBP,Target
TXN0000009720,2024-04-19T03:53:53,ACC00005930,Credit,1051.19,-1768747.7,USD,Online Store
TXN0000009721,2024-01-31T03:59:38,ACC00005999,Credit,103.43,-1768644.27,USD,Walmart
TXN0000009722,2024-01-22T14:10:57,ACC00007622,Credit,835.18,-1767809.09,GBP,Amazon
TXN0000009723,2024-02-17T17:27:53,ACC00007257,Transfer,1198.56,-1766610.53,USD,Target
TXN0000009724,2024-10-06T16:11:12,ACC00003589,Debit,1311.84,-1767922.37,GBP,Restaurant
TXN0000009725,2024-04-13T16:14:19,ACC00001285,Debit,168.96,-1768091.33,USD,Grocery
TXN0000009726,2024-10-27T05:31:52,ACC00001617,Payment,1643.44,-1769734.77,EUR,Restaurant
TXN0000009727,2024-11-01T16:54:28,ACC00001592,Payment,665.62,-1770400.39,GBP,Starbucks
TXN0000009728,2024-04-29T12:02:18,ACC00003629,Transfer,1594.82,-1768805.57,USD,Grocery
TXN0000009729,2024-10-13T09:13:48,ACC00006378,ATM,752.47,-1769558.04,EUR,Starbucks
TXN0000009730,2024-06-23T02:31:51,ACC00004262,Transfer,81.39,-1769476.65,EUR,Restaurant
TXN0000009731,2024-02-25T15:18:24,ACC00005503,Credit,820.9,-1768655.75,EUR,Restaurant
TXN0000009732,2024-08-07T07:32:39,ACC00002085,ATM,1261.1,-1769916.85,EUR,Starbucks
TXN0000009733,2024-01-03T12:59:02,ACC00002966,Payment,574.16,-1770491.01,EUR,Target
TXN0000009734,2024-04-04T10:43:20,ACC00008643,Payment,652.69,-1771143.7,GBP,Target
TXN0000009735,2024-04-22T18:48:09,ACC00009438,Payment,1723.77,-1772867.47,GBP,Restaurant
TXN0000009736,2024-07-23T14:09:59,ACC00002145,Payment,1201.37,-1774068.84,JPY,Restaurant
TXN0000009737,2024-12-12T17:19:51,ACC00003624,Payment,406.67,-1774475.51,USD,Grocery
TXN0000009738,2024-09-12T18:50:27,ACC00003747,Transfer,80.0,-1774395.51,GBP,Grocery
TXN0000009739,2024-09-26T12:12:21,ACC00008898,Credit,817.6,-1773577.91,GBP,Online Store
TXN0000009740,2024-05-30T17:32:31,ACC00001775,Debit,823.18,-1774401.09,EUR,Online Store
TXN0000009741,2024-01-14T04:46:12,ACC00008038,Debit,1621.16,-1776022.25,USD,Online Store
TXN0000009742,2024-08-19T05:47:43,ACC00004883,Credit,172.01,-1775850.24,USD,Starbucks
TXN0000009743,2024-01-22T19:53:38,ACC00004779,Payment,1817.86,-1777668.1,JPY,Restaurant
TXN0000009744,2024-08-05T00:45:55,ACC00006125,Payment,295.52,-1777963.62,GBP,Online Store
TXN0000009745,2024-01-02T02:10:18,ACC00005390,Transfer,641.14,-1777322.48,EUR,Walmart
TXN0000009746,2024-05-25T14:18:20,ACC00009295,Credit,281.02,-1777041.46,GBP,Shell
TXN0000009747,2024-07-24T21:20:28,ACC00007339,Payment,428.53,-1777469.99,GBP,Online Store
TXN0000009748,2024-11-12T21:24:27,ACC00000395,ATM,461.34,-1777931.33,GBP,Amazon
TXN0000009749,2024-11-02T19:45:10,ACC00004123,ATM,331.04,-1778262.37,JPY,Online Store
TXN0000009750,2024-04-13T16:58:21,ACC00000310,Payment,1232.95,-1779495.32,USD,Restaurant
TXN0000009751,2024-01-20T00:40:04,ACC00004672,Debit,1615.42,-1781110.74,USD,Online Store
TXN0000009752,2024-08-27T14:09:06,ACC00004425,Transfer,476.78,-1780633.96,EUR,Restaurant
TXN0000009753,2024-03-28T06:43:22,ACC00000500,Credit,1992.7,-1778641.26,EUR,Online Store
TXN0000009754,2024-11-03T13:15:57,ACC00009267,Debit,339.04,-1778980.3,GBP,Shell
TXN0000009755,2024-12-28T02:58:49,ACC00001796,ATM,1771.55,-1780751.85,JPY,Online Store
TXN0000009756,2024-07-22T02:55:28,ACC00001163,Debit,384.98,-1781136.83,GBP,Shell
TXN0000009757,2024-08-09T08:58:44,ACC00005080,Debit,1487.54,-1782624.37,USD,Restaurant
TXN0000009758,2024-07-17T08:56:36,ACC00004625,Debit,924.4,-1783548.77,EUR,Shell
TXN0000009759,2024-10-27T16:39:03,ACC00002080,Credit,989.74,-1782559.03,EUR,Walmart
TXN0000009760,2024-01-13T20:42:31,ACC00001500,Debit,509.38,-1783068.41,EUR,Restaurant
TXN0000009761,2024-07-14T01:22:59,ACC00007415,Credit,563.82,-1782504.59,GBP,Online Store
TXN0000009762,2024-03-22T15:40:26,ACC00001642,Debit,512.66,-1783017.25,GBP,Starbucks
TXN0000009763,2024-02-19T00:34:55,ACC00002291,Transfer,17.18,-1783000.07,USD,Restaurant
TXN0000009764,2024-01-19T19:01:43,ACC00003035,Debit,1483.72,-1784483.79,EUR,Online Store
TXN0000009765,2024-01-11T15:06:42,ACC00004200,Payment,1038.37,-1785522.16,USD,Online Store
TXN0000009766,2024-09-01T17:02:12,ACC00007999,Credit,1399.52,-1784122.64,GBP,Walmart
TXN0000009767,2024-03-19T21:33:48,ACC00006332,Credit,402.69,-1783719.95,EUR,Starbucks
TXN0000009768,2024-11-03T01:23:42,ACC00007150,Payment,1526.42,-1785246.37,EUR,Target
TXN0000009769,2024-07-09T06:13:25,ACC00001091,ATM,1449.9,-1786696.27,USD,Starbucks
TXN0000009770,2024-02-05T06:26:35,ACC00001219,Transfer,1946.94,-1784749.33,USD,Walmart
TXN0000009771,2024-02-05T02:40:52,ACC00001677,Transfer,1324.81,-1783424.52,JPY,Walmart
TXN0000009772,2024-08-20T23:26:11,ACC00006477,Debit,759.68,-1784184.2,USD,Walmart
TXN0000009773,2024-02-10T17:25:28,ACC00004643,Payment,331.28,-1784515.48,EUR,Target
TXN0000009774,2024-07-30T13:32:27,ACC00007491,Credit,424.82,-1784090.66,USD,Amazon
TXN0000009775,2024-06-03T00:43:28,ACC00003428,Payment,1756.9,-1785847.56,EUR,Target
TXN0000009776,2024-04-12T13:34:35,ACC00004502,ATM,1181.72,-1787029.28,GBP,Target
TXN0000009777,2024-10-06T03:28:22,ACC00005546,Debit,1751.44,-1788780.72,GBP,Target
TXN0000009778,2024-03-30T17:13:12,ACC00000298,Payment,1957.15,-1790737.87,USD,Grocery
TXN0000009779,2024-12-24T06:19:25,ACC00004931,Credit,1802.89,-1788934.98,EUR,Target
TXN0000009780,2024-07-24T12:16:38,ACC00008932,Debit,437.37,-1789372.35,EUR,Amazon
TXN0000009781,2024-12-24T02:53:02,ACC00006067,Debit,1452.24,-1790824.59,EUR,Grocery
TXN0000009782,2024-11-14T12:37:47,ACC00004828,Debit,379.28,-1791203.87,GBP,Online Store
TXN0000009783,2024-12-17T07:41:32,ACC00003796,Debit,1174.05,-1792377.92,JPY,Starbucks
TXN0000009784,2024-06-24T20:22:48,ACC00001725,ATM,227.55,-1792605.47,JPY,Shell
TXN0000009785,2024-02-29T17:04:35,ACC00009430,Payment,1361.57,-1793967.04,JPY,Grocery
TXN0000009786,2024-02-22T23:33:39,ACC00008943,Debit,673.2,-1794640.24,USD,Walmart
TXN0000009787,2024-11-06T02:39:54,ACC00008110,Credit,346.51,-1794293.73,JPY,Shell
TXN0000009788,2024-06-02T10:16:58,ACC00009963,Transfer,1328.87,-1792964.86,EUR,Amazon
TXN0000009789,2024-02-04T01:18:52,ACC00001159,Transfer,633.25,-1792331.61,EUR,Starbucks
TXN0000009790,2024-02-15T05:10:37,ACC00005729,Payment,338.7,-1792670.31,GBP,Grocery
TXN0000009791,2024-10-19T11:27:58,ACC00000116,Credit,1157.64,-1791512.67,GBP,Amazon
TXN0000009792,2024-03-26T21:24:19,ACC00007835,Transfer,1396.66,-1790116.01,GBP,Shell
TXN0000009793,2024-01-15T21:13:09,ACC00003558,Debit,1275.88,-1791391.89,JPY,Walmart
TXN0000009794,2024-10-25T18:01:35,ACC00007880,ATM,1919.02,-1793310.91,EUR,Shell
TXN0000009795,2024-04-14T05:06:36,ACC00002927,Debit,207.69,-1793518.6,JPY,Restaurant
TXN0000009796,2024-08-08T04:44:26,ACC00005808,Payment,954.15,-1794472.75,USD,Shell
TXN0000009797,2024-10-13T06:14:34,ACC00006630,Credit,1705.15,-1792767.6,JPY,Online Store
TXN0000009798,2024-08-17T10:41:02,ACC00000673,Debit,1054.52,-1793822.12,GBP,Amazon
TXN0000009799,2024-03-27T06:09:41,ACC00006407,Transfer,1234.11,-1792588.01,JPY,Walmart
TXN0000009800,2024-07-19T02:25:01,ACC00006429,Payment,100.24,-1792688.25,JPY,Starbucks
TXN0000009801,2024-08-29T11:10:54,ACC00006083,Debit,616.33,-1793304.58,JPY,Restaurant
TXN0000009802,2024-07-14T07:43:15,ACC00004160,Payment,1067.32,-1794371.9,JPY,Target
TXN0000009803,2024-10-22T09:06:11,ACC00000079,Transfer,1599.89,-1792772.01,USD,Grocery
TXN0000009804,2024-09-25T09:44:28,ACC00001709,Debit,1902.46,-1794674.47,JPY,Target
TXN0000009805,2024-08-09T22:53:50,ACC00006175,Credit,1874.21,-1792800.26,GBP,Target
TXN0000009806,2024-09-05T05:44:31,ACC00001892,ATM,198.2,-1792998.46,JPY,Target
TXN0000009807,2024-06-08T14:14:01,ACC00006974,Transfer,1071.49,-1791926.97,JPY,Shell
TXN0000009808,2024-11-23T04:06:00,ACC00004811,ATM,432.32,-1792359.29,GBP,Restaurant
TXN0000009809,2024-04-12T15:14:09,ACC00003222,Debit,614.46,-1792973.75,USD,Shell
TXN0000009810,2024-04-22T04:32:36,ACC00002003,Transfer,1253.38,-1791720.37,EUR,Online Store
TXN0000009811,2024-03-29T22:59:21,ACC00001867,Debit,678.98,-1792399.35,USD,Amazon
TXN0000009812,2024-12-09T03:29:14,ACC00006687,Transfer,816.74,-1791582.61,JPY,Grocery
TXN0000009813,2024-12-19T18:12:03,ACC00002488,Debit,577.93,-1792160.54,GBP,Restaurant
TXN0000009814,2024-02-02T21:17:57,ACC00003709,Credit,1514.99,-1790645.55,GBP,Amazon
TXN0000009815,2024-08-26T23:17:57,ACC00008340,ATM,183.29,-1790828.84,GBP,Shell
TXN0000009816,2024-07-28T05:10:22,ACC00000810,ATM,1745.06,-1792573.9,USD,Amazon
TXN0000009817,2024-06-29T14:57:22,ACC00006141,Debit,228.33,-1792802.23,EUR,Online Store
TXN0000009818,2024-02-20T05:49:36,ACC00005610,Debit,1245.9,-1794048.13,EUR,Starbucks
TXN0000009819,2024-06-05T05:53:38,ACC00008568,Transfer,1311.65,-1792736.48,EUR,Target
TXN0000009820,2024-02-01T09:58:42,ACC00006422,Payment,1555.47,-1794291.95,JPY,Target
TXN0000009821,2024-08-10T14:07:38,ACC00009599,Payment,1504.83,-1795796.78,USD,Online Store
TXN0000009822,2024-03-09T16:42:45,ACC00008477,Debit,1346.24,-1797143.02,GBP,Starbucks
TXN0000009823,2024-08-07T01:00:19,ACC00003230,Transfer,524.33,-1796618.69,JPY,Online Store
TXN0000009824,2024-02-22T17:03:49,ACC00007692,Transfer,1194.84,-1795423.85,JPY,Amazon
TXN0000009825,2024-01-21T19:03:57,ACC00003934,Credit,828.27,-1794595.58,GBP,Shell
TXN0000009826,2024-10-10T09:08:56,ACC00006490,Payment,1863.13,-1796458.71,JPY,Online Store
TXN0000009827,2024-07-12T12:28:14,ACC00009076,ATM,1046.81,-1797505.52,GBP,Starbucks
TXN0000009828,2024-07-09T04:23:21,ACC00000169,Credit,143.35,-1797362.17,JPY,Amazon
TXN0000009829,2024-06-12T01:20:12,ACC00009162,Payment,1394.64,-1798756.81,JPY,Restaurant
TXN0000009830,2024-07-01T04:09:06,ACC00007677,Transfer,991.71,-1797765.1,GBP,Online Store
TXN0000009831,2024-03-02T15:37:48,ACC00001675,Debit,1631.44,-1799396.54,JPY,Starbucks
TXN0000009832,2024-09-28T01:22:48,ACC00003573,Credit,1101.87,-1798294.67,EUR,Restaurant
TXN0000009833,2024-03-08T00:00:29,ACC00001288,Transfer,1065.18,-1797229.49,JPY,Online Store
TXN0000009834,2024-02-07T23:47:56,ACC00005162,Payment,858.92,-1798088.41,JPY,Target
TXN0000009835,2024-08-10T20:22:05,ACC00008216,Payment,1511.03,-1799599.44,USD,Target
TXN0000009836,2024-08-28T14:33:38,ACC00008582,Transfer,1552.44,-1798047.0,JPY,Walmart
TXN0000009837,2024-03-19T04:37:53,ACC00006431,Credit,1226.02,-1796820.98,JPY,Restaurant
TXN0000009838,2024-03-17T08:04:15,ACC00009445,Payment,160.54,-1796981.52,EUR,Walmart
TXN0000009839,2024-08-27T09:33:13,ACC00005256,Debit,319.49,-1797301.01,USD,Online Store
TXN0000009840,2024-06-05T07:01:48,ACC00006115,Payment,1496.67,-1798797.68,JPY,Walmart
TXN0000009841,2024-06-21T06:01:07,ACC00007823,ATM,1186.42,-1799984.1,GBP,Walmart
TXN0000009842,2024-07-24T07:24:28,ACC00004898,ATM,1646.42,-1801630.52,GBP,Starbucks
TXN0000009843,2024-09-08T03:59:40,ACC00008158,ATM,305.63,-1801936.15,USD,Restaurant
TXN0000009844,2024-09-30T09:15:38,ACC00008775,Credit,204.89,-1801731.26,USD,Amazon
TXN0000009845,2024-03-11T21:53:15,ACC00006353,Transfer,1285.9,-1800445.36,JPY,Online Store
TXN0000009846,2024-08-05T15:51:04,ACC00000275,Transfer,1806.83,-1798638.53,EUR,Grocery
TXN0000009847,2024-06-10T22:06:26,ACC00003221,ATM,1620.2,-1800258.73,USD,Starbucks
TXN0000009848,2024-09-02T11:13:20,ACC00001846,Credit,1730.34,-1798528.39,EUR,Online Store
TXN0000009849,2024-03-20T02:39:47,ACC00003324,ATM,1170.73,-1799699.12,GBP,Walmart
TXN0000009850,2024-02-12T10:15:28,ACC00006204,Payment,1153.66,-1800852.78,GBP,Amazon
TXN0000009851,2024-04-20T07:43:45,ACC00009306,Debit,882.36,-1801735.14,USD,Restaurant
TXN0000009852,2024-01-07T06:27:02,ACC00008638,Transfer,1823.5,-1799911.64,JPY,Grocery
TXN0000009853,2024-10-20T08:16:01,ACC00004281,Debit,1357.98,-1801269.62,GBP,Target
TXN0000009854,2024-10-31T04:50:55,ACC00002443,Debit,643.97,-1801913.59,GBP,Grocery
TXN0000009855,2024-10-23T07:46:22,ACC00009375,Transfer,1599.02,-1800314.57,EUR,Starbucks
TXN0000009856,2024-06-16T10:49:54,ACC00001485,ATM,139.91,-1800454.48,EUR,Grocery
TXN0000009857,2024-02-20T12:45:46,ACC00002899,Payment,1780.31,-1802234.79,USD,Restaurant
TXN0000009858,2024-04-07T09:31:31,ACC00000472,Debit,1156.17,-1803390.96,GBP,Grocery
TXN0000009859,2024-01-26T19:43:27,ACC00000034,Payment,1704.15,-1805095.11,GBP,Amazon
TXN0000009860,2024-12-02T08:37:48,ACC00003083,Credit,488.59,-1804606.52,EUR,Grocery
TXN0000009861,2024-06-10T19:04:10,ACC00003106,ATM,1181.47,-1805787.99,EUR,Starbucks
TXN0000009862,2024-01-16T21:14:04,ACC00006793,Payment,1062.67,-1806850.66,EUR,Grocery
TXN0000009863,2024-12-02T00:46:18,ACC00001171,Payment,1396.11,-1808246.77,EUR,Shell
TXN0000009864,2024-10-22T09:18:21,ACC00001623,Payment,1414.98,-1809661.75,JPY,Starbucks
TXN0000009865,2024-12-11T10:25:44,ACC00006166,Transfer,506.5,-1809155.25,GBP,Shell
TXN0000009866,2024-01-01T08:42:19,ACC00002995,ATM,719.63,-1809874.88,GBP,Restaurant
TXN0000009867,2024-03-26T00:31:38,ACC00000798,Credit,413.89,-1809460.99,JPY,Online Store
TXN0000009868,2024-08-13T13:55:02,ACC00009818,Transfer,701.93,-1808759.06,GBP,Online Store
TXN0000009869,2024-06-14T23:51:08,ACC00005087,ATM,952.52,-1809711.58,JPY,Amazon
TXN0000009870,2024-01-02T16:38:44,ACC00003281,ATM,884.57,-1810596.15,EUR,Online Store
TXN0000009871,2024-12-28T15:22:39,ACC00004630,ATM,745.98,-1811342.13,JPY,Shell
TXN0000009872,2024-12-09T02:59:53,ACC00009451,Payment,1432.93,-1812775.06,EUR,Restaurant
TXN0000009873,2024-12-30T05:56:41,ACC00001540,Transfer,1267.15,-1811507.91,JPY,Shell
TXN0000009874,2024-10-31T14:27:49,ACC00002660,Payment,1212.59,-1812720.5,USD,Target
TXN0000009875,2024-08-02T02:35:10,ACC00008117,Debit,1744.83,-1814465.33,GBP,Starbucks
TXN0000009876,2024-09-04T05:42:41,ACC00009002,Debit,527.48,-1814992.81,USD,Grocery
TXN0000009877,2024-05-09T12:54:35,ACC00007943,ATM,1892.06,-1816884.87,USD,Target
TXN0000009878,2024-03-22T08:13:02,ACC00000887,ATM,958.87,-1817843.74,JPY,Shell
TXN0000009879,2024-06-03T13:25:39,ACC00001481,Transfer,1704.35,-1816139.39,EUR,Starbucks
TXN0000009880,2024-11-06T06:50:55,ACC00001651,ATM,1343.47,-1817482.86,USD,Starbucks
TXN0000009881,2024-08-15T00:51:52,ACC00004078,Payment,1317.41,-1818800.27,GBP,Amazon
TXN0000009882,2024-06-01T18:01:28,ACC00004253,Transfer,870.4,-1817929.87,GBP,Starbucks
TXN0000009883,2024-11-26T11:07:32,ACC00003032,Credit,490.0,-1817439.87,USD,Amazon
TXN0000009884,2024-09-20T06:01:02,ACC00008599,Payment,940.01,-1818379.88,USD,Target
TXN0000009885,2024-02-05T12:57:14,ACC00001491,Credit,1006.44,-1817373.44,GBP,Shell
TXN0000009886,2024-01-16T15:37:45,ACC00008821,ATM,360.24,-1817733.68,EUR,Starbucks
TXN0000009887,2024-02-29T03:47:03,ACC00007543,Debit,1590.87,-1819324.55,EUR,Restaurant
TXN0000009888,2024-07-21T22:17:38,ACC00005482,ATM,1401.85,-1820726.4,USD,Walmart
TXN0000009889,2024-11-14T05:32:23,ACC00006384,Debit,1384.99,-1822111.39,EUR,Target
TXN0000009890,2024-01-14T00:09:53,ACC00007240,Transfer,83.9,-1822027.49,JPY,Walmart
TXN0000009891,2024-06-19T08:18:36,ACC00001967,Credit,447.81,-1821579.68,JPY,Grocery
TXN0000009892,2024-02-21T13:34:46,ACC00000043,Debit,561.54,-1822141.22,JPY,Grocery
TXN0000009893,2024-06-02T23:13:28,ACC00003393,ATM,1798.32,-1823939.54,USD,Starbucks
TXN0000009894,2024-04-19T11:27:27,ACC00007448,Payment,303.54,-1824243.08,JPY,Walmart
TXN0000009895,2024-08-07T01:11:13,ACC00002153,ATM,878.52,-1825121.6,EUR,Online Store
TXN0000009896,2024-03-10T14:59:28,ACC00007291,Payment,1628.33,-1826749.93,USD,Walmart
TXN0000009897,2024-04-04T13:21:44,ACC00000553,Debit,1812.88,-1828562.81,JPY,Grocery
TXN0000009898,2024-05-27T08:22:39,ACC00009052,Payment,27.4,-1828590.21,JPY,Online Store
TXN0000009899,2024-01-01T01:36:12,ACC00007707,Transfer,737.46,-1827852.75,GBP,Amazon
TXN0000009900,2024-10-26T08:44:23,ACC00007849,ATM,1724.84,-1829577.59,EUR,Target
TXN0000009901,2024-06-24T06:03:50,ACC00001260,Credit,389.89,-1829187.7,JPY,Grocery
TXN0000009902,2024-10-07T22:29:23,ACC00003531,Transfer,1357.91,-1827829.79,USD,Shell
TXN0000009903,2024-09-04T09:52:54,ACC00002691,Transfer,950.69,-1826879.1,USD,Starbucks
TXN0000009904,2024-06-08T06:26:26,ACC00007485,Credit,604.47,-1826274.63,GBP,Target
TXN0000009905,2024-06-24T05:36:46,ACC00006345,Credit,1556.27,-1824718.36,GBP,Shell
TXN0000009906,2024-12-21T04:51:34,ACC00003198,Transfer,1018.48,-1823699.88,GBP,Shell
TXN0000009907,2024-02-14T04:37:07,ACC00004037,Debit,1138.95,-1824838.83,GBP,Online Store
TXN0000009908,2024-09-18T07:24:22,ACC00004544,Transfer,1760.54,-1823078.29,JPY,Restaurant
TXN0000009909,2024-06-06T09:59:12,ACC00004644,ATM,1036.32,-1824114.61,USD,Online Store
TXN0000009910,2024-03-09T17:09:59,ACC00000041,Credit,725.58,-1823389.03,USD,Target
TXN0000009911,2024-06-08T05:12:01,ACC00005121,Transfer,1440.38,-1821948.65,USD,Amazon
TXN0000009912,2024-11-08T03:28:20,ACC00003756,Debit,1835.54,-1823784.19,JPY,Online Store
TXN0000009913,2024-01-22T19:09:03,ACC00000798,Transfer,1837.14,-1821947.05,USD,Walmart
TXN0000009914,2024-01-06T17:32:48,ACC00002140,Debit,1763.83,-1823710.88,JPY,Target
TXN0000009915,2024-05-03T04:12:44,ACC00001158,Debit,357.94,-1824068.82,EUR,Amazon
TXN0000009916,2024-12-21T08:06:07,ACC00007968,Transfer,107.96,-1823960.86,USD,Restaurant
TXN0000009917,2024-11-14T10:05:24,ACC00008729,Transfer,1961.69,-1821999.17,GBP,Amazon
TXN0000009918,2024-03-04T21:57:59,ACC00000571,Transfer,506.42,-1821492.75,GBP,Starbucks
TXN0000009919,2024-12-19T05:41:47,ACC00001485,Payment,793.07,-1822285.82,GBP,Shell
TXN0000009920,2024-09-24T05:39:51,ACC00009084,Payment,87.75,-1822373.57,EUR,Online Store
TXN0000009921,2024-04-27T21:48:51,ACC00002953,ATM,578.71,-1822952.28,JPY,Shell
TXN0000009922,2024-05-16T02:55:59,ACC00002507,Credit,195.09,-1822757.19,JPY,Walmart
TXN0000009923,2024-10-19T06:58:55,ACC00005299,Debit,913.95,-1823671.14,GBP,Shell
TXN0000009924,2024-01-04T19:18:05,ACC00008798,Transfer,1427.1,-1822244.04,JPY,Target
TXN0000009925,2024-07-11T23:39:22,ACC00002592,Transfer,708.93,-1821535.11,JPY,Target
TXN0000009926,2024-10-13T01:42:07,ACC00003178,Credit,587.82,-1820947.29,JPY,Online Store
TXN0000009927,2024-11-22T06:57:09,ACC00006011,ATM,1618.12,-1822565.41,EUR,Shell
TXN0000009928,2024-03-11T17:54:42,ACC00005906,Payment,1863.0,-1824428.41,USD,Restaurant
TXN0000009929,2024-08-30T10:46:41,ACC00007722,Transfer,875.27,-1823553.14,USD,Starbucks
TXN0000009930,2024-06-28T16:02:23,ACC00001093,Payment,1177.45,-1824730.59,EUR,Shell
TXN0000009931,2024-01-26T02:49:13,ACC00004594,ATM,1271.07,-1826001.66,USD,Online Store
TXN0000009932,2024-01-03T21:54:14,ACC00009166,Credit,1523.13,-1824478.53,USD,Walmart
TXN0000009933,2024-09-16T19:50:01,ACC00007509,Credit,1677.02,-1822801.51,GBP,Grocery
TXN0000009934,2024-03-14T18:25:22,ACC00000150,Transfer,11.47,-1822790.04,USD,Shell
TXN0000009935,2024-07-16T01:10:43,ACC00009199,Debit,1167.59,-1823957.63,USD,Walmart
TXN0000009936,2024-08-04T00:37:48,ACC00005416,ATM,1763.47,-1825721.1,USD,Online Store
TXN0000009937,2024-04-10T15:55:51,ACC00006547,Transfer,1777.07,-1823944.03,USD,Target
TXN0000009938,2024-02-08T11:34:44,ACC00004411,Credit,1172.7,-1822771.33,EUR,Online Store
TXN0000009939,2024-01-31T13:35:10,ACC00006465,Payment,1579.03,-1824350.36,EUR,Shell
TXN0000009940,2024-07-12T21:53:04,ACC00006053,ATM,1844.71,-1826195.07,EUR,Walmart
TXN0000009941,2024-04-22T15:59:52,ACC00004644,ATM,927.12,-1827122.19,GBP,Walmart
TXN0000009942,2024-11-29T15:09:30,ACC00003970,Transfer,173.61,-1826948.58,USD,Amazon
TXN0000009943,2024-06-02T08:23:04,ACC00006580,Credit,1085.24,-1825863.34,EUR,Starbucks
TXN0000009944,2024-12-27T07:10:43,ACC00009314,Credit,1247.31,-1824616.03,JPY,Target
TXN0000009945,2024-07-19T03:10:59,ACC00002481,ATM,657.13,-1825273.16,USD,Restaurant
TXN0000009946,2024-02-16T12:55:40,ACC00007460,ATM,1674.59,-1826947.75,GBP,Restaurant
TXN0000009947,2024-10-21T11:18:02,ACC00001660,Transfer,222.22,-1826725.53,JPY,Walmart
TXN0000009948,2024-11-30T03:56:33,ACC00007293,Credit,178.17,-1826547.36,GBP,Walmart
TXN0000009949,2024-03-07T02:17:01,ACC00007932,Credit,1228.71,-1825318.65,USD,Target
TXN0000009950,2024-02-07T15:00:02,ACC00004826,Debit,531.31,-1825849.96,GBP,Walmart
TXN0000009951,2024-06-16T05:49:20,ACC00004572,ATM,1728.53,-1827578.49,EUR,Restaurant
TXN0000009952,2024-06-30T10:33:51,ACC00003596,Transfer,1810.12,-1825768.37,JPY,Grocery
TXN0000009953,2024-01-08T11:57:04,ACC00004781,ATM,1739.92,-1827508.29,EUR,Amazon
TXN0000009954,2024-07-08T08:20:18,ACC00002584,Credit,1814.85,-1825693.44,JPY,Restaurant
TXN0000009955,2024-06-01T02:33:28,ACC00006408,Transfer,590.13,-1825103.31,USD,Online Store
TXN0000009956,2024-09-19T19:02:13,ACC00003339,Credit,536.06,-1824567.25,USD,Shell
TXN0000009957,2024-01-15T06:19:09,ACC00002901,Credit,431.13,-1824136.12,EUR,Online Store
TXN0000009958,2024-06-10T21:55:28,ACC00003343,Debit,1052.8,-1825188.92,GBP,Shell
TXN0000009959,2024-02-04T07:41:25,ACC00005904,Transfer,1613.53,-1823575.39,GBP,Walmart
TXN0000009960,2024-08-10T05:40:25,ACC00002605,ATM,1991.89,-1825567.28,GBP,Grocery
TXN0000009961,2024-12-01T22:15:03,ACC00001054,ATM,1026.97,-1826594.25,GBP,Shell
TXN0000009962,2024-05-21T13:36:33,ACC00009817,Credit,33.96,-1826560.29,JPY,Starbucks
TXN0000009963,2024-06-28T18:06:46,ACC00006604,ATM,28.76,-1826589.05,EUR,Walmart
TXN0000009964,2024-03-19T10:55:38,ACC00002444,Payment,736.78,-1827325.83,USD,Amazon
TXN0000009965,2024-02-10T10:34:32,ACC00003552,ATM,388.41,-1827714.24,EUR,Shell
TXN0000009966,2024-09-06T07:48:17,ACC00005182,Debit,1496.9,-1829211.14,USD,Grocery
TXN0000009967,2024-02-01T08:48:52,ACC00008555,Credit,163.2,-1829047.94,GBP,Online Store
TXN0000009968,2024-10-09T05:45:09,ACC00001822,ATM,848.26,-1829896.2,GBP,Starbucks
TXN0000009969,2024-03-30T18:22:58,ACC00001950,ATM,1593.55,-1831489.75,USD,Target
TXN0000009970,2024-05-02T22:12:21,ACC00002280,Transfer,1675.11,-1829814.64,USD,Amazon
TXN0000009971,2024-09-17T13:29:34,ACC00008409,Debit,945.22,-1830759.86,EUR,Walmart
TXN0000009972,2024-04-12T21:49:35,ACC00000930,Debit,1152.16,-1831912.02,JPY,Online Store
TXN0000009973,2024-01-27T22:38:58,ACC00001372,ATM,58.79,-1831970.81,EUR,Shell
TXN0000009974,2024-10-25T11:31:47,ACC00009046,ATM,24.86,-1831995.67,USD,Restaurant
TXN0000009975,2024-10-08T00:29:29,ACC00008124,Credit,211.98,-1831783.69,USD,Grocery
TXN0000009976,2024-09-12T23:39:50,ACC00004004,Transfer,1282.75,-1830500.94,USD,Starbucks
TXN0000009977,2024-01-07T15:28:14,ACC00007819,Debit,920.93,-1831421.87,EUR,Grocery
TXN0000009978,2024-05-25T22:50:16,ACC00003568,Debit,943.82,-1832365.69,USD,Starbucks
TXN0000009979,2024-12-27T17:56:34,ACC00001837,Credit,20.71,-1832344.98,EUR,Online Store
TXN0000009980,2024-09-21T09:34:07,ACC00000433,Transfer,1701.55,-1830643.43,GBP,Target
TXN0000009981,2024-12-10T12:06:45,ACC00002064,ATM,1959.04,-1832602.47,GBP,Target
TXN0000009982,2024-07-29T23:00:17,ACC00006132,Credit,1807.44,-1830795.03,USD,Target
TXN0000009983,2024-04-06T10:42:43,ACC00002532,Payment,1848.28,-1832643.31,JPY,Shell
TXN0000009984,2024-04-28T21:02:03,ACC00009079,Payment,862.4,-1833505.71,USD,Online Store
TXN0000009985,2024-06-27T11:34:19,ACC00005543,Credit,1485.87,-1832019.84,USD,Target
TXN0000009986,2024-09-14T20:06:12,ACC00007945,Payment,632.83,-1832652.67,JPY,Online Store
TXN0000009987,2024-05-05T16:51:21,ACC00002446,Transfer,1696.82,-1830955.85,GBP,Restaurant
TXN0000009988,2024-02-10T05:13:50,ACC00005501,ATM,205.61,-1831161.46,EUR,Grocery
TXN0000009989,2024-11-13T21:25:19,ACC00000525,Payment,38.99,-1831200.45,EUR,Walmart
TXN0000009990,2024-01-31T16:19:07,ACC00000389,Transfer,1200.92,-1829999.53,EUR,Shell
TXN0000009991,2024-02-25T20:55:31,ACC00005072,Debit,475.14,-1830474.67,GBP,Restaurant
TXN0000009992,2024-08-24T10:32:26,ACC00000562,Debit,1835.5,-1832310.17,EUR,Target
TXN0000009993,2024-11-03T12:16:29,ACC00009547,Credit,1507.18,-1830802.99,GBP,Starbucks
TXN0000009994,2024-09-15T18:37:47,ACC00003313,Payment,1209.33,-1832012.32,GBP,Restaurant
TXN0000009995,2024-10-08T10:10:43,ACC00001191,Credit,311.09,-1831701.23,GBP,Target
TXN0000009996,2024-12-01T05:49:28,ACC00006703,Payment,832.25,-1832533.48,EUR,Starbucks
TXN0000009997,2024-09-01T12:01:31,ACC00005004,Transfer,926.26,-1831607.22,JPY,Online Store
TXN0000009998,2024-09-25T23:14:47,ACC00002482,Credit,261.03,-1831346.19,GBP,Grocery
TXN0000009999,2024-02-23T17:29:15,ACC00002013,Debit,953.09,-1832299.28,EUR,Walmart
TXN0000010000,2024-01-16T01:15:45,ACC00009170,Payment,318.89,-1832618.17,USD,Grocery
TXN0000010001,2024-07-01T09:08:39,ACC00004659,Payment,1565.49,12516.85,GBP,Target
TXN0000010002,2024-09-06T19:55:16,ACC00002688,ATM,1587.68,10929.17,JPY,Restaurant
TXN0000010003,2024-03-11T19:53:48,ACC00004139,Credit,1750.95,12680.12,USD,Target
TXN0000010004,2024-08-31T17:35:09,ACC00001109,Payment,1909.73,10770.39,GBP,Online Store
TXN0000010005,2024-01-14T07:13:49,ACC00003641,Credit,488.32,11258.71,JPY,Online Store
TXN0000010006,2024-12-13T04:40:27,ACC00006382,Debit,356.05,10902.66,USD,Amazon
TXN0000010007,2024-10-19T00:59:06,ACC00000080,Credit,1097.62,12000.28,EUR,Amazon
TXN0000010008,2024-03-19T11:44:25,ACC00007758,Transfer,1140.39,13140.67,GBP,Online Store
TXN0000010009,2024-09-06T19:34:45,ACC00002962,Credit,365.84,13506.51,JPY,Starbucks
TXN0000010010,2024-02-25T08:30:23,ACC00000897,Transfer,1108.44,14614.95,USD,Walmart
TXN0000010011,2024-01-30T17:37:12,ACC00003714,ATM,1763.47,12851.48,GBP,Walmart
TXN0000010012,2024-07-24T02:17:03,ACC00000154,ATM,1577.93,11273.55,JPY,Restaurant
TXN0000010013,2024-09-18T04:57:51,ACC00002494,ATM,906.62,10366.93,EUR,Target
TXN0000010014,2024-04-13T06:40:23,ACC00008975,Debit,1665.98,8700.95,GBP,Starbucks
TXN0000010015,2024-01-02T03:48:06,ACC00000623,Payment,385.99,8314.96,JPY,Shell
TXN0000010016,2024-01-22T14:09:10,ACC00007556,Credit,1418.55,9733.51,EUR,Starbucks
TXN0000010017,2024-01-17T10:58:03,ACC00005814,Credit,84.69,9818.2,USD,Grocery
TXN0000010018,2024-09-12T04:41:19,ACC00003726,Transfer,1012.5,10830.7,GBP,Shell
TXN0000010019,2024-04-24T06:25:50,ACC00005304,Transfer,1865.91,12696.61,EUR,Starbucks
TXN0000010020,2024-12-29T02:20:11,ACC00008375,Credit,1645.19,14341.8,JPY,Walmart
TXN0000010021,2024-09-24T17:35:15,ACC00009723,ATM,728.8,13613.0,EUR,Target
TXN0000010022,2024-01-23T11:21:33,ACC00005479,ATM,1653.55,11959.45,GBP,Restaurant
TXN0000010023,2024-04-06T06:44:47,ACC00005427,Credit,835.25,12794.7,USD,Amazon
TXN0000010024,2024-12-02T17:47:01,ACC00002065,Transfer,1011.49,13806.19,EUR,Shell
TXN0000010025,2024-08-18T12:46:58,ACC00002946,ATM,470.91,13335.28,JPY,Restaurant
TXN0000010026,2024-05-27T02:01:58,ACC00007486,Debit,1153.64,12181.64,GBP,Online Store
TXN0000010027,2024-02-24T08:55:54,ACC00009256,Transfer,147.49,12329.13,JPY,Walmart
TXN0000010028,2024-05-31T10:18:37,ACC00005703,Credit,1167.05,13496.18,JPY,Online Store
TXN0000010029,2024-05-16T14:18:41,ACC00000147,Payment,62.37,13433.81,USD,Target
TXN0000010030,2024-08-10T18:13:00,ACC00001970,Payment,148.76,13285.05,JPY,Shell
TXN0000010031,2024-08-26T13:35:03,ACC00008595,Credit,1219.73,14504.78,JPY,Online Store
TXN0000010032,2024-08-29T11:36:15,ACC00004944,Payment,1032.64,13472.14,EUR,Target
TXN0000010033,2024-03-30T03:12:06,ACC00005684,Transfer,769.78,14241.92,USD,Walmart
TXN0000010034,2024-02-19T01:53:23,ACC00001541,ATM,1252.5,12989.42,JPY,Amazon
TXN0000010035,2024-01-12T09:27:24,ACC00009670,ATM,1455.87,11533.55,USD,Grocery
TXN0000010036,2024-03-21T21:15:40,ACC00007506,Debit,1481.07,10052.48,USD,Restaurant
TXN0000010037,2024-05-11T06:36:10,ACC00007415,Debit,539.47,9513.01,USD,Amazon
TXN0000010038,2024-10-25T19:52:43,ACC00005881,Transfer,922.11,10435.12,JPY,Online Store
TXN0000010039,2024-12-09T03:11:29,ACC00000624,ATM,1863.39,8571.73,JPY,Target
TXN0000010040,2024-04-29T12:23:24,ACC00007047,Debit,834.1,7737.63,EUR,Online Store
TXN0000010041,2024-08-21T20:14:27,ACC00002309,ATM,1474.03,6263.6,JPY,Amazon
TXN0000010042,2024-05-29T21:48:48,ACC00006495,Debit,1270.31,4993.29,USD,Target
TXN0000010043,2024-06-07T16:17:12,ACC00001807,Transfer,821.15,5814.44,JPY,Walmart
TXN0000010044,2024-06-02T09:23:03,ACC00004845,Credit,1927.67,7742.11,USD,Walmart
TXN0000010045,2024-08-29T20:05:24,ACC00007271,Payment,1786.84,5955.27,EUR,Amazon
TXN0000010046,2024-04-27T20:14:15,ACC00008702,Debit,175.38,5779.89,EUR,Amazon
TXN0000010047,2024-06-02T00:19:54,ACC00001847,Debit,1321.11,4458.78,EUR,Grocery
TXN0000010048,2024-08-26T08:23:31,ACC00003833,Payment,1072.95,3385.83,EUR,Amazon
TXN0000010049,2024-11-20T16:20:51,ACC00002243,Credit,55.81,3441.64,EUR,Walmart
TXN0000010050,2024-03-15T16:58:38,ACC00001628,Debit,775.27,2666.37,GBP,Walmart
TXN0000010051,2024-09-20T06:07:41,ACC00008151,Credit,1655.15,4321.52,JPY,Shell
TXN0000010052,2024-03-08T06:44:32,ACC00007889,Credit,1906.24,6227.76,EUR,Walmart
TXN0000010053,2024-12-04T02:38:31,ACC00004530,Payment,312.97,5914.79,USD,Target
TXN0000010054,2024-03-11T21:29:45,ACC00007886,Debit,424.48,5490.31,EUR,Target
TXN0000010055,2024-05-15T17:30:04,ACC00001367,Payment,1689.69,3800.62,USD,Walmart
TXN0000010056,2024-05-05T13:01:07,ACC00005172,Payment,1023.26,2777.36,GBP,Walmart
TXN0000010057,2024-11-08T17:52:27,ACC00008095,ATM,1058.96,1718.4,JPY,Shell
TXN0000010058,2024-08-09T05:20:12,ACC00004548,Payment,1065.75,652.65,USD,Starbucks
TXN0000010059,2024-04-29T23:42:32,ACC00008096,ATM,822.01,-169.36,GBP,Starbucks
TXN0000010060,2024-05-23T11:22:55,ACC00006443,Debit,445.16,-614.52,GBP,Online Store
TXN0000010061,2024-09-18T08:36:11,ACC00008342,ATM,1081.86,-1696.38,GBP,Amazon
TXN0000010062,2024-03-05T10:08:26,ACC00004714,ATM,771.57,-2467.95,JPY,Online Store
TXN0000010063,2024-10-17T14:05:08,ACC00006424,Debit,1480.6,-3948.55,EUR,Shell
TXN0000010064,2024-12-06T22:03:26,ACC00002587,Debit,183.27,-4131.82,GBP,Amazon
TXN0000010065,2024-11-05T13:04:03,ACC00008771,ATM,460.34,-4592.16,JPY,Restaurant
TXN0000010066,2024-10-11T08:29:10,ACC00005355,ATM,1778.43,-6370.59,USD,Amazon
TXN0000010067,2024-10-03T22:05:08,ACC00006040,Transfer,1830.81,-4539.78,GBP,Shell
TXN0000010068,2024-06-19T03:47:35,ACC00008238,Payment,1685.32,-6225.1,EUR,Amazon
TXN0000010069,2024-06-17T18:34:51,ACC00002003,Payment,1668.55,-7893.65,GBP,Walmart
TXN0000010070,2024-09-26T05:53:08,ACC00002323,Payment,1305.45,-9199.1,GBP,Target
TXN0000010071,2024-06-09T16:17:24,ACC00008693,Debit,1859.34,-11058.44,GBP,Starbucks
TXN0000010072,2024-01-10T23:17:51,ACC00006898,Payment,1891.99,-12950.43,USD,Restaurant
TXN0000010073,2024-01-17T23:27:53,ACC00007128,Debit,475.09,-13425.52,GBP,Shell
TXN0000010074,2024-04-21T21:27:45,ACC00009800,Debit,426.64,-13852.16,GBP,Grocery
TXN0000010075,2024-06-02T00:17:19,ACC00003461,Credit,1493.12,-12359.04,USD,Walmart
TXN0000010076,2024-03-19T13:57:26,ACC00004027,Transfer,827.86,-11531.18,USD,Target
TXN0000010077,2024-11-27T23:04:26,ACC00000525,ATM,349.34,-11880.52,EUR,Grocery
TXN0000010078,2024-06-15T01:18:41,ACC00000118,Debit,1623.99,-13504.51,JPY,Grocery
TXN0000010079,2024-02-18T17:38:59,ACC00007270,ATM,832.41,-14336.92,EUR,Walmart
TXN0000010080,2024-09-18T16:04:10,ACC00004478,Debit,1865.08,-16202.0,GBP,Walmart
TXN0000010081,2024-10-31T02:54:01,ACC00009230,Debit,650.61,-16852.61,EUR,Online Store
TXN0000010082,2024-12-16T12:21:58,ACC00006985,Credit,1053.0,-15799.61,EUR,Grocery
TXN0000010083,2024-05-26T18:16:46,ACC00003796,Payment,602.42,-16402.03,USD,Grocery
TXN0000010084,2024-11-26T06:23:57,ACC00001187,Transfer,377.26,-16024.77,USD,Shell
TXN0000010085,2024-01-06T01:01:57,ACC00008922,Credit,904.34,-15120.43,GBP,Shell
TXN0000010086,2024-06-28T21:35:05,ACC00002114,ATM,1433.02,-16553.45,JPY,Online Store
TXN0000010087,2024-05-07T19:36:43,ACC00001638,Credit,563.82,-15989.63,JPY,Walmart
TXN0000010088,2024-08-25T07:03:18,ACC00004681,Transfer,250.16,-15739.47,JPY,Amazon
TXN0000010089,2024-10-14T06:09:55,ACC00006627,Credit,1071.49,-14667.98,EUR,Grocery
TXN0000010090,2024-12-20T05:40:41,ACC00000654,Payment,636.8,-15304.78,GBP,Amazon
TXN0000010091,2024-10-26T13:05:48,ACC00006949,Payment,215.99,-15520.77,GBP,Shell
TXN0000010092,2024-11-17T20:45:10,ACC00005408,Credit,1714.15,-13806.62,USD,Restaurant
TXN0000010093,2024-02-24T03:05:18,ACC00000774,Transfer,1159.72,-12646.9,JPY,Shell
TXN0000010094,2024-06-18T10:49:12,ACC00009242,Transfer,1311.74,-11335.16,USD,Amazon
TXN0000010095,2024-08-21T17:27:26,ACC00001109,Payment,1594.19,-12929.35,GBP,Restaurant
TXN0000010096,2024-01-17T01:26:00,ACC00007908,Credit,1857.77,-11071.58,EUR,Online Store
TXN0000010097,2024-07-26T22:00:25,ACC00008939,Payment,916.82,-11988.4,EUR,Starbucks
TXN0000010098,2024-12-09T22:34:06,ACC00006241,Credit,1362.73,-10625.67,EUR,Amazon
TXN0000010099,2024-01-08T18:11:34,ACC00003246,ATM,362.49,-10988.16,GBP,Target
TXN0000010100,2024-07-16T02:12:19,ACC00004628,Credit,682.23,-10305.93,GBP,Grocery
TXN0000010101,2024-03-31T15:41:10,ACC00000042,Transfer,911.27,-9394.66,EUR,Online Store
TXN0000010102,2024-03-10T18:20:44,ACC00001828,Payment,1984.27,-11378.93,GBP,Amazon
TXN0000010103,2024-09-09T04:54:55,ACC00007923,Debit,255.91,-11634.84,JPY,Shell
TXN0000010104,2024-03-04T03:30:09,ACC00005166,ATM,359.12,-11993.96,USD,Starbucks
TXN0000010105,2024-06-09T07:20:39,ACC00000041,Credit,79.15,-11914.81,JPY,Amazon
TXN0000010106,2024-04-08T06:39:13,ACC00000676,ATM,1954.34,-13869.15,EUR,Starbucks
TXN0000010107,2024-06-28T17:19:39,ACC00008412,Payment,1164.37,-15033.52,USD,Walmart
TXN0000010108,2024-04-12T17:44:27,ACC00005834,Debit,1746.61,-16780.13,JPY,Amazon
TXN0000010109,2024-06-11T14:04:49,ACC00004310,Payment,1075.14,-17855.27,GBP,Restaurant
TXN0000010110,2024-12-13T21:19:37,ACC00004313,Debit,876.4,-18731.67,EUR,Grocery
TXN0000010111,2024-02-12T12:40:18,ACC00002144,Transfer,1577.16,-17154.51,USD,Target
TXN0000010112,2024-08-19T18:29:24,ACC00000667,Credit,1680.53,-15473.98,JPY,Grocery
TXN0000010113,2024-02-13T04:43:45,ACC00000132,ATM,1595.39,-17069.37,JPY,Shell
TXN0000010114,2024-12-27T01:03:15,ACC00007308,Credit,1181.68,-15887.69,GBP,Starbucks
TXN0000010115,2024-02-26T05:47:45,ACC00008249,Debit,1413.15,-17300.84,EUR,Amazon
TXN0000010116,2024-04-04T19:57:00,ACC00007128,ATM,834.57,-18135.41,GBP,Target
TXN0000010117,2024-08-20T17:11:00,ACC00000922,ATM,1723.47,-19858.88,USD,Walmart
TXN0000010118,2024-09-29T00:06:27,ACC00008517,Transfer,1683.31,-18175.57,JPY,Restaurant
TXN0000010119,2024-10-17T19:39:35,ACC00008916,Debit,1594.68,-19770.25,GBP,Shell
TXN0000010120,2024-04-30T12:18:18,ACC00001218,Payment,642.56,-20412.81,GBP,Grocery
TXN0000010121,2024-01-11T07:09:05,ACC00001301,Credit,1982.65,-18430.16,EUR,Walmart
TXN0000010122,2024-09-11T16:50:09,ACC00008331,Transfer,894.57,-17535.59,USD,Online Store
TXN0000010123,2024-02-22T08:34:08,ACC00006961,ATM,1508.6,-19044.19,USD,Walmart
TXN0000010124,2024-06-03T05:48:17,ACC00001004,ATM,388.19,-19432.38,JPY,Target
TXN0000010125,2024-03-31T16:21:30,ACC00008076,Payment,618.24,-20050.62,GBP,Shell
TXN0000010126,2024-02-27T09:39:48,ACC00006906,ATM,1890.72,-21941.34,EUR,Shell
TXN0000010127,2024-10-10T14:34:44,ACC00001984,Debit,1335.26,-23276.6,USD,Target
TXN0000010128,2024-12-21T05:14:58,ACC00004835,ATM,722.86,-23999.46,GBP,Amazon
TXN0000010129,2024-03-20T10:30:43,ACC00009571,Debit,879.63,-24879.09,JPY,Target
TXN0000010130,2024-10-04T23:19:26,ACC00006900,Payment,342.51,-25221.6,JPY,Starbucks
TXN0000010131,2024-09-11T04:36:29,ACC00001118,Credit,1757.26,-23464.34,EUR,Amazon
TXN0000010132,2024-11-03T22:37:25,ACC00002369,ATM,959.18,-24423.52,JPY,Restaurant
TXN0000010133,2024-10-22T04:15:01,ACC00009415,Payment,695.44,-25118.96,EUR,Restaurant
TXN0000010134,2024-10-31T21:12:16,ACC00002182,Debit,946.68,-26065.64,JPY,Target
TXN0000010135,2024-08-05T01:45:40,ACC00000163,Transfer,1375.58,-24690.06,USD,Target
TXN0000010136,2024-08-09T09:06:30,ACC00002175,Payment,1756.34,-26446.4,JPY,Grocery
TXN0000010137,2024-04-04T21:08:28,ACC00009281,Debit,18.36,-26464.76,EUR,Restaurant
TXN0000010138,2024-11-02T06:39:21,ACC00002702,Debit,191.76,-26656.52,USD,Online Store
TXN0000010139,2024-12-13T19:57:00,ACC00002965,Credit,512.62,-26143.9,EUR,Shell
TXN0000010140,2024-01-06T09:20:57,ACC00004333,Transfer,1670.02,-24473.88,USD,Grocery
TXN0000010141,2024-03-27T02:38:38,ACC00006022,Payment,998.73,-25472.61,USD,Shell
TXN0000010142,2024-04-02T17:33:45,ACC00008559,ATM,107.46,-25580.07,EUR,Restaurant
TXN0000010143,2024-09-09T21:24:26,ACC00002031,Payment,1320.17,-26900.24,JPY,Online Store
TXN0000010144,2024-12-03T06:46:40,ACC00009941,Transfer,1298.75,-25601.49,GBP,Shell
TXN0000010145,2024-01-10T06:43:48,ACC00007896,Credit,832.3,-24769.19,USD,Amazon
TXN0000010146,2024-06-30T09:08:53,ACC00007157,ATM,1063.27,-25832.46,JPY,Shell
TXN0000010147,2024-02-29T01:19:43,ACC00008541,Payment,142.18,-25974.64,JPY,Online Store
TXN0000010148,2024-01-08T13:45:39,ACC00002981,Payment,1518.98,-27493.62,USD,Amazon
TXN0000010149,2024-11-26T06:46:48,ACC00007984,Debit,1638.84,-29132.46,GBP,Starbucks
TXN0000010150,2024-05-13T07:59:56,ACC00005653,Payment,705.51,-29837.97,EUR,Online Store
TXN0000010151,2024-06-17T17:07:14,ACC00006333,Credit,1966.58,-27871.39,USD,Restaurant
TXN0000010152,2024-04-10T02:07:22,ACC00003529,ATM,593.63,-28465.02,GBP,Starbucks
TXN0000010153,2024-08-25T09:53:20,ACC00001965,ATM,1499.58,-29964.6,USD,Shell
TXN0000010154,2024-05-07T08:40:44,ACC00003093,Transfer,470.23,-29494.37,GBP,Grocery
TXN0000010155,2024-08-11T19:15:23,ACC00007873,Debit,1574.04,-31068.41,JPY,Restaurant
TXN0000010156,2024-10-07T10:48:00,ACC00009942,Transfer,807.82,-30260.59,USD,Starbucks
TXN0000010157,2024-05-10T07:20:01,ACC00009148,Payment,667.02,-30927.61,GBP,Starbucks
TXN0000010158,2024-12-29T19:00:48,ACC00003517,Debit,920.22,-31847.83,GBP,Grocery
TXN0000010159,2024-06-25T08:01:32,ACC00002275,Transfer,1471.76,-30376.07,JPY,Walmart
TXN0000010160,2024-05-15T14:47:17,ACC00001901,Payment,1985.15,-32361.22,GBP,Walmart
TXN0000010161,2024-03-25T22:43:23,ACC00006934,Credit,1622.61,-30738.61,GBP,Online Store
TXN0000010162,2024-03-17T05:56:35,ACC00002260,Debit,72.08,-30810.69,GBP,Starbucks
TXN0000010163,2024-07-15T22:06:17,ACC00004606,ATM,574.14,-31384.83,EUR,Amazon
TXN0000010164,2024-03-14T19:31:46,ACC00007853,Credit,1359.87,-30024.96,GBP,Restaurant
TXN0000010165,2024-06-18T17:42:04,ACC00005035,ATM,1683.34,-31708.3,JPY,Starbucks
TXN0000010166,2024-10-13T05:12:27,ACC00004245,Credit,444.08,-31264.22,USD,Amazon
TXN0000010167,2024-02-17T02:25:54,ACC00008691,Debit,895.17,-32159.39,USD,Online Store
TXN0000010168,2024-03-25T18:09:04,ACC00001941,Payment,1202.35,-33361.74,EUR,Grocery
TXN0000010169,2024-06-22T18:08:18,ACC00003163,ATM,988.33,-34350.07,GBP,Shell
TXN0000010170,2024-06-08T06:05:54,ACC00006529,Debit,1634.59,-35984.66,EUR,Amazon
TXN0000010171,2024-09-22T14:41:36,ACC00007967,Debit,44.41,-36029.07,EUR,Amazon
TXN0000010172,2024-06-04T19:08:09,ACC00000870,Transfer,395.29,-35633.78,EUR,Restaurant
TXN0000010173,2024-04-06T09:51:12,ACC00003479,ATM,1070.21,-36703.99,EUR,Target
TXN0000010174,2024-02-03T18:54:31,ACC00008635,Debit,1479.7,-38183.69,JPY,Target
TXN0000010175,2024-11-11T07:46:03,ACC00003677,Transfer,270.4,-37913.29,USD,Amazon
TXN0000010176,2024-03-01T17:22:26,ACC00000638,Transfer,1299.84,-36613.45,EUR,Starbucks
TXN0000010177,2024-12-10T11:22:48,ACC00004540,Debit,1881.61,-38495.06,GBP,Grocery
TXN0000010178,2024-03-16T22:54:13,ACC00008545,ATM,903.55,-39398.61,USD,Walmart
TXN0000010179,2024-02-02T13:48:05,ACC00006247,Payment,1872.16,-41270.77,JPY,Target
TXN0000010180,2024-01-11T11:16:29,ACC00009167,Transfer,509.13,-40761.64,EUR,Amazon
TXN0000010181,2024-02-15T07:40:19,ACC00003464,Payment,180.72,-40942.36,USD,Target
TXN0000010182,2024-04-06T02:52:59,ACC00006160,Debit,351.38,-41293.74,USD,Grocery
TXN0000010183,2024-07-07T08:08:11,ACC00001143,ATM,1344.81,-42638.55,EUR,Shell
TXN0000010184,2024-10-11T13:53:53,ACC00006585,Payment,311.41,-42949.96,JPY,Shell
TXN0000010185,2024-08-01T15:36:55,ACC00004761,ATM,1986.69,-44936.65,USD,Grocery
TXN0000010186,2024-07-07T22:35:54,ACC00003678,ATM,210.27,-45146.92,EUR,Restaurant
TXN0000010187,2024-04-29T15:01:22,ACC00008059,Transfer,1829.91,-43317.01,USD,Amazon
TXN0000010188,2024-10-17T01:23:40,ACC00005866,Debit,243.29,-43560.3,GBP,Walmart
TXN0000010189,2024-01-16T22:16:18,ACC00000745,Debit,1432.53,-44992.83,USD,Shell
TXN0000010190,2024-07-02T15:49:18,ACC00009696,Transfer,1997.78,-42995.05,USD,Target
TXN0000010191,2024-05-11T04:19:19,ACC00004851,Payment,1581.82,-44576.87,GBP,Restaurant
TXN0000010192,2024-06-19T10:43:22,ACC00002270,Payment,1544.2,-46121.07,JPY,Restaurant
TXN0000010193,2024-01-13T04:16:26,ACC00001890,Payment,922.22,-47043.29,GBP,Walmart
TXN0000010194,2024-05-28T18:29:17,ACC00008816,Credit,1329.19,-45714.1,JPY,Grocery
TXN0000010195,2024-05-24T10:47:23,ACC00006054,Credit,31.03,-45683.07,USD,Starbucks
TXN0000010196,2024-12-29T20:27:51,ACC00006529,Debit,704.08,-46387.15,USD,Amazon
TXN0000010197,2024-06-06T04:49:23,ACC00007348,Payment,1969.26,-48356.41,USD,Amazon
TXN0000010198,2024-04-09T09:07:28,ACC00001054,Payment,463.1,-48819.51,GBP,Starbucks
TXN0000010199,2024-10-10T14:42:52,ACC00001902,Payment,608.32,-49427.83,JPY,Target
TXN0000010200,2024-11-20T14:05:24,ACC00001398,Transfer,1567.36,-47860.47,USD,Target
TXN0000010201,2024-04-02T06:03:50,ACC00003473,Debit,1465.92,-49326.39,EUR,Grocery
TXN0000010202,2024-11-25T06:01:26,ACC00003503,Transfer,1410.36,-47916.03,GBP,Grocery
TXN0000010203,2024-12-17T22:28:36,ACC00001374,Transfer,255.0,-47661.03,GBP,Amazon
TXN0000010204,2024-03-10T13:29:23,ACC00006488,Credit,901.41,-46759.62,JPY,Walmart
TXN0000010205,2024-07-20T04:30:47,ACC00005133,Transfer,1271.7,-45487.92,EUR,Amazon
TXN0000010206,2024-05-25T14:01:07,ACC00009095,Debit,1819.88,-47307.8,EUR,Walmart
TXN0000010207,2024-12-09T10:39:46,ACC00009039,Payment,200.53,-47508.33,JPY,Amazon
TXN0000010208,2024-06-08T10:39:46,ACC00005864,Payment,1668.81,-49177.14,USD,Walmart
TXN0000010209,2024-04-26T17:02:17,ACC00001991,Debit,726.86,-49904.0,USD,Target
TXN0000010210,2024-08-20T02:37:18,ACC00005783,Credit,67.81,-49836.19,GBP,Restaurant
TXN0000010211,2024-11-10T04:53:02,ACC00000843,Credit,1521.88,-48314.31,EUR,Target
TXN0000010212,2024-01-01T06:03:53,ACC00007738,Transfer,919.02,-47395.29,GBP,Shell
TXN0000010213,2024-08-30T17:38:19,ACC00008062,Credit,1772.06,-45623.23,USD,Online Store
TXN0000010214,2024-02-03T19:52:49,ACC00006299,Payment,1901.95,-47525.18,GBP,Amazon
TXN0000010215,2024-04-12T09:21:47,ACC00007564,ATM,217.92,-47743.1,USD,Restaurant
TXN0000010216,2024-03-06T20:42:28,ACC00008731,Debit,117.93,-47861.03,EUR,Shell
TXN0000010217,2024-01-31T11:00:55,ACC00005650,Transfer,635.01,-47226.02,JPY,Restaurant
TXN0000010218,2024-02-05T16:31:31,ACC00008904,ATM,1935.17,-49161.19,JPY,Walmart
TXN0000010219,2024-03-17T04:53:39,ACC00003674,ATM,754.2,-49915.39,JPY,Shell
TXN0000010220,2024-06-04T09:22:05,ACC00002482,Debit,473.23,-50388.62,EUR,Starbucks
TXN0000010221,2024-03-28T20:54:01,ACC00007856,Debit,574.34,-50962.96,JPY,Amazon
TXN0000010222,2024-09-07T12:03:57,ACC00008783,ATM,107.79,-51070.75,GBP,Restaurant
TXN0000010223,2024-12-25T07:23:10,ACC00007820,Transfer,1562.07,-49508.68,GBP,Target
TXN0000010224,2024-05-09T03:50:57,ACC00007466,Debit,681.49,-50190.17,JPY,Restaurant
TXN0000010225,2024-02-29T14:26:42,ACC00003007,Debit,1688.61,-51878.78,JPY,Grocery
TXN0000010226,2024-01-05T22:44:06,ACC00007338,ATM,498.8,-52377.58,USD,Online Store
TXN0000010227,2024-05-29T04:40:06,ACC00000659,Transfer,913.11,-51464.47,EUR,Target
TXN0000010228,2024-06-16T22:46:55,ACC00005918,Debit,1641.85,-53106.32,JPY,Restaurant
TXN0000010229,2024-04-16T06:51:12,ACC00005223,ATM,872.34,-53978.66,EUR,Online Store
TXN0000010230,2024-04-12T10:37:44,ACC00006146,Payment,1870.82,-55849.48,GBP,Target
TXN0000010231,2024-04-01T16:48:17,ACC00006776,ATM,124.44,-55973.92,USD,Target
TXN0000010232,2024-12-06T20:06:27,ACC00007091,ATM,1270.11,-57244.03,GBP,Amazon
TXN0000010233,2024-09-12T21:06:48,ACC00003887,Payment,730.22,-57974.25,GBP,Grocery
TXN0000010234,2024-11-24T07:19:53,ACC00001359,Payment,300.77,-58275.02,EUR,Amazon
TXN0000010235,2024-08-07T17:06:04,ACC00008193,Transfer,1714.93,-56560.09,JPY,Target
TXN0000010236,2024-01-17T05:22:00,ACC00000626,Transfer,39.52,-56520.57,USD,Online Store
TXN0000010237,2024-01-03T01:55:53,ACC00003824,Credit,1387.74,-55132.83,USD,Target
TXN0000010238,2024-11-24T03:34:39,ACC00001090,ATM,1603.19,-56736.02,GBP,Starbucks
TXN0000010239,2024-08-27T23:37:06,ACC00008241,Payment,924.91,-57660.93,GBP,Starbucks
TXN0000010240,2024-03-21T07:00:49,ACC00007548,Debit,796.12,-58457.05,EUR,Amazon
TXN0000010241,2024-12-21T00:50:36,ACC00001576,Credit,807.98,-57649.07,JPY,Target
TXN0000010242,2024-03-17T03:35:59,ACC00004581,Transfer,461.65,-57187.42,GBP,Walmart
TXN0000010243,2024-12-04T06:00:46,ACC00002503,Debit,1044.31,-58231.73,JPY,Grocery
TXN0000010244,2024-08-25T12:41:25,ACC00002065,Credit,1827.42,-56404.31,USD,Walmart
TXN0000010245,2024-12-11T03:51:54,ACC00004259,ATM,1926.09,-58330.4,GBP,Amazon
TXN0000010246,2024-05-13T20:56:19,ACC00006089,Credit,1363.01,-56967.39,EUR,Starbucks
TXN0000010247,2024-05-22T19:33:31,ACC00005924,Payment,180.28,-57147.67,GBP,Starbucks
TXN0000010248,2024-06-05T16:23:54,ACC00002612,Payment,468.04,-57615.71,JPY,Online Store
TXN0000010249,2024-08-24T02:06:47,ACC00007347,Transfer,1181.14,-56434.57,EUR,Amazon
TXN0000010250,2024-02-05T02:24:45,ACC00007389,Payment,1565.89,-58000.46,EUR,Starbucks
TXN0000010251,2024-04-14T13:57:25,ACC00002313,Credit,1771.48,-56228.98,EUR,Starbucks
TXN0000010252,2024-07-22T06:30:15,ACC00007702,Credit,1241.57,-54987.41,GBP,Shell
TXN0000010253,2024-03-18T22:42:31,ACC00000193,Transfer,1136.7,-53850.71,JPY,Amazon
TXN0000010254,2024-11-16T14:51:16,ACC00005539,Credit,1985.41,-51865.3,USD,Amazon
TXN0000010255,2024-11-12T07:58:42,ACC00005767,Transfer,116.89,-51748.41,EUR,Starbucks
TXN0000010256,2024-02-06T11:16:51,ACC00005765,Credit,1001.25,-50747.16,EUR,Amazon
TXN0000010257,2024-07-10T09:36:50,ACC00008764,Payment,557.32,-51304.48,GBP,Amazon
TXN0000010258,2024-02-23T21:08:32,ACC00006561,Credit,1894.1,-49410.38,JPY,Target
TXN0000010259,2024-03-26T21:57:59,ACC00007491,Debit,1754.36,-51164.74,EUR,Target
TXN0000010260,2024-12-12T14:56:43,ACC00002038,Payment,1012.57,-52177.31,USD,Online Store
TXN0000010261,2024-09-08T13:39:09,ACC00008155,Payment,1921.55,-54098.86,USD,Online Store
TXN0000010262,2024-09-23T21:09:16,ACC00006453,Payment,1768.44,-55867.3,GBP,Shell
TXN0000010263,2024-08-23T15:12:02,ACC00006945,Transfer,1328.93,-54538.37,JPY,Shell
TXN0000010264,2024-12-22T05:36:01,ACC00004910,Payment,1902.39,-56440.76,EUR,Restaurant
TXN0000010265,2024-07-04T17:36:43,ACC00005651,Transfer,827.62,-55613.14,GBP,Shell
TXN0000010266,2024-07-03T07:56:23,ACC00008146,Credit,1189.85,-54423.29,JPY,Online Store
TXN0000010267,2024-12-04T10:09:09,ACC00006882,Credit,793.92,-53629.37,USD,Grocery
TXN0000010268,2024-07-13T02:07:50,ACC00004781,Payment,668.37,-54297.74,EUR,Restaurant
TXN0000010269,2024-10-14T14:40:43,ACC00001597,Credit,1549.21,-52748.53,EUR,Grocery
TXN0000010270,2024-02-09T14:23:02,ACC00005287,Debit,32.51,-52781.04,USD,Walmart
TXN0000010271,2024-06-05T11:00:53,ACC00007495,ATM,297.52,-53078.56,USD,Shell
TXN0000010272,2024-10-02T13:22:47,ACC00003285,Payment,1518.89,-54597.45,EUR,Target
TXN0000010273,2024-03-02T06:41:10,ACC00008586,Payment,1973.67,-56571.12,JPY,Shell
TXN0000010274,2024-06-02T22:50:45,ACC00004804,Credit,1934.02,-54637.1,EUR,Starbucks
TXN0000010275,2024-06-30T13:08:54,ACC00002070,Transfer,103.22,-54533.88,GBP,Walmart
TXN0000010276,2024-01-11T03:36:52,ACC00004023,Credit,302.65,-54231.23,GBP,Starbucks
TXN0000010277,2024-09-01T15:35:19,ACC00008565,ATM,1632.02,-55863.25,JPY,Shell
TXN0000010278,2024-10-17T22:15:15,ACC00009255,ATM,1413.98,-57277.23,JPY,Target
TXN0000010279,2024-04-20T12:42:27,ACC00006518,ATM,1039.99,-58317.22,JPY,Grocery
TXN0000010280,2024-10-12T20:21:19,ACC00006883,Payment,479.86,-58797.08,GBP,Grocery
TXN0000010281,2024-09-30T19:02:48,ACC00004619,Credit,679.0,-58118.08,JPY,Target
TXN0000010282,2024-05-19T21:06:17,ACC00007676,Payment,257.61,-58375.69,EUR,Amazon
TXN0000010283,2024-06-13T05:13:50,ACC00003794,Transfer,915.68,-57460.01,GBP,Walmart
TXN0000010284,2024-11-19T00:05:48,ACC00009450,Credit,207.51,-57252.5,EUR,Shell
TXN0000010285,2024-05-31T03:45:44,ACC00002834,ATM,1672.78,-58925.28,GBP,Shell
TXN0000010286,2024-07-01T17:58:14,ACC00008243,ATM,1419.15,-60344.43,GBP,Restaurant
TXN0000010287,2024-06-09T06:59:00,ACC00004100,Debit,1897.46,-62241.89,GBP,Target
TXN0000010288,2024-12-21T09:23:06,ACC00009071,Credit,1342.46,-60899.43,GBP,Amazon
TXN0000010289,2024-01-28T17:39:14,ACC00000351,Credit,541.26,-60358.17,GBP,Amazon
TXN0000010290,2024-05-24T15:52:35,ACC00006731,Payment,62.68,-60420.85,EUR,Online Store
TXN0000010291,2024-06-19T14:18:38,ACC00002354,Transfer,832.39,-59588.46,GBP,Walmart
TXN0000010292,2024-10-19T19:42:41,ACC00006659,Transfer,1916.69,-57671.77,GBP,Amazon
TXN0000010293,2024-12-21T09:43:07,ACC00006124,Debit,1825.49,-59497.26,GBP,Starbucks
TXN0000010294,2024-07-03T21:35:07,ACC00004881,Transfer,600.01,-58897.25,GBP,Walmart
TXN0000010295,2024-11-01T21:39:13,ACC00009288,Debit,503.5,-59400.75,JPY,Target
TXN0000010296,2024-11-15T13:25:41,ACC00009730,Credit,1171.88,-58228.87,JPY,Starbucks
TXN0000010297,2024-07-13T21:44:27,ACC00001218,Payment,1459.66,-59688.53,EUR,Restaurant
TXN0000010298,2024-09-21T14:31:42,ACC00005301,Transfer,1786.29,-57902.24,USD,Grocery
TXN0000010299,2024-12-06T02:52:51,ACC00008710,ATM,1870.46,-59772.7,JPY,Restaurant
TXN0000010300,2024-02-19T19:24:34,ACC00009589,ATM,1988.01,-61760.71,USD,Amazon
TXN0000010301,2024-09-27T20:52:40,ACC00007036,Debit,1783.74,-63544.45,USD,Shell
TXN0000010302,2024-05-27T00:19:55,ACC00002803,Debit,1572.72,-65117.17,EUR,Shell
TXN0000010303,2024-12-20T13:03:28,ACC00004515,ATM,1798.07,-66915.24,EUR,Starbucks
TXN0000010304,2024-08-04T17:17:44,ACC00004743,Debit,485.26,-67400.5,JPY,Grocery
TXN0000010305,2024-04-23T02:09:00,ACC00005697,Debit,122.94,-67523.44,USD,Walmart
TXN0000010306,2024-03-15T02:07:42,ACC00002601,Payment,1994.31,-69517.75,USD,Online Store
TXN0000010307,2024-06-10T07:23:07,ACC00006581,Debit,1654.96,-71172.71,JPY,Starbucks
TXN0000010308,2024-01-17T07:43:34,ACC00009142,ATM,360.29,-71533.0,GBP,Online Store
TXN0000010309,2024-10-27T03:22:48,ACC00000603,Transfer,1833.96,-69699.04,EUR,Walmart
TXN0000010310,2024-11-12T10:20:37,ACC00004577,Transfer,1664.18,-68034.86,GBP,Walmart
TXN0000010311,2024-08-02T03:45:11,ACC00003326,ATM,665.21,-68700.07,EUR,Grocery
TXN0000010312,2024-05-03T13:21:56,ACC00001210,ATM,961.37,-69661.44,GBP,Walmart
TXN0000010313,2024-11-28T08:21:18,ACC00000939,ATM,1046.62,-70708.06,GBP,Amazon
TXN0000010314,2024-05-08T08:28:31,ACC00005578,ATM,839.47,-71547.53,USD,Target
TXN0000010315,2024-03-06T17:39:29,ACC00006311,Credit,656.88,-70890.65,GBP,Starbucks
TXN0000010316,2024-06-24T09:19:22,ACC00008201,ATM,678.45,-71569.1,GBP,Restaurant
TXN0000010317,2024-05-22T04:06:30,ACC00001135,Debit,204.51,-71773.61,EUR,Amazon
TXN0000010318,2024-09-21T07:02:17,ACC00004990,Transfer,958.84,-70814.77,GBP,Target
TXN0000010319,2024-01-29T13:37:35,ACC00004299,ATM,1512.88,-72327.65,EUR,Amazon
TXN0000010320,2024-06-02T08:13:37,ACC00007188,Transfer,139.26,-72188.39,USD,Starbucks
TXN0000010321,2024-01-28T20:41:04,ACC00008836,Debit,410.41,-72598.8,USD,Starbucks
TXN0000010322,2024-08-13T13:53:23,ACC00004239,Transfer,1388.49,-71210.31,USD,Online Store
TXN0000010323,2024-02-20T18:55:20,ACC00003070,ATM,1455.06,-72665.37,GBP,Restaurant
TXN0000010324,2024-06-21T06:16:59,ACC00008531,Debit,252.78,-72918.15,EUR,Starbucks
TXN0000010325,2024-08-31T20:13:00,ACC00008870,Debit,843.19,-73761.34,USD,Shell
TXN0000010326,2024-04-02T19:46:31,ACC00003950,ATM,1153.02,-74914.36,JPY,Online Store
TXN0000010327,2024-11-10T01:07:48,ACC00009427,Debit,265.82,-75180.18,EUR,Target
TXN0000010328,2024-03-11T18:47:31,ACC00004530,Credit,1167.65,-74012.53,USD,Starbucks
TXN0000010329,2024-08-11T14:43:52,ACC00009688,Debit,1491.11,-75503.64,GBP,Starbucks
TXN0000010330,2024-03-02T23:18:56,ACC00003784,Transfer,427.38,-75076.26,EUR,Shell
TXN0000010331,2024-09-22T00:17:33,ACC00005396,ATM,1107.51,-76183.77,GBP,Walmart
TXN0000010332,2024-01-26T22:12:14,ACC00005034,Credit,782.09,-75401.68,USD,Target
TXN0000010333,2024-07-06T14:35:58,ACC00009750,Payment,1711.46,-77113.14,EUR,Amazon
TXN0000010334,2024-07-26T05:12:09,ACC00002434,Payment,708.67,-77821.81,EUR,Restaurant
TXN0000010335,2024-03-10T00:45:38,ACC00004826,Debit,598.29,-78420.1,EUR,Amazon
TXN0000010336,2024-07-29T23:53:12,ACC00007495,Transfer,39.25,-78380.85,JPY,Restaurant
TXN0000010337,2024-01-19T06:27:37,ACC00008505,Debit,1438.66,-79819.51,GBP,Online Store
TXN0000010338,2024-07-31T16:46:44,ACC00002779,Credit,325.53,-79493.98,JPY,Walmart
TXN0000010339,2024-03-17T20:38:02,ACC00004965,Debit,1246.12,-80740.1,EUR,Amazon
TXN0000010340,2024-04-26T05:14:47,ACC00005871,ATM,1034.17,-81774.27,EUR,Online Store
TXN0000010341,2024-01-07T23:04:00,ACC00006875,ATM,242.99,-82017.26,EUR,Shell
TXN0000010342,2024-05-13T08:48:41,ACC00006742,Debit,1976.97,-83994.23,GBP,Online Store
TXN0000010343,2024-11-20T17:08:24,ACC00007077,Payment,69.14,-84063.37,GBP,Target
TXN0000010344,2024-06-27T02:59:38,ACC00005288,Credit,784.27,-83279.1,EUR,Target
TXN0000010345,2024-04-06T11:26:46,ACC00008703,Payment,1157.08,-84436.18,GBP,Amazon
TXN0000010346,2024-10-04T00:13:41,ACC00001625,Payment,12.11,-84448.29,EUR,Online Store
TXN0000010347,2024-12-15T17:48:56,ACC00000527,Debit,330.73,-84779.02,USD,Walmart
TXN0000010348,2024-09-14T06:53:54,ACC00003325,ATM,182.37,-84961.39,JPY,Online Store
TXN0000010349,2024-10-05T14:38:28,ACC00005676,Debit,1834.96,-86796.35,GBP,Shell
TXN0000010350,2024-04-03T23:13:00,ACC00001741,Credit,1807.3,-84989.05,USD,Starbucks
TXN0000010351,2024-01-31T06:18:25,ACC00008280,Debit,518.45,-85507.5,USD,Amazon
TXN0000010352,2024-02-11T02:24:52,ACC00005884,ATM,1605.27,-87112.77,EUR,Amazon
TXN0000010353,2024-10-25T19:04:24,ACC00009350,Payment,1982.54,-89095.31,JPY,Shell
TXN0000010354,2024-08-28T22:46:08,ACC00003507,Credit,1175.34,-87919.97,GBP,Starbucks
TXN0000010355,2024-04-25T10:31:35,ACC00003218,Payment,1753.53,-89673.5,JPY,Target
TXN0000010356,2024-06-17T23:20:39,ACC00003252,Payment,1395.52,-91069.02,EUR,Walmart
TXN0000010357,2024-12-04T00:05:22,ACC00000713,Transfer,40.42,-91028.6,EUR,Walmart
TXN0000010358,2024-10-25T06:34:55,ACC00000146,Debit,1399.9,-92428.5,JPY,Target
TXN0000010359,2024-11-06T14:35:41,ACC00003835,Debit,298.5,-92727.0,JPY,Shell
TXN0000010360,2024-11-08T19:25:45,ACC00003100,ATM,563.28,-93290.28,EUR,Online Store
TXN0000010361,2024-01-21T07:17:44,ACC00007289,Credit,738.14,-92552.14,GBP,Amazon
TXN0000010362,2024-04-22T14:54:38,ACC00000524,Transfer,1897.39,-90654.75,JPY,Amazon
TXN0000010363,2024-10-23T13:44:55,ACC00000272,Debit,1885.45,-92540.2,GBP,Target
TXN0000010364,2024-10-21T02:03:22,ACC00003550,Debit,1425.2,-93965.4,USD,Target
TXN0000010365,2024-10-29T00:14:39,ACC00004732,ATM,361.78,-94327.18,EUR,Starbucks
TXN0000010366,2024-10-28T15:20:41,ACC00001059,Transfer,303.62,-94023.56,EUR,Restaurant
TXN0000010367,2024-07-16T04:17:40,ACC00002881,ATM,612.52,-94636.08,GBP,Amazon
TXN0000010368,2024-12-07T10:50:31,ACC00007169,Debit,1487.87,-96123.95,EUR,Starbucks
TXN0000010369,2024-03-19T17:53:24,ACC00004364,ATM,485.86,-96609.81,JPY,Target
TXN0000010370,2024-07-26T06:35:31,ACC00003869,Debit,751.39,-97361.2,EUR,Starbucks
TXN0000010371,2024-04-14T03:20:52,ACC00002302,Payment,130.35,-97491.55,EUR,Target
TXN0000010372,2024-09-03T04:31:07,ACC00006423,Debit,740.11,-98231.66,JPY,Amazon
TXN0000010373,2024-06-16T02:52:08,ACC00004860,Payment,1761.28,-99992.94,USD,Restaurant
TXN0000010374,2024-01-28T14:57:33,ACC00000385,Debit,193.68,-100186.62,USD,Online Store
TXN0000010375,2024-07-07T15:51:02,ACC00003524,ATM,1263.51,-101450.13,EUR,Target
TXN0000010376,2024-10-01T13:27:43,ACC00006511,Payment,1236.01,-102686.14,GBP,Online Store
TXN0000010377,2024-04-10T18:26:17,ACC00001223,Debit,342.46,-103028.6,JPY,Walmart
TXN0000010378,2024-08-06T19:20:03,ACC00001210,Payment,1277.7,-104306.3,GBP,Walmart
TXN0000010379,2024-08-05T17:10:55,ACC00006779,Transfer,344.65,-103961.65,JPY,Shell
TXN0000010380,2024-09-23T17:12:29,ACC00006032,Payment,1489.66,-105451.31,USD,Restaurant
TXN0000010381,2024-04-06T18:01:15,ACC00007403,Payment,186.84,-105638.15,GBP,Amazon
TXN0000010382,2024-03-15T12:47:59,ACC00004831,Debit,619.47,-106257.62,USD,Restaurant
TXN0000010383,2024-04-12T05:12:01,ACC00007145,Debit,1200.27,-107457.89,JPY,Online Store
TXN0000010384,2024-09-02T18:23:18,ACC00005469,ATM,1441.88,-108899.77,EUR,Online Store
TXN0000010385,2024-05-31T14:37:36,ACC00004641,Payment,1248.38,-110148.15,USD,Grocery
TXN0000010386,2024-11-18T07:54:11,ACC00001786,Transfer,555.23,-109592.92,JPY,Grocery
TXN0000010387,2024-06-09T05:44:50,ACC00006364,ATM,1628.56,-111221.48,USD,Amazon
TXN0000010388,2024-07-28T00:50:12,ACC00001866,ATM,1739.8,-112961.28,USD,Amazon
TXN0000010389,2024-08-27T12:06:22,ACC00009796,ATM,1729.43,-114690.71,GBP,Walmart
TXN0000010390,2024-08-22T15:05:14,ACC00009924,Payment,235.78,-114926.49,JPY,Target
TXN0000010391,2024-11-13T04:11:12,ACC00006878,Credit,1454.93,-113471.56,EUR,Target
TXN0000010392,2024-06-28T19:13:18,ACC00006675,Credit,560.33,-112911.23,JPY,Walmart
TXN0000010393,2024-05-14T12:10:21,ACC00001476,Credit,236.73,-112674.5,EUR,Shell
TXN0000010394,2024-03-02T21:16:09,ACC00006766,Transfer,653.36,-112021.14,EUR,Starbucks
TXN0000010395,2024-06-28T17:50:02,ACC00004598,Payment,336.58,-112357.72,USD,Starbucks
TXN0000010396,2024-11-08T04:00:03,ACC00008686,Payment,12.33,-112370.05,EUR,Amazon
TXN0000010397,2024-05-31T11:22:26,ACC00009377,Credit,1786.17,-110583.88,JPY,Amazon
TXN0000010398,2024-12-01T21:14:47,ACC00001946,ATM,246.93,-110830.81,GBP,Starbucks
TXN0000010399,2024-03-22T00:33:52,ACC00001601,Transfer,744.43,-110086.38,JPY,Target
TXN0000010400,2024-11-16T14:15:33,ACC00000642,Debit,1797.22,-111883.6,EUR,Shell
TXN0000010401,2024-11-02T23:54:49,ACC00001354,Debit,185.79,-112069.39,JPY,Online Store
TXN0000010402,2024-05-21T13:45:59,ACC00007237,ATM,1839.15,-113908.54,USD,Walmart
TXN0000010403,2024-08-03T22:24:54,ACC00007480,Transfer,595.65,-113312.89,JPY,Target
TXN0000010404,2024-06-15T22:17:29,ACC00006467,Credit,298.2,-113014.69,JPY,Amazon
TXN0000010405,2024-12-25T04:34:22,ACC00007634,Transfer,1057.24,-111957.45,JPY,Walmart
TXN0000010406,2024-09-04T21:32:30,ACC00005487,Transfer,968.94,-110988.51,USD,Restaurant
TXN0000010407,2024-08-24T20:13:26,ACC00006334,Payment,939.2,-111927.71,EUR,Amazon
TXN0000010408,2024-04-17T01:39:38,ACC00005513,Transfer,1052.59,-110875.12,GBP,Online Store
TXN0000010409,2024-07-22T14:35:37,ACC00000915,Payment,1312.68,-112187.8,GBP,Grocery
TXN0000010410,2024-01-30T00:19:38,ACC00001149,Payment,1289.91,-113477.71,USD,Online Store
TXN0000010411,2024-08-19T19:17:07,ACC00003716,Transfer,405.36,-113072.35,GBP,Shell
TXN0000010412,2024-03-31T18:00:01,ACC00002251,Payment,596.79,-113669.14,USD,Grocery
TXN0000010413,2024-10-16T18:20:53,ACC00006458,ATM,1416.4,-115085.54,EUR,Walmart
TXN0000010414,2024-12-07T13:39:31,ACC00006777,Credit,1143.24,-113942.3,EUR,Grocery
TXN0000010415,2024-10-14T23:55:28,ACC00009684,ATM,375.34,-114317.64,JPY,Restaurant
TXN0000010416,2024-10-19T03:22:12,ACC00006619,Debit,389.45,-114707.09,USD,Walmart
TXN0000010417,2024-05-06T20:52:47,ACC00005105,Debit,273.49,-114980.58,USD,Walmart
TXN0000010418,2024-04-29T11:21:07,ACC00006362,Transfer,171.09,-114809.49,GBP,Grocery
TXN0000010419,2024-01-02T18:18:06,ACC00000838,Transfer,569.19,-114240.3,JPY,Amazon
TXN0000010420,2024-02-04T09:31:52,ACC00009132,Transfer,46.39,-114193.91,GBP,Starbucks
TXN0000010421,2024-07-27T10:02:42,ACC00005099,Payment,1979.18,-116173.09,EUR,Target
TXN0000010422,2024-12-14T11:59:38,ACC00004374,Transfer,437.91,-115735.18,GBP,Grocery
TXN0000010423,2024-01-02T18:35:15,ACC00007404,Transfer,1625.36,-114109.82,GBP,Amazon
TXN0000010424,2024-03-20T03:40:08,ACC00005471,Debit,1681.51,-115791.33,USD,Shell
TXN0000010425,2024-07-28T06:06:06,ACC00007523,Credit,701.96,-115089.37,USD,Target
TXN0000010426,2024-09-26T12:08:19,ACC00000638,Payment,1338.27,-116427.64,EUR,Grocery
TXN0000010427,2024-02-29T00:04:44,ACC00006663,Payment,1111.02,-117538.66,USD,Target
TXN0000010428,2024-04-13T06:39:03,ACC00001165,ATM,1350.55,-118889.21,EUR,Target
TXN0000010429,2024-03-01T01:26:02,ACC00005625,Payment,290.4,-119179.61,USD,Target
TXN0000010430,2024-07-22T15:56:27,ACC00007949,Debit,1619.15,-120798.76,GBP,Restaurant
TXN0000010431,2024-04-12T07:51:02,ACC00008910,Payment,130.44,-120929.2,GBP,Walmart
TXN0000010432,2024-12-26T07:44:31,ACC00009077,Transfer,1153.74,-119775.46,USD,Target
TXN0000010433,2024-08-14T19:56:13,ACC00004008,Payment,534.91,-120310.37,USD,Online Store
TXN0000010434,2024-11-01T22:32:10,ACC00007964,Payment,407.22,-120717.59,JPY,Amazon
TXN0000010435,2024-12-24T09:40:15,ACC00001082,Credit,343.24,-120374.35,JPY,Walmart
TXN0000010436,2024-04-20T15:51:13,ACC00006613,ATM,557.87,-120932.22,JPY,Amazon
TXN0000010437,2024-03-03T14:02:04,ACC00004766,Debit,1343.85,-122276.07,EUR,Restaurant
TXN0000010438,2024-11-19T06:39:20,ACC00006944,Payment,241.78,-122517.85,JPY,Restaurant
TXN0000010439,2024-03-01T07:14:49,ACC00002369,Debit,1103.03,-123620.88,JPY,Grocery
TXN0000010440,2024-12-03T03:50:06,ACC00004330,Credit,107.65,-123513.23,GBP,Online Store
TXN0000010441,2024-09-11T02:33:37,ACC00006985,ATM,969.64,-124482.87,USD,Grocery
TXN0000010442,2024-06-14T18:33:23,ACC00006426,Credit,1175.84,-123307.03,EUR,Target
TXN0000010443,2024-11-10T04:26:13,ACC00002216,ATM,1682.42,-124989.45,GBP,Restaurant
TXN0000010444,2024-12-06T05:18:21,ACC00001961,ATM,1894.05,-126883.5,GBP,Shell
TXN0000010445,2024-06-25T06:05:07,ACC00004191,Transfer,134.7,-126748.8,EUR,Starbucks
TXN0000010446,2024-04-26T17:34:18,ACC00005736,Payment,369.6,-127118.4,USD,Amazon
TXN0000010447,2024-01-24T09:04:41,ACC00007660,Debit,163.05,-127281.45,JPY,Target
TXN0000010448,2024-05-08T20:04:22,ACC00006627,Debit,1355.21,-128636.66,GBP,Amazon
TXN0000010449,2024-07-29T19:31:54,ACC00008272,Transfer,670.59,-127966.07,GBP,Target
TXN0000010450,2024-02-10T02:53:17,ACC00006713,Transfer,1239.84,-126726.23,EUR,Restaurant
TXN0000010451,2024-06-16T18:54:16,ACC00002802,ATM,1268.99,-127995.22,GBP,Walmart
TXN0000010452,2024-10-19T16:49:34,ACC00001135,Debit,1020.73,-129015.95,GBP,Shell
TXN0000010453,2024-05-22T22:28:42,ACC00005565,ATM,416.75,-129432.7,USD,Grocery
TXN0000010454,2024-03-05T01:41:30,ACC00000331,Debit,983.33,-130416.03,EUR,Restaurant
TXN0000010455,2024-12-02T13:02:50,ACC00003262,Transfer,607.8,-129808.23,USD,Online Store
TXN0000010456,2024-02-06T09:07:45,ACC00006970,Debit,98.51,-129906.74,JPY,Grocery
TXN0000010457,2024-11-17T11:12:47,ACC00000172,Debit,1073.18,-130979.92,JPY,Starbucks
TXN0000010458,2024-09-02T03:33:18,ACC00003101,Debit,245.0,-131224.92,EUR,Online Store
TXN0000010459,2024-04-16T10:35:26,ACC00006247,Transfer,1833.79,-129391.13,JPY,Shell
TXN0000010460,2024-02-20T06:51:53,ACC00005872,Debit,1631.01,-131022.14,EUR,Starbucks
TXN0000010461,2024-11-15T20:08:29,ACC00000899,Payment,1513.39,-132535.53,EUR,Amazon
TXN0000010462,2024-12-03T21:49:12,ACC00009201,ATM,1670.09,-134205.62,GBP,Walmart
TXN0000010463,2024-08-21T17:00:13,ACC00001770,ATM,255.19,-134460.81,JPY,Grocery
TXN0000010464,2024-02-27T18:51:33,ACC00005863,Credit,111.8,-134349.01,EUR,Walmart
TXN0000010465,2024-07-23T11:56:09,ACC00004751,Payment,893.23,-135242.24,EUR,Grocery
TXN0000010466,2024-04-24T10:14:26,ACC00007160,Transfer,1558.3,-133683.94,GBP,Shell
TXN0000010467,2024-12-25T19:53:04,ACC00001676,Transfer,1682.94,-132001.0,JPY,Target
TXN0000010468,2024-03-10T11:16:49,ACC00001318,Transfer,402.73,-131598.27,USD,Online Store
TXN0000010469,2024-11-19T07:20:07,ACC00008369,Transfer,1016.26,-130582.01,EUR,Target
TXN0000010470,2024-12-10T15:47:58,ACC00005962,Payment,1957.8,-132539.81,USD,Restaurant
TXN0000010471,2024-06-19T00:57:32,ACC00004156,Credit,1090.13,-131449.68,JPY,Target
TXN0000010472,2024-07-16T12:24:44,ACC00006468,Debit,1809.44,-133259.12,JPY,Grocery
TXN0000010473,2024-09-26T20:53:11,ACC00000464,ATM,848.18,-134107.3,JPY,Shell
TXN0000010474,2024-03-09T21:57:46,ACC00002192,ATM,1786.76,-135894.06,GBP,Amazon
TXN0000010475,2024-09-09T00:15:42,ACC00004256,Debit,728.94,-136623.0,JPY,Walmart
TXN0000010476,2024-11-25T11:18:51,ACC00006838,Payment,1575.59,-138198.59,EUR,Online Store
TXN0000010477,2024-09-18T00:17:13,ACC00002987,Transfer,61.36,-138137.23,EUR,Walmart
TXN0000010478,2024-05-15T04:00:12,ACC00009911,Payment,1590.06,-139727.29,JPY,Grocery
TXN0000010479,2024-12-01T10:39:15,ACC00009293,ATM,1452.86,-141180.15,JPY,Grocery
TXN0000010480,2024-03-11T11:39:13,ACC00002033,Debit,1731.23,-142911.38,JPY,Shell
TXN0000010481,2024-11-26T09:09:08,ACC00005814,Payment,455.57,-143366.95,USD,Grocery
TXN0000010482,2024-01-02T15:12:57,ACC00008885,Debit,1828.62,-145195.57,USD,Restaurant
TXN0000010483,2024-04-28T01:23:39,ACC00003222,Transfer,773.6,-144421.97,USD,Starbucks
TXN0000010484,2024-12-28T16:35:02,ACC00000216,Payment,661.05,-145083.02,JPY,Grocery
TXN0000010485,2024-03-16T08:36:10,ACC00004860,Transfer,1022.17,-144060.85,EUR,Starbucks
TXN0000010486,2024-09-15T13:10:55,ACC00001324,ATM,383.65,-144444.5,JPY,Restaurant
TXN0000010487,2024-08-24T02:26:53,ACC00007152,Payment,1290.57,-145735.07,USD,Target
TXN0000010488,2024-10-27T14:27:31,ACC00000567,ATM,713.41,-146448.48,EUR,Online Store
TXN0000010489,2024-11-23T00:26:00,ACC00000457,Debit,1722.17,-148170.65,USD,Restaurant
TXN0000010490,2024-03-03T04:57:44,ACC00007335,Payment,344.56,-148515.21,GBP,Grocery
TXN0000010491,2024-06-28T23:52:01,ACC00009862,ATM,246.82,-148762.03,EUR,Online Store
TXN0000010492,2024-10-15T08:04:11,ACC00005275,Transfer,1674.75,-147087.28,JPY,Starbucks
TXN0000010493,2024-01-29T23:45:20,ACC00009145,Credit,312.19,-146775.09,JPY,Grocery
TXN0000010494,2024-02-25T02:48:42,ACC00002925,Payment,84.54,-146859.63,USD,Walmart
TXN0000010495,2024-01-03T15:04:19,ACC00003668,Payment,1594.15,-148453.78,EUR,Shell
TXN0000010496,2024-07-23T18:32:04,ACC00007567,Credit,54.27,-148399.51,GBP,Grocery
TXN0000010497,2024-06-07T04:17:00,ACC00002796,Debit,1205.05,-149604.56,EUR,Amazon
TXN0000010498,2024-04-19T23:37:12,ACC00004428,Payment,1466.13,-151070.69,GBP,Starbucks
TXN0000010499,2024-11-13T20:08:38,ACC00001180,Transfer,937.13,-150133.56,EUR,Amazon
TXN0000010500,2024-02-21T21:34:43,ACC00005810,ATM,1691.64,-151825.2,GBP,Walmart
TXN0000010501,2024-08-24T07:48:59,ACC00006938,Payment,1966.41,-153791.61,USD,Walmart
TXN0000010502,2024-01-19T22:39:44,ACC00001470,Payment,1978.54,-155770.15,USD,Target
TXN0000010503,2024-07-02T11:44:38,ACC00001403,ATM,202.77,-155972.92,EUR,Walmart
TXN0000010504,2024-03-31T13:46:57,ACC00006160,Credit,1083.56,-154889.36,GBP,Starbucks
TXN0000010505,2024-01-16T23:55:57,ACC00003485,Payment,1061.35,-155950.71,USD,Target
TXN0000010506,2024-08-23T23:26:10,ACC00005083,Credit,600.64,-155350.07,JPY,Restaurant
TXN0000010507,2024-01-01T10:42:31,ACC00009959,Debit,1423.06,-156773.13,GBP,Shell
TXN0000010508,2024-04-30T12:03:23,ACC00008684,Debit,1385.59,-158158.72,EUR,Amazon
TXN0000010509,2024-11-27T12:51:39,ACC00000124,ATM,999.2,-159157.92,GBP,Online Store
TXN0000010510,2024-09-04T19:11:06,ACC00009065,Transfer,628.39,-158529.53,USD,Online Store
TXN0000010511,2024-01-17T15:17:56,ACC00008624,Debit,1692.72,-160222.25,GBP,Amazon
TXN0000010512,2024-02-24T20:18:03,ACC00000225,Debit,732.77,-160955.02,GBP,Walmart
TXN0000010513,2024-10-29T02:58:18,ACC00006979,Payment,716.67,-161671.69,JPY,Grocery
TXN0000010514,2024-05-22T02:36:01,ACC00002125,Transfer,1861.83,-159809.86,EUR,Starbucks
TXN0000010515,2024-10-25T01:57:16,ACC00009933,ATM,1995.2,-161805.06,EUR,Target
TXN0000010516,2024-03-09T19:26:19,ACC00009997,Transfer,1918.24,-159886.82,JPY,Target
TXN0000010517,2024-02-11T18:06:27,ACC00005382,Transfer,1408.35,-158478.47,GBP,Online Store
TXN0000010518,2024-10-18T09:42:40,ACC00003200,Debit,703.53,-159182.0,USD,Grocery
TXN0000010519,2024-09-02T08:02:03,ACC00009570,ATM,619.68,-159801.68,EUR,Target
TXN0000010520,2024-09-09T01:01:22,ACC00006867,Transfer,315.55,-159486.13,EUR,Amazon
TXN0000010521,2024-05-26T19:22:30,ACC00004806,ATM,1720.98,-161207.11,GBP,Online Store
TXN0000010522,2024-11-21T13:28:18,ACC00003635,Credit,1278.29,-159928.82,USD,Walmart
TXN0000010523,2024-12-24T02:27:55,ACC00001651,Credit,1976.46,-157952.36,JPY,Amazon
TXN0000010524,2024-11-10T15:35:26,ACC00002081,Payment,484.3,-158436.66,JPY,Restaurant
TXN0000010525,2024-10-25T15:10:38,ACC00001578,Credit,279.05,-158157.61,USD,Online Store
TXN0000010526,2024-10-13T12:33:44,ACC00005329,Debit,692.05,-158849.66,GBP,Restaurant
TXN0000010527,2024-03-26T20:19:46,ACC00002256,Transfer,203.68,-158645.98,JPY,Online Store
TXN0000010528,2024-05-07T09:50:51,ACC00003009,Debit,1142.72,-159788.7,USD,Starbucks
TXN0000010529,2024-08-26T09:30:51,ACC00004097,Transfer,373.42,-159415.28,JPY,Walmart
TXN0000010530,2024-03-24T04:21:42,ACC00003675,ATM,995.64,-160410.92,EUR,Online Store
TXN0000010531,2024-03-26T02:04:41,ACC00002061,Payment,606.72,-161017.64,JPY,Restaurant
TXN0000010532,2024-03-11T07:18:50,ACC00006136,ATM,503.97,-161521.61,EUR,Shell
TXN0000010533,2024-11-30T07:32:23,ACC00002008,Transfer,127.8,-161393.81,JPY,Amazon
TXN0000010534,2024-10-21T06:10:33,ACC00008779,ATM,1224.91,-162618.72,JPY,Shell
TXN0000010535,2024-06-17T08:03:24,ACC00008054,Debit,970.85,-163589.57,GBP,Grocery
TXN0000010536,2024-06-30T19:25:11,ACC00007020,Payment,202.78,-163792.35,USD,Shell
TXN0000010537,2024-05-04T16:55:34,ACC00002811,Credit,753.04,-163039.31,EUR,Grocery
TXN0000010538,2024-10-08T12:55:03,ACC00003034,Credit,703.77,-162335.54,GBP,Shell
TXN0000010539,2024-12-05T02:12:30,ACC00009078,ATM,626.37,-162961.91,USD,Grocery
TXN0000010540,2024-07-28T14:30:05,ACC00004520,Transfer,1171.88,-161790.03,EUR,Amazon
TXN0000010541,2024-01-25T05:56:01,ACC00004654,Transfer,1675.38,-160114.65,USD,Grocery
TXN0000010542,2024-01-09T05:23:55,ACC00008283,ATM,391.92,-160506.57,GBP,Shell
TXN0000010543,2024-03-25T12:32:04,ACC00000402,Credit,1543.39,-158963.18,USD,Amazon
TXN0000010544,2024-05-29T08:43:16,ACC00008360,Debit,1032.19,-159995.37,GBP,Amazon
TXN0000010545,2024-12-29T07:34:27,ACC00009978,Debit,313.5,-160308.87,JPY,Amazon
TXN0000010546,2024-09-21T00:58:29,ACC00009406,ATM,663.73,-160972.6,GBP,Target
TXN0000010547,2024-04-12T18:03:54,ACC00004645,ATM,743.69,-161716.29,JPY,Shell
TXN0000010548,2024-02-20T10:38:26,ACC00009160,Debit,1134.13,-162850.42,EUR,Grocery
TXN0000010549,2024-09-20T13:47:36,ACC00002729,Debit,533.06,-163383.48,EUR,Online Store
TXN0000010550,2024-10-28T17:10:36,ACC00008819,Credit,1990.85,-161392.63,JPY,Amazon
TXN0000010551,2024-12-01T17:25:54,ACC00007730,Credit,148.97,-161243.66,GBP,Restaurant
TXN0000010552,2024-03-29T05:18:24,ACC00006310,Credit,698.53,-160545.13,GBP,Target
TXN0000010553,2024-10-02T09:03:44,ACC00008082,Credit,1396.61,-159148.52,EUR,Online Store
TXN0000010554,2024-07-31T03:19:30,ACC00001277,ATM,956.2,-160104.72,EUR,Walmart
TXN0000010555,2024-09-23T08:13:59,ACC00003301,Transfer,1426.03,-158678.69,USD,Target
TXN0000010556,2024-12-03T08:05:59,ACC00007683,ATM,1947.87,-160626.56,USD,Starbucks
TXN0000010557,2024-02-13T00:55:52,ACC00009033,Transfer,205.85,-160420.71,GBP,Walmart
TXN0000010558,2024-02-28T18:43:07,ACC00008210,Transfer,1109.75,-159310.96,GBP,Online Store
TXN0000010559,2024-08-28T00:00:53,ACC00005346,ATM,1790.77,-161101.73,USD,Online Store
TXN0000010560,2024-08-09T14:21:32,ACC00007669,Debit,862.87,-161964.6,EUR,Restaurant
TXN0000010561,2024-03-03T20:50:16,ACC00002982,ATM,1398.39,-163362.99,USD,Amazon
TXN0000010562,2024-12-21T06:36:46,ACC00007987,Credit,743.67,-162619.32,EUR,Shell
TXN0000010563,2024-01-09T23:32:45,ACC00000248,Payment,641.96,-163261.28,USD,Restaurant
TXN0000010564,2024-05-26T00:58:54,ACC00000413,Payment,470.97,-163732.25,EUR,Online Store
TXN0000010565,2024-02-15T23:17:53,ACC00008703,Payment,998.71,-164730.96,EUR,Grocery
TXN0000010566,2024-05-21T13:50:43,ACC00004797,Payment,395.03,-165125.99,JPY,Target
TXN0000010567,2024-10-07T00:17:19,ACC00004253,ATM,173.71,-165299.7,EUR,Grocery
TXN0000010568,2024-06-23T05:53:39,ACC00009001,ATM,715.88,-166015.58,JPY,Amazon
TXN0000010569,2024-07-21T08:52:08,ACC00001236,Payment,1286.31,-167301.89,JPY,Amazon
TXN0000010570,2024-08-08T01:08:23,ACC00004905,Transfer,1811.2,-165490.69,JPY,Starbucks
TXN0000010571,2024-08-02T10:05:42,ACC00006943,ATM,332.54,-165823.23,USD,Target
TXN0000010572,2024-05-13T07:34:29,ACC00006931,Debit,1667.25,-167490.48,USD,Restaurant
TXN0000010573,2024-10-28T01:09:16,ACC00000938,Transfer,981.65,-166508.83,GBP,Restaurant
TXN0000010574,2024-04-26T03:40:34,ACC00005141,Transfer,1414.24,-165094.59,EUR,Shell
TXN0000010575,2024-06-29T06:35:04,ACC00004166,Transfer,353.86,-164740.73,GBP,Grocery
TXN0000010576,2024-11-10T10:06:34,ACC00002993,Debit,1602.56,-166343.29,EUR,Online Store
TXN0000010577,2024-02-17T13:50:00,ACC00007955,ATM,1546.26,-167889.55,EUR,Grocery
TXN0000010578,2024-01-01T22:58:27,ACC00004984,ATM,1089.57,-168979.12,USD,Amazon
TXN0000010579,2024-01-31T08:43:41,ACC00002423,Credit,412.64,-168566.48,GBP,Starbucks
TXN0000010580,2024-12-13T12:37:50,ACC00001597,ATM,285.11,-168851.59,EUR,Walmart
TXN0000010581,2024-09-02T21:44:45,ACC00002794,Transfer,1117.82,-167733.77,JPY,Restaurant
TXN0000010582,2024-03-07T14:01:59,ACC00007648,Debit,949.53,-168683.3,EUR,Target
TXN0000010583,2024-05-15T09:56:07,ACC00004924,Transfer,1441.53,-167241.77,GBP,Amazon
TXN0000010584,2024-01-05T12:00:24,ACC00009484,ATM,1053.82,-168295.59,JPY,Restaurant
TXN0000010585,2024-08-17T22:41:20,ACC00005248,Debit,941.91,-169237.5,USD,Online Store
TXN0000010586,2024-05-14T01:54:55,ACC00003730,Transfer,1967.26,-167270.24,EUR,Restaurant
TXN0000010587,2024-06-07T16:44:49,ACC00006562,Payment,185.37,-167455.61,USD,Target
TXN0000010588,2024-11-29T13:46:07,ACC00005723,Debit,1325.69,-168781.3,JPY,Walmart
TXN0000010589,2024-09-10T01:32:04,ACC00004025,Credit,1414.81,-167366.49,EUR,Walmart
TXN0000010590,2024-01-15T15:00:32,ACC00003089,Transfer,568.36,-166798.13,GBP,Starbucks
TXN0000010591,2024-02-11T23:02:16,ACC00008852,Transfer,1868.6,-164929.53,EUR,Amazon
TXN0000010592,2024-10-05T20:33:40,ACC00004944,ATM,572.89,-165502.42,JPY,Walmart
TXN0000010593,2024-05-18T13:40:45,ACC00006219,Transfer,264.63,-165237.79,GBP,Restaurant
TXN0000010594,2024-02-15T08:34:21,ACC00005586,Credit,622.14,-164615.65,JPY,Target
TXN0000010595,2024-05-07T09:48:04,ACC00005994,Payment,113.29,-164728.94,EUR,Amazon
TXN0000010596,2024-02-12T00:38:24,ACC00002913,Transfer,1671.62,-163057.32,USD,Target
TXN0000010597,2024-06-13T14:26:56,ACC00005438,Debit,1215.2,-164272.52,GBP,Online Store
TXN0000010598,2024-03-05T13:44:59,ACC00001895,Credit,338.3,-163934.22,EUR,Online Store
TXN0000010599,2024-01-17T13:26:33,ACC00008579,Credit,1417.22,-162517.0,EUR,Grocery
TXN0000010600,2024-12-10T19:12:56,ACC00005995,Transfer,1410.31,-161106.69,GBP,Walmart
TXN0000010601,2024-01-26T19:45:46,ACC00003016,Payment,1747.16,-162853.85,USD,Grocery
TXN0000010602,2024-07-21T13:58:08,ACC00002526,ATM,638.44,-163492.29,JPY,Starbucks
TXN0000010603,2024-03-31T12:40:29,ACC00003143,ATM,392.67,-163884.96,EUR,Online Store
TXN0000010604,2024-08-15T22:41:22,ACC00007696,ATM,1639.16,-165524.12,EUR,Target
TXN0000010605,2024-08-17T01:03:58,ACC00007307,Transfer,215.04,-165309.08,EUR,Starbucks
TXN0000010606,2024-11-11T02:18:25,ACC00006411,ATM,1944.1,-167253.18,GBP,Online Store
TXN0000010607,2024-10-16T11:13:49,ACC00004382,ATM,889.78,-168142.96,EUR,Starbucks
TXN0000010608,2024-08-13T19:19:22,ACC00006997,ATM,240.9,-168383.86,GBP,Starbucks
TXN0000010609,2024-12-03T02:08:49,ACC00000841,Credit,120.45,-168263.41,USD,Walmart
TXN0000010610,2024-09-15T03:36:00,ACC00002894,Credit,412.41,-167851.0,GBP,Grocery
TXN0000010611,2024-10-17T06:55:01,ACC00007429,Debit,478.65,-168329.65,USD,Grocery
TXN0000010612,2024-11-26T20:14:12,ACC00002540,Transfer,987.35,-167342.3,EUR,Target
TXN0000010613,2024-09-24T06:38:57,ACC00001273,ATM,1499.4,-168841.7,EUR,Amazon
TXN0000010614,2024-08-11T22:15:59,ACC00000770,Transfer,584.21,-168257.49,GBP,Shell
TXN0000010615,2024-11-13T15:27:55,ACC00000625,Debit,1151.25,-169408.74,GBP,Online Store
TXN0000010616,2024-09-22T16:07:27,ACC00007417,Credit,1164.45,-168244.29,USD,Starbucks
TXN0000010617,2024-05-24T00:32:02,ACC00001757,ATM,1141.38,-169385.67,EUR,Starbucks
TXN0000010618,2024-11-05T08:53:14,ACC00004503,Payment,1349.57,-170735.24,EUR,Target
TXN0000010619,2024-12-20T19:54:01,ACC00002892,Transfer,1907.07,-168828.17,GBP,Grocery
TXN0000010620,2024-07-03T13:47:54,ACC00006937,ATM,1108.68,-169936.85,GBP,Online Store
TXN0000010621,2024-12-07T23:31:05,ACC00003406,Payment,311.53,-170248.38,EUR,Restaurant
TXN0000010622,2024-11-25T13:50:18,ACC00002747,Debit,1724.24,-171972.62,JPY,Walmart
TXN0000010623,2024-06-05T18:38:42,ACC00003232,ATM,995.96,-172968.58,JPY,Grocery
TXN0000010624,2024-06-11T06:59:53,ACC00005126,Transfer,754.24,-172214.34,USD,Grocery
TXN0000010625,2024-04-15T09:11:47,ACC00006444,Transfer,1247.03,-170967.31,USD,Starbucks
TXN0000010626,2024-01-18T05:36:26,ACC00001959,ATM,1732.65,-172699.96,GBP,Shell
TXN0000010627,2024-06-12T23:13:19,ACC00004275,ATM,674.71,-173374.67,EUR,Walmart
TXN0000010628,2024-12-30T22:48:18,ACC00006463,Transfer,508.24,-172866.43,USD,Shell
TXN0000010629,2024-02-01T14:16:09,ACC00003291,Transfer,173.3,-172693.13,JPY,Online Store
TXN0000010630,2024-07-23T06:54:38,ACC00007225,Payment,149.42,-172842.55,USD,Shell
TXN0000010631,2024-10-13T03:19:57,ACC00006569,Transfer,1773.78,-171068.77,EUR,Shell
TXN0000010632,2024-12-21T01:51:27,ACC00006387,Payment,519.92,-171588.69,JPY,Restaurant
TXN0000010633,2024-03-04T00:23:12,ACC00002324,Credit,651.31,-170937.38,EUR,Grocery
TXN0000010634,2024-11-18T01:43:55,ACC00001006,ATM,385.92,-171323.3,JPY,Amazon
TXN0000010635,2024-10-05T00:30:12,ACC00004851,Transfer,698.07,-170625.23,EUR,Online Store
TXN0000010636,2024-02-18T16:02:44,ACC00002713,Credit,424.76,-170200.47,EUR,Restaurant
TXN0000010637,2024-04-06T21:09:13,ACC00001025,Debit,1677.08,-171877.55,USD,Shell
TXN0000010638,2024-08-14T16:29:50,ACC00008454,Transfer,1215.13,-170662.42,JPY,Online Store
TXN0000010639,2024-01-15T22:34:28,ACC00000891,Payment,783.11,-171445.53,GBP,Restaurant
TXN0000010640,2024-06-01T15:36:32,ACC00008988,Transfer,39.37,-171406.16,GBP,Walmart
TXN0000010641,2024-06-30T05:54:52,ACC00001847,Transfer,183.11,-171223.05,EUR,Starbucks
TXN0000010642,2024-01-20T10:49:32,ACC00002032,Debit,1907.51,-173130.56,USD,Grocery
TXN0000010643,2024-07-31T02:08:02,ACC00003096,Payment,23.04,-173153.6,USD,Starbucks
TXN0000010644,2024-01-12T00:17:10,ACC00006428,Credit,680.61,-172472.99,USD,Target
TXN0000010645,2024-07-07T07:07:22,ACC00002510,Payment,155.87,-172628.86,USD,Online Store
TXN0000010646,2024-03-24T21:29:03,ACC00006816,Payment,700.07,-173328.93,USD,Restaurant
TXN0000010647,2024-02-18T22:08:28,ACC00007501,Transfer,1564.53,-171764.4,USD,Shell
TXN0000010648,2024-09-22T14:05:43,ACC00009933,ATM,1350.47,-173114.87,EUR,Starbucks
TXN0000010649,2024-04-04T22:04:34,ACC00003301,Payment,229.4,-173344.27,GBP,Online Store
TXN0000010650,2024-10-10T04:24:10,ACC00006529,Debit,252.47,-173596.74,JPY,Restaurant
TXN0000010651,2024-08-10T21:37:33,ACC00008916,Debit,1670.01,-175266.75,USD,Restaurant
TXN0000010652,2024-11-09T22:58:03,ACC00003800,Debit,1640.82,-176907.57,USD,Online Store
TXN0000010653,2024-03-24T06:06:32,ACC00001490,ATM,457.58,-177365.15,JPY,Shell
TXN0000010654,2024-04-29T06:03:32,ACC00007357,Credit,796.13,-176569.02,EUR,Restaurant
TXN0000010655,2024-07-15T03:57:42,ACC00000408,Credit,1913.2,-174655.82,USD,Starbucks
TXN0000010656,2024-06-02T21:07:56,ACC00003584,Transfer,1660.59,-172995.23,GBP,Grocery
TXN0000010657,2024-04-24T04:18:38,ACC00006453,Debit,1131.81,-174127.04,EUR,Target
TXN0000010658,2024-08-01T19:04:30,ACC00002541,Credit,1092.19,-173034.85,GBP,Amazon
TXN0000010659,2024-05-05T23:49:27,ACC00000491,Credit,1139.18,-171895.67,EUR,Amazon
TXN0000010660,2024-03-05T23:10:01,ACC00005606,Payment,1390.37,-173286.04,EUR,Starbucks
TXN0000010661,2024-12-17T01:26:04,ACC00003740,ATM,568.04,-173854.08,GBP,Grocery
TXN0000010662,2024-08-12T17:42:13,ACC00007072,Credit,617.26,-173236.82,GBP,Walmart
TXN0000010663,2024-10-06T05:38:22,ACC00000856,Credit,807.02,-172429.8,GBP,Restaurant
TXN0000010664,2024-03-06T05:35:59,ACC00000606,ATM,1261.04,-173690.84,JPY,Walmart
TXN0000010665,2024-10-01T07:00:58,ACC00004173,Credit,1210.68,-172480.16,JPY,Shell
TXN0000010666,2024-05-15T20:06:12,ACC00005695,Debit,557.44,-173037.6,EUR,Walmart
TXN0000010667,2024-05-10T07:19:38,ACC00000675,Credit,1968.14,-171069.46,GBP,Restaurant
TXN0000010668,2024-04-05T20:25:05,ACC00005065,Transfer,913.6,-170155.86,GBP,Walmart
TXN0000010669,2024-07-26T14:53:18,ACC00002506,Debit,472.5,-170628.36,GBP,Restaurant
TXN0000010670,2024-10-27T06:01:02,ACC00003555,ATM,835.17,-171463.53,JPY,Starbucks
TXN0000010671,2024-11-20T00:13:14,ACC00006410,Transfer,1323.21,-170140.32,EUR,Online Store
TXN0000010672,2024-10-10T20:04:18,ACC00006837,Debit,1355.84,-171496.16,USD,Target
TXN0000010673,2024-05-04T06:55:45,ACC00007543,ATM,228.59,-171724.75,JPY,Restaurant
TXN0000010674,2024-07-15T20:06:51,ACC00002465,Debit,1194.84,-172919.59,EUR,Shell
TXN0000010675,2024-09-09T03:56:11,ACC00005077,Credit,434.83,-172484.76,EUR,Target
TXN0000010676,2024-03-23T08:33:24,ACC00006415,Payment,247.16,-172731.92,JPY,Grocery
TXN0000010677,2024-08-12T15:21:53,ACC00005588,Credit,1909.76,-170822.16,JPY,Starbucks
TXN0000010678,2024-11-19T06:44:58,ACC00009043,Credit,1123.9,-169698.26,GBP,Shell
TXN0000010679,2024-05-25T12:37:40,ACC00009636,Payment,1959.68,-171657.94,GBP,Online Store
TXN0000010680,2024-11-20T04:14:11,ACC00008072,Credit,1439.85,-170218.09,EUR,Online Store
TXN0000010681,2024-02-05T22:24:17,ACC00008365,Credit,1246.41,-168971.68,USD,Restaurant
TXN0000010682,2024-08-03T04:40:03,ACC00008764,Payment,1308.73,-170280.41,EUR,Online Store
TXN0000010683,2024-09-25T14:18:04,ACC00005313,Debit,754.09,-171034.5,USD,Grocery
TXN0000010684,2024-03-22T03:47:44,ACC00003667,Credit,1537.13,-169497.37,EUR,Restaurant
TXN0000010685,2024-10-08T12:53:52,ACC00003302,Debit,1495.96,-170993.33,USD,Walmart
TXN0000010686,2024-01-25T19:21:36,ACC00000366,Debit,1988.07,-172981.4,USD,Walmart
TXN0000010687,2024-09-14T05:48:24,ACC00004857,Debit,1159.47,-174140.87,GBP,Walmart
TXN0000010688,2024-07-21T19:25:56,ACC00007311,Transfer,1587.84,-172553.03,USD,Shell
TXN0000010689,2024-02-10T01:40:49,ACC00002402,Credit,1334.27,-171218.76,EUR,Shell
TXN0000010690,2024-01-03T14:34:09,ACC00007455,Transfer,1416.43,-169802.33,USD,Shell
TXN0000010691,2024-07-11T18:43:47,ACC00003396,Credit,1339.81,-168462.52,EUR,Walmart
TXN0000010692,2024-07-05T18:58:55,ACC00005220,Debit,1722.73,-170185.25,USD,Online Store
TXN0000010693,2024-12-18T16:51:49,ACC00005583,Credit,1514.67,-168670.58,USD,Amazon
TXN0000010694,2024-11-08T13:15:37,ACC00001342,Debit,1988.04,-170658.62,GBP,Grocery
TXN0000010695,2024-01-12T23:27:07,ACC00006323,Credit,1840.31,-168818.31,EUR,Starbucks
TXN0000010696,2024-12-28T04:54:14,ACC00003052,Credit,1448.13,-167370.18,GBP,Target
TXN0000010697,2024-05-18T21:06:44,ACC00005241,Payment,277.33,-167647.51,GBP,Amazon
TXN0000010698,2024-08-19T10:59:16,ACC00000162,Credit,373.92,-167273.59,EUR,Grocery
TXN0000010699,2024-12-19T00:48:29,ACC00000610,Debit,472.86,-167746.45,GBP,Online Store
TXN0000010700,2024-06-12T15:31:45,ACC00001538,Debit,1899.18,-169645.63,GBP,Walmart
TXN0000010701,2024-06-24T16:34:58,ACC00008859,Transfer,1844.94,-167800.69,EUR,Walmart
TXN0000010702,2024-08-05T10:47:06,ACC00001042,ATM,1834.46,-169635.15,GBP,Online Store
TXN0000010703,2024-03-16T19:11:44,ACC00004446,Payment,1353.54,-170988.69,JPY,Starbucks
TXN0000010704,2024-02-25T02:44:37,ACC00004931,Transfer,249.76,-170738.93,GBP,Target
TXN0000010705,2024-11-30T02:30:58,ACC00005847,Debit,1984.48,-172723.41,EUR,Starbucks
TXN0000010706,2024-06-21T13:07:08,ACC00009646,ATM,1150.64,-173874.05,EUR,Amazon
TXN0000010707,2024-04-13T22:18:40,ACC00001141,Transfer,1262.9,-172611.15,JPY,Grocery
TXN0000010708,2024-05-14T12:25:28,ACC00006156,ATM,258.14,-172869.29,USD,Shell
TXN0000010709,2024-11-29T13:07:51,ACC00003220,ATM,351.94,-173221.23,USD,Amazon
TXN0000010710,2024-12-07T00:13:07,ACC00000567,ATM,273.07,-173494.3,JPY,Amazon
TXN0000010711,2024-02-20T04:21:43,ACC00008824,Debit,457.0,-173951.3,EUR,Starbucks
TXN0000010712,2024-05-04T17:26:07,ACC00004282,Transfer,866.93,-173084.37,GBP,Restaurant
TXN0000010713,2024-07-18T13:48:12,ACC00003841,Debit,1333.34,-174417.71,JPY,Restaurant
TXN0000010714,2024-07-30T12:24:55,ACC00007615,ATM,1282.55,-175700.26,USD,Target
TXN0000010715,2024-03-04T19:39:42,ACC00000854,Transfer,1591.24,-174109.02,EUR,Walmart
TXN0000010716,2024-09-08T21:45:23,ACC00009755,Payment,1167.55,-175276.57,JPY,Target
TXN0000010717,2024-06-19T20:39:42,ACC00008006,ATM,91.68,-175368.25,JPY,Target
TXN0000010718,2024-12-25T16:10:05,ACC00003641,Debit,573.52,-175941.77,GBP,Online Store
TXN0000010719,2024-03-28T07:28:09,ACC00004175,Transfer,822.48,-175119.29,GBP,Target
TXN0000010720,2024-08-26T12:03:34,ACC00006771,Payment,1667.12,-176786.41,GBP,Target
TXN0000010721,2024-03-09T03:50:21,ACC00003491,Transfer,1073.08,-175713.33,JPY,Online Store
TXN0000010722,2024-02-27T02:11:53,ACC00009848,Credit,970.59,-174742.74,JPY,Starbucks
TXN0000010723,2024-08-28T21:26:08,ACC00009986,ATM,530.91,-175273.65,USD,Amazon
TXN0000010724,2024-10-24T08:20:55,ACC00005594,Transfer,1140.28,-174133.37,USD,Shell
TXN0000010725,2024-10-11T03:51:11,ACC00006011,Transfer,1542.48,-172590.89,USD,Online Store
TXN0000010726,2024-12-16T08:15:09,ACC00002003,Debit,1587.18,-174178.07,JPY,Shell
TXN0000010727,2024-07-05T04:42:31,ACC00005198,Payment,807.42,-174985.49,EUR,Online Store
TXN0000010728,2024-07-18T19:11:32,ACC00005781,Credit,1249.85,-173735.64,JPY,Amazon
TXN0000010729,2024-04-27T23:03:49,ACC00006780,Transfer,33.62,-173702.02,USD,Grocery
TXN0000010730,2024-03-02T14:04:10,ACC00001127,Transfer,717.68,-172984.34,GBP,Amazon
TXN0000010731,2024-04-22T02:59:37,ACC00004261,ATM,1146.07,-174130.41,USD,Shell
TXN0000010732,2024-08-01T09:25:20,ACC00007727,ATM,1259.26,-175389.67,USD,Walmart
TXN0000010733,2024-02-05T01:01:47,ACC00003777,Credit,1854.24,-173535.43,EUR,Shell
TXN0000010734,2024-07-16T13:38:28,ACC00006912,Payment,1610.91,-175146.34,JPY,Starbucks
TXN0000010735,2024-08-13T02:37:06,ACC00006150,Credit,166.89,-174979.45,EUR,Walmart
TXN0000010736,2024-09-12T02:08:28,ACC00007674,Payment,198.94,-175178.39,GBP,Shell
TXN0000010737,2024-01-29T08:16:49,ACC00005310,Credit,779.59,-174398.8,GBP,Shell
TXN0000010738,2024-08-31T17:46:34,ACC00008443,Debit,1394.49,-175793.29,USD,Online Store
TXN0000010739,2024-03-10T07:14:07,ACC00007926,ATM,1126.3,-176919.59,GBP,Online Store
TXN0000010740,2024-04-16T19:46:58,ACC00003370,Payment,638.63,-177558.22,USD,Restaurant
TXN0000010741,2024-07-19T07:22:59,ACC00000940,Transfer,490.1,-177068.12,GBP,Online Store
TXN0000010742,2024-12-22T21:19:42,ACC00005882,ATM,359.18,-177427.3,USD,Restaurant
TXN0000010743,2024-07-31T09:53:01,ACC00002842,Transfer,1283.57,-176143.73,EUR,Grocery
TXN0000010744,2024-09-28T20:02:04,ACC00003047,Credit,718.66,-175425.07,GBP,Restaurant
TXN0000010745,2024-01-31T19:15:49,ACC00005712,Payment,1979.55,-177404.62,USD,Amazon
TXN0000010746,2024-04-02T02:32:12,ACC00006042,Payment,1828.66,-179233.28,JPY,Target
TXN0000010747,2024-03-21T07:12:20,ACC00003581,Credit,1321.67,-177911.61,JPY,Target
TXN0000010748,2024-12-11T10:21:25,ACC00008259,Credit,1074.77,-176836.84,GBP,Online Store
TXN0000010749,2024-08-30T19:19:37,ACC00007378,ATM,566.3,-177403.14,USD,Shell
TXN0000010750,2024-03-10T09:10:32,ACC00003167,Credit,1535.46,-175867.68,EUR,Restaurant
TXN0000010751,2024-06-04T03:23:03,ACC00000598,Debit,1631.19,-177498.87,EUR,Restaurant
TXN0000010752,2024-07-31T01:49:02,ACC00005307,Credit,688.75,-176810.12,EUR,Online Store
TXN0000010753,2024-05-29T05:00:41,ACC00002609,Credit,851.19,-175958.93,GBP,Starbucks
TXN0000010754,2024-08-24T02:12:11,ACC00003324,ATM,1297.41,-177256.34,USD,Online Store
TXN0000010755,2024-12-27T17:13:11,ACC00007964,Transfer,1737.32,-175519.02,USD,Amazon
TXN0000010756,2024-05-15T04:38:40,ACC00009752,ATM,1586.75,-177105.77,JPY,Shell
TXN0000010757,2024-10-29T12:17:14,ACC00005601,Transfer,1855.92,-175249.85,USD,Starbucks
TXN0000010758,2024-10-09T05:04:35,ACC00009021,Credit,1616.63,-173633.22,EUR,Grocery
TXN0000010759,2024-07-05T10:46:15,ACC00007701,Credit,135.29,-173497.93,USD,Shell
TXN0000010760,2024-12-05T06:00:59,ACC00003526,Credit,905.91,-172592.02,USD,Online Store
TXN0000010761,2024-09-15T16:19:11,ACC00000357,Debit,927.38,-173519.4,JPY,Grocery
TXN0000010762,2024-06-06T06:35:36,ACC00007897,Payment,1037.13,-174556.53,EUR,Amazon
TXN0000010763,2024-10-07T20:24:43,ACC00000152,Transfer,1424.14,-173132.39,GBP,Starbucks
TXN0000010764,2024-06-03T13:01:14,ACC00008497,Debit,941.96,-174074.35,JPY,Walmart
TXN0000010765,2024-03-23T19:09:33,ACC00006685,ATM,1434.39,-175508.74,EUR,Restaurant
TXN0000010766,2024-03-06T00:16:19,ACC00002912,Credit,539.59,-174969.15,EUR,Starbucks
TXN0000010767,2024-09-03T05:46:18,ACC00003209,Payment,561.65,-175530.8,USD,Starbucks
TXN0000010768,2024-07-07T14:13:45,ACC00005470,Credit,1065.36,-174465.44,GBP,Grocery
TXN0000010769,2024-01-29T23:02:42,ACC00009074,Debit,621.63,-175087.07,JPY,Online Store
TXN0000010770,2024-04-26T02:48:53,ACC00008238,Credit,829.2,-174257.87,JPY,Online Store
TXN0000010771,2024-10-10T12:01:53,ACC00006346,Payment,434.67,-174692.54,EUR,Restaurant
TXN0000010772,2024-03-19T22:13:38,ACC00002576,Payment,1712.36,-176404.9,EUR,Shell
TXN0000010773,2024-01-29T07:46:24,ACC00009557,ATM,1017.0,-177421.9,GBP,Grocery
TXN0000010774,2024-04-15T05:44:06,ACC00009830,ATM,509.42,-177931.32,EUR,Online Store
TXN0000010775,2024-04-26T23:59:21,ACC00008509,Debit,101.62,-178032.94,JPY,Shell
TXN0000010776,2024-08-22T15:45:18,ACC00004381,Transfer,363.32,-177669.62,USD,Amazon
TXN0000010777,2024-06-01T13:48:54,ACC00002380,Credit,150.97,-177518.65,GBP,Online Store
TXN0000010778,2024-10-05T19:48:54,ACC00009463,Transfer,751.45,-176767.2,GBP,Amazon
TXN0000010779,2024-02-17T22:49:53,ACC00003923,Payment,574.07,-177341.27,JPY,Target
TXN0000010780,2024-05-05T23:17:59,ACC00009255,Debit,849.7,-178190.97,GBP,Grocery
TXN0000010781,2024-11-17T13:28:02,ACC00009451,Payment,1407.75,-179598.72,GBP,Grocery
TXN0000010782,2024-06-19T18:25:35,ACC00000863,Debit,1857.89,-181456.61,GBP,Online Store
TXN0000010783,2024-02-28T19:45:28,ACC00009679,Transfer,134.5,-181322.11,JPY,Shell
TXN0000010784,2024-11-01T00:28:20,ACC00001118,Payment,1611.45,-182933.56,EUR,Grocery
TXN0000010785,2024-11-05T10:06:47,ACC00007589,Credit,577.99,-182355.57,EUR,Target
TXN0000010786,2024-09-13T18:20:30,ACC00001124,Transfer,1729.64,-180625.93,USD,Starbucks
TXN0000010787,2024-01-07T09:46:36,ACC00003404,Payment,1853.62,-182479.55,EUR,Target
TXN0000010788,2024-09-23T22:23:01,ACC00005557,Debit,1760.93,-184240.48,USD,Amazon
TXN0000010789,2024-01-19T22:12:48,ACC00006780,ATM,701.65,-184942.13,JPY,Grocery
TXN0000010790,2024-07-09T20:25:07,ACC00008356,Payment,1652.81,-186594.94,GBP,Grocery
TXN0000010791,2024-03-07T05:16:55,ACC00006885,Transfer,457.49,-186137.45,USD,Walmart
TXN0000010792,2024-05-11T05:06:50,ACC00007500,Transfer,774.84,-185362.61,JPY,Amazon
TXN0000010793,2024-05-05T15:37:50,ACC00000717,Credit,1591.28,-183771.33,GBP,Restaurant
TXN0000010794,2024-03-19T13:38:28,ACC00001739,Debit,1939.1,-185710.43,JPY,Starbucks
TXN0000010795,2024-02-18T06:42:39,ACC00005408,Credit,1844.61,-183865.82,EUR,Shell
TXN0000010796,2024-11-20T12:02:17,ACC00000635,ATM,1610.04,-185475.86,JPY,Amazon
TXN0000010797,2024-01-28T23:20:50,ACC00008022,ATM,276.33,-185752.19,GBP,Walmart
TXN0000010798,2024-09-24T15:50:40,ACC00003401,Payment,1992.86,-187745.05,JPY,Amazon
TXN0000010799,2024-02-03T04:18:20,ACC00006750,Debit,1584.45,-189329.5,USD,Target
TXN0000010800,2024-07-12T00:51:44,ACC00003993,Payment,1071.59,-190401.09,USD,Starbucks
TXN0000010801,2024-02-11T01:36:40,ACC00003772,Transfer,320.24,-190080.85,EUR,Target
TXN0000010802,2024-02-20T02:15:31,ACC00001041,Payment,463.35,-190544.2,USD,Restaurant
TXN0000010803,2024-06-21T20:34:34,ACC00004271,Debit,86.58,-190630.78,USD,Grocery
TXN0000010804,2024-08-04T10:10:51,ACC00007113,Credit,643.68,-189987.1,EUR,Walmart
TXN0000010805,2024-08-10T16:44:12,ACC00001812,ATM,1545.2,-191532.3,USD,Walmart
TXN0000010806,2024-01-18T20:46:28,ACC00006310,Transfer,801.31,-190730.99,USD,Amazon
TXN0000010807,2024-11-29T23:33:23,ACC00005677,Transfer,835.01,-189895.98,JPY,Shell
TXN0000010808,2024-11-16T10:32:05,ACC00001297,Debit,1911.11,-191807.09,EUR,Grocery
TXN0000010809,2024-05-01T05:26:36,ACC00003486,Transfer,1072.57,-190734.52,GBP,Shell
TXN0000010810,2024-10-01T11:01:05,ACC00005290,Debit,232.06,-190966.58,USD,Amazon
TXN0000010811,2024-02-03T01:07:18,ACC00002025,ATM,297.21,-191263.79,EUR,Shell
TXN0000010812,2024-10-01T04:07:56,ACC00003169,Debit,1207.52,-192471.31,EUR,Walmart
TXN0000010813,2024-03-04T11:25:24,ACC00000596,Debit,1811.58,-194282.89,JPY,Restaurant
TXN0000010814,2024-07-29T18:17:13,ACC00006828,Credit,620.02,-193662.87,GBP,Online Store
TXN0000010815,2024-01-20T07:39:49,ACC00004143,Credit,1297.08,-192365.79,USD,Target
TXN0000010816,2024-09-19T12:14:48,ACC00001632,Transfer,685.33,-191680.46,GBP,Restaurant
TXN0000010817,2024-01-18T01:19:11,ACC00002188,Payment,664.34,-192344.8,USD,Grocery
TXN0000010818,2024-05-09T01:07:17,ACC00000462,ATM,1467.61,-193812.41,GBP,Walmart
TXN0000010819,2024-11-08T10:11:10,ACC00003327,ATM,1589.57,-195401.98,JPY,Grocery
TXN0000010820,2024-02-14T22:49:17,ACC00006523,Transfer,1184.62,-194217.36,GBP,Starbucks
TXN0000010821,2024-09-03T07:03:32,ACC00004387,Payment,1458.04,-195675.4,JPY,Restaurant
TXN0000010822,2024-01-07T22:39:11,ACC00007179,Transfer,1521.11,-194154.29,JPY,Target
TXN0000010823,2024-11-21T10:26:19,ACC00006416,ATM,657.55,-194811.84,USD,Amazon
TXN0000010824,2024-06-03T14:25:19,ACC00000127,Payment,1118.09,-195929.93,JPY,Amazon
TXN0000010825,2024-07-30T16:28:56,ACC00007633,Debit,395.67,-196325.6,GBP,Walmart
TXN0000010826,2024-01-21T00:32:32,ACC00003404,Debit,1440.76,-197766.36,EUR,Online Store
TXN0000010827,2024-04-08T05:55:43,ACC00009396,Transfer,894.0,-196872.36,GBP,Target
TXN0000010828,2024-08-28T11:56:14,ACC00006117,Credit,892.91,-195979.45,USD,Target
TXN0000010829,2024-09-06T14:27:27,ACC00007291,Debit,232.6,-196212.05,EUR,Walmart
TXN0000010830,2024-06-18T09:35:58,ACC00003055,Debit,622.71,-196834.76,EUR,Shell
TXN0000010831,2024-11-28T19:40:32,ACC00000423,Payment,884.74,-197719.5,JPY,Online Store
TXN0000010832,2024-05-08T21:33:18,ACC00008256,Payment,1856.59,-199576.09,GBP,Walmart
TXN0000010833,2024-03-23T21:07:55,ACC00007547,Credit,447.11,-199128.98,EUR,Restaurant
TXN0000010834,2024-01-15T15:50:40,ACC00009834,Payment,1451.92,-200580.9,JPY,Shell
TXN0000010835,2024-03-19T14:37:58,ACC00004989,Payment,10.55,-200591.45,USD,Target
TXN0000010836,2024-09-07T09:48:53,ACC00003994,Debit,179.99,-200771.44,USD,Walmart
TXN0000010837,2024-09-05T15:02:01,ACC00009763,Transfer,619.83,-200151.61,EUR,Walmart
TXN0000010838,2024-12-22T08:56:44,ACC00005462,ATM,207.97,-200359.58,USD,Restaurant
TXN0000010839,2024-12-15T16:25:31,ACC00005287,Payment,1098.82,-201458.4,USD,Shell
TXN0000010840,2024-01-21T18:29:59,ACC00001252,Credit,1845.7,-199612.7,USD,Walmart
TXN0000010841,2024-03-05T00:43:06,ACC00003982,ATM,755.28,-200367.98,JPY,Amazon
TXN0000010842,2024-04-03T12:14:14,ACC00007863,Credit,1666.75,-198701.23,USD,Grocery
TXN0000010843,2024-01-11T16:12:41,ACC00005049,Transfer,944.65,-197756.58,USD,Target
TXN0000010844,2024-07-09T05:46:13,ACC00000430,Credit,457.36,-197299.22,USD,Shell
TXN0000010845,2024-11-15T03:55:53,ACC00006554,Transfer,757.26,-196541.96,GBP,Walmart
TXN0000010846,2024-02-15T02:17:55,ACC00003993,ATM,1646.7,-198188.66,JPY,Grocery
TXN0000010847,2024-03-18T10:40:13,ACC00009577,ATM,388.37,-198577.03,JPY,Target
TXN0000010848,2024-09-07T20:08:31,ACC00004233,Debit,1029.13,-199606.16,EUR,Restaurant
TXN0000010849,2024-06-02T00:39:35,ACC00006878,Payment,529.93,-200136.09,GBP,Restaurant
TXN0000010850,2024-06-30T09:52:10,ACC00006013,ATM,29.0,-200165.09,EUR,Restaurant
TXN0000010851,2024-04-29T20:22:22,ACC00006004,Payment,268.88,-200433.97,EUR,Online Store
TXN0000010852,2024-07-07T07:45:36,ACC00000161,ATM,1372.42,-201806.39,GBP,Restaurant
TXN0000010853,2024-12-20T08:24:52,ACC00005207,Debit,834.86,-202641.25,EUR,Amazon
TXN0000010854,2024-08-23T09:19:35,ACC00001986,Debit,1884.01,-204525.26,EUR,Amazon
TXN0000010855,2024-04-13T15:16:50,ACC00008689,Transfer,839.18,-203686.08,GBP,Amazon
TXN0000010856,2024-10-16T23:28:43,ACC00005728,Payment,1907.79,-205593.87,JPY,Online Store
TXN0000010857,2024-04-27T14:28:11,ACC00006760,Transfer,1145.99,-204447.88,JPY,Amazon
TXN0000010858,2024-07-06T20:51:44,ACC00001305,ATM,372.0,-204819.88,EUR,Restaurant
TXN0000010859,2024-07-25T17:36:30,ACC00001458,ATM,1651.19,-206471.07,GBP,Grocery
TXN0000010860,2024-07-18T07:44:09,ACC00000011,ATM,1794.79,-208265.86,USD,Walmart
TXN0000010861,2024-09-16T21:46:13,ACC00009632,ATM,76.22,-208342.08,JPY,Target
TXN0000010862,2024-12-28T20:19:19,ACC00000104,Transfer,1547.71,-206794.37,JPY,Restaurant
TXN0000010863,2024-10-22T06:20:27,ACC00003209,Transfer,963.32,-205831.05,GBP,Target
TXN0000010864,2024-09-09T18:41:27,ACC00001632,Transfer,842.79,-204988.26,EUR,Grocery
TXN0000010865,2024-04-08T11:36:14,ACC00002486,Debit,1422.43,-206410.69,USD,Amazon
TXN0000010866,2024-03-19T14:59:41,ACC00005127,Debit,232.59,-206643.28,EUR,Restaurant
TXN0000010867,2024-03-03T13:40:33,ACC00006983,Credit,90.46,-206552.82,USD,Amazon
TXN0000010868,2024-02-29T13:06:23,ACC00000446,Transfer,701.04,-205851.78,JPY,Starbucks
TXN0000010869,2024-06-03T21:46:21,ACC00007805,Transfer,265.3,-205586.48,EUR,Restaurant
TXN0000010870,2024-12-14T03:15:36,ACC00001648,Debit,390.15,-205976.63,EUR,Starbucks
TXN0000010871,2024-08-05T04:48:09,ACC00006456,Payment,1241.21,-207217.84,EUR,Grocery
TXN0000010872,2024-05-05T04:50:32,ACC00008537,Credit,134.04,-207083.8,EUR,Shell
TXN0000010873,2024-12-30T09:44:18,ACC00006824,Credit,362.48,-206721.32,JPY,Target
TXN0000010874,2024-03-19T13:50:03,ACC00000103,Debit,1281.26,-208002.58,GBP,Online Store
TXN0000010875,2024-01-11T05:17:55,ACC00004569,Debit,524.3,-208526.88,GBP,Walmart
TXN0000010876,2024-10-25T23:38:26,ACC00002349,ATM,185.3,-208712.18,GBP,Starbucks
TXN0000010877,2024-03-27T15:36:17,ACC00002007,Credit,414.94,-208297.24,JPY,Online Store
TXN0000010878,2024-09-13T14:07:24,ACC00000878,Credit,840.46,-207456.78,USD,Starbucks
TXN0000010879,2024-03-29T15:24:53,ACC00005696,Payment,1670.56,-209127.34,JPY,Restaurant
TXN0000010880,2024-12-06T21:07:02,ACC00006486,Credit,1532.28,-207595.06,JPY,Shell
TXN0000010881,2024-08-11T21:38:43,ACC00003632,ATM,172.13,-207767.19,EUR,Target
TXN0000010882,2024-03-26T21:11:30,ACC00004490,ATM,342.3,-208109.49,GBP,Shell
TXN0000010883,2024-01-02T16:09:22,ACC00005492,ATM,1251.67,-209361.16,EUR,Shell
TXN0000010884,2024-07-19T16:50:25,ACC00007350,Credit,223.9,-209137.26,USD,Target
TXN0000010885,2024-11-06T14:13:30,ACC00003122,ATM,485.31,-209622.57,GBP,Walmart
TXN0000010886,2024-05-30T21:48:03,ACC00005452,Credit,1269.68,-208352.89,EUR,Starbucks
TXN0000010887,2024-11-02T00:55:13,ACC00008433,Transfer,839.81,-207513.08,USD,Restaurant
TXN0000010888,2024-08-12T22:24:02,ACC00002947,Debit,1782.46,-209295.54,USD,Starbucks
TXN0000010889,2024-05-09T12:03:46,ACC00006784,Transfer,1103.04,-208192.5,EUR,Target
TXN0000010890,2024-07-12T15:41:00,ACC00008128,Payment,1195.41,-209387.91,USD,Amazon
TXN0000010891,2024-12-04T21:53:10,ACC00009419,Debit,840.44,-210228.35,EUR,Amazon
TXN0000010892,2024-02-15T01:57:11,ACC00007054,Payment,188.77,-210417.12,USD,Restaurant
TXN0000010893,2024-06-12T14:31:36,ACC00005513,Debit,1384.33,-211801.45,GBP,Starbucks
TXN0000010894,2024-12-15T17:50:04,ACC00009859,Transfer,363.82,-211437.63,GBP,Shell
TXN0000010895,2024-11-08T13:14:03,ACC00001029,Debit,711.87,-212149.5,JPY,Grocery
TXN0000010896,2024-07-24T02:33:18,ACC00004278,Payment,782.65,-212932.15,GBP,Online Store
TXN0000010897,2024-11-06T12:21:23,ACC00003438,ATM,201.0,-213133.15,JPY,Starbucks
TXN0000010898,2024-08-21T18:02:17,ACC00008153,Debit,1791.03,-214924.18,GBP,Amazon
TXN0000010899,2024-05-30T23:14:49,ACC00008475,Debit,1268.94,-216193.12,JPY,Restaurant
TXN0000010900,2024-10-25T13:44:00,ACC00009225,ATM,587.16,-216780.28,EUR,Target
TXN0000010901,2024-01-04T10:34:52,ACC00001392,Credit,732.49,-216047.79,USD,Grocery
TXN0000010902,2024-04-12T13:12:57,ACC00008676,Payment,952.21,-217000.0,JPY,Shell
TXN0000010903,2024-04-14T15:27:30,ACC00009804,Debit,1744.46,-218744.46,USD,Target
TXN0000010904,2024-12-19T20:50:42,ACC00006527,Payment,758.63,-219503.09,GBP,Target
TXN0000010905,2024-03-30T12:28:22,ACC00005464,Transfer,1318.9,-218184.19,USD,Walmart
TXN0000010906,2024-12-22T02:06:54,ACC00007412,Debit,1771.62,-219955.81,GBP,Amazon
TXN0000010907,2024-07-21T17:54:22,ACC00002256,Credit,1235.41,-218720.4,EUR,Online Store
TXN0000010908,2024-01-23T09:51:03,ACC00005803,Debit,774.82,-219495.22,GBP,Shell
TXN0000010909,2024-05-20T16:49:39,ACC00004874,Payment,1997.38,-221492.6,GBP,Online Store
TXN0000010910,2024-07-29T18:41:11,ACC00002584,Transfer,1696.4,-219796.2,EUR,Grocery
TXN0000010911,2024-01-25T22:02:06,ACC00002278,Debit,207.62,-220003.82,USD,Grocery
TXN0000010912,2024-02-27T15:01:26,ACC00001475,Credit,158.49,-219845.33,JPY,Target
TXN0000010913,2024-03-26T16:45:03,ACC00000457,ATM,522.91,-220368.24,JPY,Walmart
TXN0000010914,2024-08-15T11:55:18,ACC00000936,Debit,243.03,-220611.27,USD,Online Store
TXN0000010915,2024-02-28T09:42:22,ACC00003844,Credit,1870.06,-218741.21,GBP,Amazon
TXN0000010916,2024-03-31T18:50:01,ACC00000863,Transfer,1365.03,-217376.18,USD,Shell
TXN0000010917,2024-01-14T22:13:25,ACC00008813,Transfer,1259.91,-216116.27,GBP,Online Store
TXN0000010918,2024-12-10T04:36:45,ACC00006394,Transfer,1688.34,-214427.93,GBP,Target
TXN0000010919,2024-01-24T04:22:11,ACC00006155,ATM,1171.75,-215599.68,JPY,Restaurant
TXN0000010920,2024-05-03T07:12:46,ACC00007732,Transfer,112.88,-215486.8,GBP,Shell
TXN0000010921,2024-04-15T21:41:39,ACC00006533,Payment,340.19,-215826.99,USD,Restaurant
TXN0000010922,2024-08-30T10:07:09,ACC00008521,Transfer,82.22,-215744.77,JPY,Amazon
TXN0000010923,2024-12-14T14:05:02,ACC00004782,Payment,269.23,-216014.0,GBP,Shell
TXN0000010924,2024-04-17T11:49:06,ACC00005623,ATM,1738.02,-217752.02,EUR,Walmart
TXN0000010925,2024-03-05T23:09:37,ACC00007132,Transfer,1847.51,-215904.51,JPY,Walmart
TXN0000010926,2024-03-22T16:49:11,ACC00000926,Transfer,348.28,-215556.23,GBP,Grocery
TXN0000010927,2024-11-20T04:44:22,ACC00007552,Payment,1156.88,-216713.11,GBP,Walmart
TXN0000010928,2024-02-05T19:05:25,ACC00007853,Transfer,1710.61,-215002.5,USD,Amazon
TXN0000010929,2024-03-17T04:51:10,ACC00001823,ATM,1554.31,-216556.81,JPY,Grocery
TXN0000010930,2024-05-26T21:17:54,ACC00006359,ATM,206.0,-216762.81,USD,Shell
TXN0000010931,2024-10-11T13:03:37,ACC00004374,Payment,957.86,-217720.67,GBP,Walmart
TXN0000010932,2024-07-06T18:00:48,ACC00000852,Transfer,1538.53,-216182.14,USD,Walmart
TXN0000010933,2024-03-03T02:33:10,ACC00005709,ATM,1169.81,-217351.95,JPY,Amazon
TXN0000010934,2024-05-21T23:45:25,ACC00005832,Payment,423.01,-217774.96,USD,Walmart
TXN0000010935,2024-11-28T00:36:46,ACC00002407,Credit,638.87,-217136.09,EUR,Walmart
TXN0000010936,2024-04-12T02:40:16,ACC00000533,Payment,1224.92,-218361.01,USD,Amazon
TXN0000010937,2024-08-12T23:24:27,ACC00004369,Payment,1774.1,-220135.11,JPY,Walmart
TXN0000010938,2024-01-19T22:19:15,ACC00006659,Payment,356.29,-220491.4,GBP,Starbucks
TXN0000010939,2024-11-30T19:13:12,ACC00009278,Credit,1875.51,-218615.89,GBP,Amazon
TXN0000010940,2024-08-23T10:46:28,ACC00008144,Payment,610.04,-219225.93,USD,Target
TXN0000010941,2024-08-07T03:22:15,ACC00009605,Debit,1969.73,-221195.66,GBP,Shell
TXN0000010942,2024-02-04T07:29:13,ACC00002042,ATM,1921.6,-223117.26,JPY,Walmart
TXN0000010943,2024-02-13T02:35:28,ACC00004651,Debit,701.08,-223818.34,JPY,Grocery
TXN0000010944,2024-11-22T08:58:33,ACC00009517,Credit,1856.91,-221961.43,USD,Shell
TXN0000010945,2024-07-20T01:12:05,ACC00008020,ATM,1246.23,-223207.66,USD,Walmart
TXN0000010946,2024-09-11T10:02:39,ACC00002463,Transfer,1169.23,-222038.43,GBP,Target
TXN0000010947,2024-11-12T01:00:39,ACC00003369,ATM,420.37,-222458.8,GBP,Starbucks
TXN0000010948,2024-01-21T18:44:54,ACC00009848,Debit,51.29,-222510.09,USD,Walmart
TXN0000010949,2024-06-13T19:54:01,ACC00001331,Transfer,601.56,-221908.53,EUR,Online Store
TXN0000010950,2024-09-07T18:50:55,ACC00001405,ATM,799.15,-222707.68,GBP,Amazon
TXN0000010951,2024-01-03T04:25:16,ACC00004251,Payment,947.36,-223655.04,JPY,Target
TXN0000010952,2024-12-18T20:25:59,ACC00005393,Transfer,223.94,-223431.1,USD,Walmart
TXN0000010953,2024-07-07T00:17:30,ACC00008185,Transfer,1556.09,-221875.01,JPY,Amazon
TXN0000010954,2024-06-07T09:39:18,ACC00006042,Payment,1629.11,-223504.12,GBP,Shell
TXN0000010955,2024-03-27T22:58:58,ACC00000282,ATM,86.07,-223590.19,USD,Starbucks
TXN0000010956,2024-04-18T10:36:26,ACC00004228,Payment,1071.07,-224661.26,GBP,Grocery
TXN0000010957,2024-10-22T10:58:31,ACC00004221,Debit,1599.94,-226261.2,JPY,Walmart
TXN0000010958,2024-12-20T02:29:44,ACC00007754,Payment,1537.42,-227798.62,JPY,Shell
TXN0000010959,2024-08-29T17:15:54,ACC00007962,Payment,805.86,-228604.48,USD,Starbucks
TXN0000010960,2024-08-14T17:49:45,ACC00001411,Transfer,1816.93,-226787.55,GBP,Shell
TXN0000010961,2024-10-09T01:25:21,ACC00005350,ATM,299.26,-227086.81,JPY,Restaurant
TXN0000010962,2024-01-31T16:41:46,ACC00002554,Payment,1279.89,-228366.7,GBP,Shell
TXN0000010963,2024-03-11T00:08:55,ACC00005666,Payment,339.32,-228706.02,USD,Restaurant
TXN0000010964,2024-02-10T22:08:05,ACC00007841,Payment,1987.52,-230693.54,EUR,Amazon
TXN0000010965,2024-09-20T19:43:01,ACC00009236,Credit,1682.95,-229010.59,EUR,Grocery
TXN0000010966,2024-08-07T03:57:36,ACC00001852,Payment,768.1,-229778.69,GBP,Starbucks
TXN0000010967,2024-09-17T10:57:29,ACC00008435,Transfer,51.69,-229727.0,EUR,Online Store
TXN0000010968,2024-07-03T20:28:04,ACC00009345,Transfer,1791.12,-227935.88,GBP,Walmart
TXN0000010969,2024-11-05T12:23:27,ACC00006640,Payment,85.14,-228021.02,JPY,Walmart
TXN0000010970,2024-12-01T15:00:42,ACC00004206,ATM,153.4,-228174.42,USD,Amazon
TXN0000010971,2024-04-21T05:02:27,ACC00009758,ATM,1136.11,-229310.53,USD,Grocery
TXN0000010972,2024-07-11T07:27:42,ACC00000721,Credit,69.62,-229240.91,EUR,Target
TXN0000010973,2024-03-10T11:53:26,ACC00001715,Credit,636.76,-228604.15,USD,Walmart
TXN0000010974,2024-03-24T06:53:49,ACC00002128,Payment,819.6,-229423.75,JPY,Amazon
TXN0000010975,2024-01-17T17:22:54,ACC00008693,Debit,540.87,-229964.62,JPY,Shell
TXN0000010976,2024-12-04T07:45:22,ACC00004164,Credit,1574.22,-228390.4,JPY,Target
TXN0000010977,2024-06-15T16:27:54,ACC00009028,Credit,1057.89,-227332.51,GBP,Walmart
TXN0000010978,2024-06-02T14:02:46,ACC00002643,Debit,1502.09,-228834.6,JPY,Target
TXN0000010979,2024-01-26T12:23:12,ACC00004375,Debit,1772.29,-230606.89,JPY,Grocery
TXN0000010980,2024-02-05T06:46:46,ACC00002703,Payment,870.79,-231477.68,EUR,Online Store
TXN0000010981,2024-03-29T10:47:45,ACC00002335,Credit,1739.23,-229738.45,GBP,Walmart
TXN0000010982,2024-02-04T07:50:06,ACC00009873,Debit,204.38,-229942.83,JPY,Restaurant
TXN0000010983,2024-12-19T08:43:45,ACC00007605,ATM,1787.05,-231729.88,GBP,Starbucks
TXN0000010984,2024-10-19T13:38:18,ACC00008800,Transfer,721.96,-231007.92,GBP,Restaurant
TXN0000010985,2024-07-26T06:17:23,ACC00001154,ATM,198.17,-231206.09,EUR,Target
TXN0000010986,2024-08-13T07:34:48,ACC00006469,Debit,1646.69,-232852.78,GBP,Starbucks
TXN0000010987,2024-05-03T18:49:41,ACC00002969,Transfer,1148.18,-231704.6,GBP,Restaurant
TXN0000010988,2024-04-24T08:26:30,ACC00005071,Payment,1427.61,-233132.21,USD,Restaurant
TXN0000010989,2024-04-17T21:51:55,ACC00003179,Credit,1361.8,-231770.41,USD,Walmart
TXN0000010990,2024-05-26T21:05:25,ACC00008366,Debit,384.8,-232155.21,EUR,Walmart
TXN0000010991,2024-11-30T13:16:49,ACC00007104,Credit,1725.22,-230429.99,USD,Restaurant
TXN0000010992,2024-04-09T22:07:40,ACC00001524,Payment,185.8,-230615.79,USD,Target
TXN0000010993,2024-05-24T20:34:55,ACC00005185,ATM,397.06,-231012.85,JPY,Amazon
TXN0000010994,2024-10-20T14:48:33,ACC00006382,ATM,840.79,-231853.64,USD,Amazon
TXN0000010995,2024-06-10T14:14:57,ACC00003005,Transfer,1635.2,-230218.44,EUR,Shell
TXN0000010996,2024-07-13T00:32:54,ACC00005322,Transfer,1721.49,-228496.95,EUR,Shell
TXN0000010997,2024-11-11T16:56:04,ACC00003941,Debit,889.57,-229386.52,USD,Walmart
TXN0000010998,2024-04-04T08:17:15,ACC00003050,Payment,881.41,-230267.93,JPY,Amazon
TXN0000010999,2024-09-23T04:07:28,ACC00005914,Transfer,423.54,-229844.39,GBP,Grocery
TXN0000011000,2024-07-05T19:17:27,ACC00004598,Debit,113.65,-229958.04,EUR,Amazon
TXN0000011001,2024-12-10T12:28:09,ACC00009140,Transfer,1166.59,-228791.45,GBP,Starbucks
TXN0000011002,2024-09-26T08:21:16,ACC00007599,Credit,607.75,-228183.7,GBP,Grocery
TXN0000011003,2024-02-13T03:16:58,ACC00008728,Transfer,1616.42,-226567.28,USD,Starbucks
TXN0000011004,2024-02-23T14:46:19,ACC00009685,Payment,412.41,-226979.69,GBP,Target
TXN0000011005,2024-05-17T17:56:08,ACC00001883,Debit,1478.99,-228458.68,JPY,Online Store
TXN0000011006,2024-04-21T05:53:24,ACC00003035,Debit,911.86,-229370.54,GBP,Starbucks
TXN0000011007,2024-02-15T07:25:27,ACC00003653,Payment,1751.1,-231121.64,JPY,Grocery
TXN0000011008,2024-11-06T08:43:25,ACC00004948,Credit,1446.28,-229675.36,GBP,Target
TXN0000011009,2024-10-19T09:13:20,ACC00005162,Payment,1601.55,-231276.91,JPY,Starbucks
TXN0000011010,2024-08-24T09:16:23,ACC00001072,Credit,770.98,-230505.93,GBP,Walmart
TXN0000011011,2024-09-30T08:56:10,ACC00003709,Credit,319.59,-230186.34,USD,Online Store
TXN0000011012,2024-02-27T02:55:58,ACC00003162,ATM,192.07,-230378.41,JPY,Online Store
TXN0000011013,2024-09-16T16:02:11,ACC00005985,ATM,1333.84,-231712.25,GBP,Grocery
TXN0000011014,2024-09-05T16:40:44,ACC00000261,Transfer,180.39,-231531.86,JPY,Starbucks
TXN0000011015,2024-02-04T00:05:23,ACC00008539,Debit,1019.01,-232550.87,JPY,Restaurant
TXN0000011016,2024-02-23T01:39:17,ACC00009813,Payment,369.8,-232920.67,JPY,Restaurant
TXN0000011017,2024-02-13T01:08:20,ACC00008355,ATM,1904.65,-234825.32,JPY,Restaurant
TXN0000011018,2024-03-21T13:27:17,ACC00001485,Transfer,209.91,-234615.41,EUR,Walmart
TXN0000011019,2024-08-28T04:07:36,ACC00000851,Payment,363.36,-234978.77,JPY,Amazon
TXN0000011020,2024-03-27T13:45:06,ACC00006979,ATM,589.84,-235568.61,GBP,Restaurant
TXN0000011021,2024-12-11T14:12:06,ACC00003407,Transfer,771.92,-234796.69,JPY,Walmart
TXN0000011022,2024-06-25T17:12:39,ACC00000117,Debit,1614.76,-236411.45,GBP,Grocery
TXN0000011023,2024-11-29T06:39:52,ACC00001126,Transfer,277.2,-236134.25,JPY,Walmart
TXN0000011024,2024-08-02T14:12:55,ACC00005765,Transfer,1837.33,-234296.92,USD,Grocery
TXN0000011025,2024-11-04T05:20:12,ACC00006322,Payment,769.35,-235066.27,EUR,Grocery
TXN0000011026,2024-08-25T07:49:36,ACC00001874,Debit,143.96,-235210.23,USD,Amazon
TXN0000011027,2024-07-02T10:58:43,ACC00006897,Payment,1705.74,-236915.97,EUR,Walmart
TXN0000011028,2024-02-27T07:16:52,ACC00000691,Debit,900.13,-237816.1,GBP,Grocery
TXN0000011029,2024-11-11T23:15:42,ACC00005610,Debit,397.4,-238213.5,GBP,Grocery
TXN0000011030,2024-05-18T01:15:10,ACC00004093,Transfer,983.13,-237230.37,GBP,Walmart
TXN0000011031,2024-04-27T04:48:54,ACC00008378,Transfer,355.26,-236875.11,JPY,Amazon
TXN0000011032,2024-09-06T18:37:55,ACC00003298,Payment,1570.54,-238445.65,USD,Starbucks
TXN0000011033,2024-02-14T09:52:59,ACC00009105,Credit,532.02,-237913.63,JPY,Starbucks
TXN0000011034,2024-04-09T08:26:35,ACC00005371,Payment,1557.87,-239471.5,JPY,Walmart
TXN0000011035,2024-03-23T20:31:27,ACC00002989,Transfer,317.18,-239154.32,EUR,Walmart
TXN0000011036,2024-08-22T07:27:49,ACC00004921,Payment,1346.34,-240500.66,GBP,Amazon
TXN0000011037,2024-04-29T22:09:45,ACC00005164,Debit,402.11,-240902.77,USD,Walmart
TXN0000011038,2024-10-01T18:23:12,ACC00008217,Debit,692.95,-241595.72,GBP,Grocery
TXN0000011039,2024-05-10T20:10:43,ACC00002959,ATM,1055.15,-242650.87,GBP,Amazon
TXN0000011040,2024-11-30T05:45:07,ACC00004784,Credit,542.86,-242108.01,USD,Restaurant
TXN0000011041,2024-06-02T18:04:19,ACC00008144,ATM,140.3,-242248.31,EUR,Target
TXN0000011042,2024-07-21T07:11:19,ACC00008409,Credit,1226.41,-241021.9,JPY,Amazon
TXN0000011043,2024-01-09T03:45:49,ACC00004406,Debit,435.88,-241457.78,JPY,Target
TXN0000011044,2024-04-21T15:14:13,ACC00002480,Debit,1010.52,-242468.3,GBP,Grocery
TXN0000011045,2024-02-25T05:30:08,ACC00006110,Transfer,588.87,-241879.43,JPY,Target
TXN0000011046,2024-12-28T15:58:08,ACC00001875,Credit,1403.89,-240475.54,EUR,Amazon
TXN0000011047,2024-09-19T23:05:48,ACC00008528,ATM,816.46,-241292.0,USD,Starbucks
TXN0000011048,2024-05-03T09:03:48,ACC00008202,Debit,464.58,-241756.58,EUR,Walmart
TXN0000011049,2024-06-09T13:13:51,ACC00009914,ATM,1625.61,-243382.19,GBP,Target
TXN0000011050,2024-08-29T12:19:21,ACC00002741,Payment,405.21,-243787.4,GBP,Amazon
TXN0000011051,2024-06-10T06:59:59,ACC00005058,Payment,771.24,-244558.64,USD,Restaurant
TXN0000011052,2024-11-13T03:12:56,ACC00008516,Payment,596.22,-245154.86,JPY,Amazon
TXN0000011053,2024-03-08T23:27:50,ACC00005427,ATM,1796.38,-246951.24,USD,Amazon
TXN0000011054,2024-10-18T20:43:15,ACC00005408,Credit,101.14,-246850.1,JPY,Grocery
TXN0000011055,2024-11-21T08:20:53,ACC00009109,Transfer,160.54,-246689.56,JPY,Shell
TXN0000011056,2024-01-27T22:05:45,ACC00003961,Payment,476.03,-247165.59,JPY,Online Store
TXN0000011057,2024-07-25T13:17:38,ACC00007891,Credit,1874.8,-245290.79,USD,Grocery
TXN0000011058,2024-06-19T21:09:49,ACC00009044,Transfer,1729.25,-243561.54,GBP,Shell
TXN0000011059,2024-04-25T00:44:55,ACC00004904,ATM,765.98,-244327.52,USD,Shell
TXN0000011060,2024-12-15T09:49:46,ACC00005045,Credit,339.81,-243987.71,JPY,Walmart
TXN0000011061,2024-06-25T20:49:56,ACC00004837,Credit,758.8,-243228.91,EUR,Restaurant
TXN0000011062,2024-11-24T14:25:28,ACC00008220,ATM,1755.19,-244984.1,EUR,Shell
TXN0000011063,2024-07-23T04:14:27,ACC00001044,Credit,527.59,-244456.51,USD,Starbucks
TXN0000011064,2024-05-13T16:11:10,ACC00007809,Credit,1019.58,-243436.93,JPY,Target
TXN0000011065,2024-01-15T06:51:28,ACC00008743,Transfer,1817.43,-241619.5,GBP,Online Store
TXN0000011066,2024-04-12T17:35:01,ACC00003439,Transfer,205.38,-241414.12,GBP,Amazon
TXN0000011067,2024-10-17T09:12:15,ACC00001862,Transfer,1665.6,-239748.52,JPY,Shell
TXN0000011068,2024-11-04T05:25:14,ACC00005167,Payment,1252.23,-241000.75,EUR,Starbucks
TXN0000011069,2024-07-20T17:14:01,ACC00000554,Debit,364.83,-241365.58,JPY,Amazon
TXN0000011070,2024-11-20T22:03:31,ACC00009141,Credit,83.47,-241282.11,USD,Starbucks
TXN0000011071,2024-12-07T16:39:13,ACC00009836,Transfer,478.24,-240803.87,JPY,Restaurant
TXN0000011072,2024-01-24T08:17:10,ACC00008001,Transfer,1628.47,-239175.4,EUR,Shell
TXN0000011073,2024-11-28T10:02:38,ACC00005316,Debit,826.69,-240002.09,JPY,Online Store
TXN0000011074,2024-01-25T12:55:42,ACC00001804,Payment,693.88,-240695.97,USD,Target
TXN0000011075,2024-08-30T08:30:04,ACC00000772,Credit,1488.61,-239207.36,USD,Online Store
TXN0000011076,2024-03-20T16:03:44,ACC00002264,ATM,606.79,-239814.15,JPY,Walmart
TXN0000011077,2024-08-07T10:53:48,ACC00007519,ATM,424.71,-240238.86,USD,Amazon
TXN0000011078,2024-03-07T08:21:10,ACC00005313,Credit,1037.24,-239201.62,USD,Target
TXN0000011079,2024-02-03T05:03:17,ACC00004179,Payment,925.52,-240127.14,JPY,Amazon
TXN0000011080,2024-05-26T17:58:02,ACC00008937,Credit,1835.72,-238291.42,USD,Target
TXN0000011081,2024-06-15T18:27:07,ACC00000054,Transfer,1299.45,-236991.97,USD,Grocery
TXN0000011082,2024-01-10T21:00:00,ACC00003703,Credit,1804.61,-235187.36,USD,Restaurant
TXN0000011083,2024-11-05T14:23:29,ACC00003232,Debit,1434.9,-236622.26,EUR,Target
TXN0000011084,2024-04-23T01:34:24,ACC00002275,Transfer,604.41,-236017.85,GBP,Restaurant
TXN0000011085,2024-12-25T15:58:42,ACC00005167,Payment,1857.54,-237875.39,EUR,Starbucks
TXN0000011086,2024-09-12T02:09:44,ACC00000803,Payment,1119.27,-238994.66,GBP,Grocery
TXN0000011087,2024-12-17T12:23:01,ACC00000505,Transfer,1813.37,-237181.29,EUR,Restaurant
TXN0000011088,2024-12-11T02:03:40,ACC00007729,Payment,788.07,-237969.36,GBP,Walmart
TXN0000011089,2024-12-08T12:00:33,ACC00006109,Transfer,1793.63,-236175.73,GBP,Starbucks
TXN0000011090,2024-12-17T08:39:04,ACC00007583,Payment,1049.5,-237225.23,EUR,Amazon
TXN0000011091,2024-01-30T23:06:03,ACC00003084,ATM,1737.62,-238962.85,GBP,Online Store
TXN0000011092,2024-08-14T14:07:34,ACC00005995,Transfer,1629.47,-237333.38,EUR,Target
TXN0000011093,2024-01-31T02:57:52,ACC00006276,Transfer,1468.77,-235864.61,EUR,Walmart
TXN0000011094,2024-03-04T22:47:13,ACC00002776,Debit,1259.89,-237124.5,EUR,Restaurant
TXN0000011095,2024-05-21T18:24:39,ACC00006096,Debit,1634.26,-238758.76,JPY,Starbucks
TXN0000011096,2024-04-26T23:05:32,ACC00004178,Payment,1005.37,-239764.13,JPY,Amazon
TXN0000011097,2024-11-22T10:54:34,ACC00006326,Debit,1687.08,-241451.21,GBP,Starbucks
TXN0000011098,2024-02-08T20:39:13,ACC00002871,Payment,1902.19,-243353.4,EUR,Amazon
TXN0000011099,2024-09-16T08:06:21,ACC00000790,Transfer,312.4,-243041.0,JPY,Shell
TXN0000011100,2024-09-10T17:29:31,ACC00001755,Credit,1297.02,-241743.98,EUR,Target
TXN0000011101,2024-11-17T21:15:38,ACC00004223,Payment,398.65,-242142.63,JPY,Amazon
TXN0000011102,2024-10-22T04:54:06,ACC00006763,Transfer,1306.99,-240835.64,JPY,Walmart
TXN0000011103,2024-03-07T02:17:17,ACC00009842,ATM,1860.28,-242695.92,USD,Restaurant
TXN0000011104,2024-04-18T14:48:03,ACC00003945,Payment,981.28,-243677.2,JPY,Online Store
TXN0000011105,2024-09-07T08:01:33,ACC00009602,Credit,1842.93,-241834.27,USD,Online Store
TXN0000011106,2024-12-30T13:25:57,ACC00008072,Debit,93.94,-241928.21,USD,Online Store
TXN0000011107,2024-10-03T04:31:31,ACC00007183,ATM,1767.6,-243695.81,EUR,Walmart
TXN0000011108,2024-01-20T13:14:14,ACC00005052,ATM,597.38,-244293.19,EUR,Walmart
TXN0000011109,2024-10-09T14:47:09,ACC00004151,Payment,624.08,-244917.27,GBP,Walmart
TXN0000011110,2024-06-15T14:57:17,ACC00008736,Payment,1990.0,-246907.27,USD,Restaurant
TXN0000011111,2024-06-12T20:30:23,ACC00006041,ATM,607.92,-247515.19,JPY,Restaurant
TXN0000011112,2024-04-03T00:32:48,ACC00008993,Debit,406.67,-247921.86,EUR,Online Store
TXN0000011113,2024-08-21T09:00:15,ACC00001294,ATM,734.02,-248655.88,EUR,Online Store
TXN0000011114,2024-04-26T15:18:47,ACC00001350,Payment,1915.57,-250571.45,EUR,Target
TXN0000011115,2024-11-06T00:40:54,ACC00000683,Credit,243.5,-250327.95,GBP,Grocery
TXN0000011116,2024-02-29T14:41:01,ACC00005062,Transfer,465.18,-249862.77,JPY,Target
TXN0000011117,2024-06-06T15:22:17,ACC00008365,ATM,317.66,-250180.43,JPY,Starbucks
TXN0000011118,2024-07-11T15:54:20,ACC00006892,Credit,788.38,-249392.05,EUR,Starbucks
TXN0000011119,2024-05-03T14:00:54,ACC00008116,Transfer,919.11,-248472.94,GBP,Walmart
TXN0000011120,2024-05-15T17:38:25,ACC00009089,Debit,1547.54,-250020.48,GBP,Shell
TXN0000011121,2024-10-29T16:09:43,ACC00009152,Credit,34.65,-249985.83,USD,Shell
TXN0000011122,2024-11-14T01:02:41,ACC00005350,Credit,1726.61,-248259.22,GBP,Grocery
TXN0000011123,2024-12-28T20:53:00,ACC00005729,Payment,1631.86,-249891.08,JPY,Grocery
TXN0000011124,2024-12-22T15:49:00,ACC00002417,Credit,1479.21,-248411.87,JPY,Restaurant
TXN0000011125,2024-11-08T06:36:06,ACC00005283,Payment,119.26,-248531.13,USD,Target
TXN0000011126,2024-04-09T04:59:52,ACC00008321,Debit,1561.36,-250092.49,EUR,Grocery
TXN0000011127,2024-01-11T03:09:42,ACC00002584,Debit,1576.31,-251668.8,EUR,Starbucks
TXN0000011128,2024-12-28T02:43:39,ACC00000190,Transfer,1678.69,-249990.11,EUR,Starbucks
TXN0000011129,2024-07-23T06:30:58,ACC00006378,Debit,907.42,-250897.53,USD,Amazon
TXN0000011130,2024-01-03T15:15:44,ACC00005686,Credit,240.55,-250656.98,USD,Walmart
TXN0000011131,2024-01-23T21:20:25,ACC00003707,Credit,1012.34,-249644.64,USD,Starbucks
TXN0000011132,2024-05-23T05:13:22,ACC00000698,Payment,798.68,-250443.32,EUR,Online Store
TXN0000011133,2024-07-01T16:30:01,ACC00008289,Payment,954.23,-251397.55,EUR,Restaurant
TXN0000011134,2024-02-29T17:00:31,ACC00005851,Credit,162.66,-251234.89,JPY,Walmart
TXN0000011135,2024-11-16T15:04:15,ACC00009185,Transfer,74.57,-251160.32,JPY,Online Store
TXN0000011136,2024-02-26T03:31:05,ACC00000539,Credit,1277.45,-249882.87,EUR,Starbucks
TXN0000011137,2024-09-03T15:46:19,ACC00005409,Payment,1334.97,-251217.84,JPY,Amazon
TXN0000011138,2024-06-09T10:36:01,ACC00005761,Payment,265.89,-251483.73,GBP,Shell
TXN0000011139,2024-08-03T15:56:02,ACC00007815,Transfer,1499.3,-249984.43,GBP,Restaurant
TXN0000011140,2024-07-15T00:50:47,ACC00005158,Payment,932.81,-250917.24,USD,Online Store
TXN0000011141,2024-02-28T23:18:31,ACC00009715,Transfer,1938.47,-248978.77,EUR,Walmart
TXN0000011142,2024-12-06T05:51:52,ACC00003436,Credit,83.96,-248894.81,EUR,Starbucks
TXN0000011143,2024-08-05T05:09:58,ACC00007104,Credit,924.02,-247970.79,GBP,Starbucks
TXN0000011144,2024-10-07T12:19:23,ACC00006666,Transfer,1256.03,-246714.76,USD,Starbucks
TXN0000011145,2024-04-05T00:50:16,ACC00006637,Credit,1839.17,-244875.59,GBP,Online Store
TXN0000011146,2024-03-09T15:55:01,ACC00000622,Transfer,28.28,-244847.31,EUR,Online Store
TXN0000011147,2024-10-27T06:37:56,ACC00004496,Payment,61.25,-244908.56,EUR,Starbucks
TXN0000011148,2024-04-21T12:19:32,ACC00004100,Transfer,1981.83,-242926.73,USD,Shell
TXN0000011149,2024-06-03T18:13:21,ACC00000714,ATM,856.84,-243783.57,EUR,Shell
TXN0000011150,2024-04-30T20:46:35,ACC00003543,Credit,1891.33,-241892.24,JPY,Online Store
TXN0000011151,2024-01-18T23:50:04,ACC00007459,Credit,1493.95,-240398.29,GBP,Grocery
TXN0000011152,2024-04-17T08:20:42,ACC00002233,Debit,49.87,-240448.16,EUR,Shell
TXN0000011153,2024-09-20T21:34:44,ACC00002327,Debit,945.61,-241393.77,USD,Starbucks
TXN0000011154,2024-05-25T19:24:41,ACC00007517,Payment,113.25,-241507.02,USD,Starbucks
TXN0000011155,2024-08-07T02:35:38,ACC00001368,Payment,1651.25,-243158.27,USD,Target
TXN0000011156,2024-05-09T15:56:16,ACC00007370,Credit,1053.52,-242104.75,GBP,Grocery
TXN0000011157,2024-05-01T03:52:10,ACC00005161,Debit,1102.59,-243207.34,GBP,Amazon
TXN0000011158,2024-10-18T04:26:20,ACC00000148,Debit,85.45,-243292.79,USD,Online Store
TXN0000011159,2024-04-23T01:31:30,ACC00003258,Transfer,885.52,-242407.27,EUR,Online Store
TXN0000011160,2024-10-27T23:06:34,ACC00004768,Credit,1936.23,-240471.04,EUR,Walmart
TXN0000011161,2024-07-19T09:37:51,ACC00008928,Credit,113.17,-240357.87,JPY,Grocery
TXN0000011162,2024-07-12T08:50:09,ACC00006188,Transfer,1048.77,-239309.1,USD,Walmart
TXN0000011163,2024-04-26T14:36:18,ACC00003866,ATM,74.75,-239383.85,USD,Walmart
TXN0000011164,2024-09-10T01:46:15,ACC00007533,Credit,478.24,-238905.61,GBP,Starbucks
TXN0000011165,2024-07-21T21:19:49,ACC00006616,Payment,1722.54,-240628.15,EUR,Shell
TXN0000011166,2024-09-07T21:54:11,ACC00007331,Credit,1977.01,-238651.14,EUR,Walmart
TXN0000011167,2024-10-09T11:34:13,ACC00008022,Transfer,392.57,-238258.57,GBP,Amazon
TXN0000011168,2024-07-29T09:32:57,ACC00004863,Transfer,1696.06,-236562.51,GBP,Shell
TXN0000011169,2024-12-15T14:45:22,ACC00001656,Transfer,224.78,-236337.73,GBP,Online Store
TXN0000011170,2024-10-14T04:47:35,ACC00009050,Payment,1573.96,-237911.69,GBP,Walmart
TXN0000011171,2024-06-25T05:48:39,ACC00005547,Transfer,338.09,-237573.6,JPY,Online Store
TXN0000011172,2024-09-06T21:51:18,ACC00001814,Payment,709.94,-238283.54,GBP,Amazon
TXN0000011173,2024-01-10T03:46:03,ACC00004147,ATM,1298.61,-239582.15,JPY,Starbucks
TXN0000011174,2024-12-28T23:29:16,ACC00002258,Credit,292.79,-239289.36,USD,Restaurant
TXN0000011175,2024-08-21T00:08:35,ACC00005908,Debit,1089.51,-240378.87,EUR,Walmart
TXN0000011176,2024-06-21T06:31:16,ACC00006620,ATM,1602.37,-241981.24,GBP,Target
TXN0000011177,2024-05-17T17:07:09,ACC00008305,Credit,1076.07,-240905.17,GBP,Walmart
TXN0000011178,2024-02-22T01:16:38,ACC00007604,Debit,1709.56,-242614.73,GBP,Shell
TXN0000011179,2024-06-01T10:15:51,ACC00007151,ATM,338.74,-242953.47,USD,Restaurant
TXN0000011180,2024-09-13T11:38:36,ACC00005944,Credit,53.61,-242899.86,USD,Grocery
TXN0000011181,2024-03-15T00:19:18,ACC00006557,ATM,689.47,-243589.33,USD,Target
TXN0000011182,2024-02-20T13:51:41,ACC00002698,Debit,1829.47,-245418.8,EUR,Amazon
TXN0000011183,2024-02-11T03:33:30,ACC00007143,Debit,513.29,-245932.09,USD,Restaurant
TXN0000011184,2024-04-15T17:09:14,ACC00004801,ATM,1497.22,-247429.31,USD,Restaurant
TXN0000011185,2024-01-04T05:38:31,ACC00004618,Payment,1035.54,-248464.85,EUR,Walmart
TXN0000011186,2024-05-31T00:16:23,ACC00000344,Payment,1498.09,-249962.94,GBP,Target
TXN0000011187,2024-11-07T23:47:45,ACC00005375,Payment,1444.69,-251407.63,USD,Online Store
TXN0000011188,2024-02-28T13:23:44,ACC00005726,Debit,647.62,-252055.25,EUR,Restaurant
TXN0000011189,2024-10-04T05:49:38,ACC00003240,Transfer,651.14,-251404.11,GBP,Walmart
TXN0000011190,2024-03-25T09:20:28,ACC00004769,Payment,448.25,-251852.36,JPY,Amazon
TXN0000011191,2024-04-17T09:05:05,ACC00002901,ATM,449.69,-252302.05,EUR,Restaurant
TXN0000011192,2024-01-08T06:09:44,ACC00000953,ATM,72.31,-252374.36,GBP,Grocery
TXN0000011193,2024-02-18T21:20:06,ACC00009994,ATM,1930.74,-254305.1,JPY,Amazon
TXN0000011194,2024-10-02T20:48:09,ACC00005884,Transfer,1357.26,-252947.84,USD,Walmart
TXN0000011195,2024-10-24T23:56:42,ACC00009054,Debit,592.32,-253540.16,JPY,Shell
TXN0000011196,2024-11-06T07:58:24,ACC00001463,Credit,1487.04,-252053.12,GBP,Restaurant
TXN0000011197,2024-10-21T23:58:44,ACC00007777,ATM,435.36,-252488.48,JPY,Restaurant
TXN0000011198,2024-10-18T03:35:49,ACC00009767,ATM,115.79,-252604.27,USD,Walmart
TXN0000011199,2024-06-17T16:32:10,ACC00001184,Debit,418.13,-253022.4,JPY,Amazon
TXN0000011200,2024-03-10T03:56:47,ACC00009490,Transfer,1458.83,-251563.57,EUR,Shell
TXN0000011201,2024-03-22T07:23:32,ACC00006948,Credit,1089.01,-250474.56,JPY,Target
TXN0000011202,2024-05-27T01:59:15,ACC00002633,Payment,1083.13,-251557.69,USD,Walmart
TXN0000011203,2024-10-11T05:39:39,ACC00006221,Transfer,1290.56,-250267.13,EUR,Grocery
TXN0000011204,2024-11-08T05:15:13,ACC00001340,Transfer,1166.11,-249101.02,GBP,Grocery
TXN0000011205,2024-02-12T17:20:59,ACC00000458,Payment,866.03,-249967.05,JPY,Restaurant
TXN0000011206,2024-08-10T17:10:04,ACC00008475,Credit,809.81,-249157.24,USD,Online Store
TXN0000011207,2024-12-02T11:59:21,ACC00005934,ATM,224.27,-249381.51,JPY,Shell
TXN0000011208,2024-05-19T05:27:48,ACC00000087,Debit,1771.54,-251153.05,EUR,Amazon
TXN0000011209,2024-05-16T11:36:59,ACC00003971,ATM,561.49,-251714.54,JPY,Starbucks
TXN0000011210,2024-04-03T22:36:04,ACC00008275,Credit,900.56,-250813.98,EUR,Shell
TXN0000011211,2024-10-30T14:43:23,ACC00006231,Payment,562.03,-251376.01,JPY,Walmart
TXN0000011212,2024-03-11T17:27:34,ACC00000432,Debit,919.35,-252295.36,GBP,Restaurant
TXN0000011213,2024-12-13T12:03:27,ACC00005792,Payment,1206.24,-253501.6,USD,Target
TXN0000011214,2024-01-30T07:40:14,ACC00003034,Transfer,1316.92,-252184.68,GBP,Grocery
TXN0000011215,2024-03-07T19:06:16,ACC00003304,Debit,1695.22,-253879.9,GBP,Walmart
TXN0000011216,2024-07-16T20:53:55,ACC00009772,ATM,1761.84,-255641.74,USD,Online Store
TXN0000011217,2024-01-25T20:53:55,ACC00006122,Payment,1984.15,-257625.89,USD,Grocery
TXN0000011218,2024-12-23T20:09:57,ACC00009450,ATM,1225.43,-258851.32,GBP,Restaurant
TXN0000011219,2024-09-03T01:52:11,ACC00008200,Credit,714.26,-258137.06,USD,Starbucks
TXN0000011220,2024-07-30T01:27:21,ACC00007182,ATM,1118.94,-259256.0,EUR,Grocery
TXN0000011221,2024-09-27T14:34:41,ACC00002108,Payment,773.43,-260029.43,EUR,Shell
TXN0000011222,2024-12-18T06:25:45,ACC00007072,ATM,217.55,-260246.98,GBP,Target
TXN0000011223,2024-03-15T18:24:04,ACC00000190,ATM,1277.26,-261524.24,GBP,Shell
TXN0000011224,2024-10-09T12:42:50,ACC00001383,Debit,1039.62,-262563.86,JPY,Restaurant
TXN0000011225,2024-04-11T18:36:40,ACC00002533,Credit,498.02,-262065.84,USD,Walmart
TXN0000011226,2024-11-30T16:54:29,ACC00006857,ATM,1844.81,-263910.65,EUR,Restaurant
TXN0000011227,2024-09-26T17:53:36,ACC00007557,Debit,1846.7,-265757.35,USD,Online Store
TXN0000011228,2024-01-02T20:00:02,ACC00000324,Transfer,31.47,-265725.88,EUR,Grocery
TXN0000011229,2024-05-20T22:44:04,ACC00007926,Transfer,1092.56,-264633.32,EUR,Shell
TXN0000011230,2024-02-15T17:50:58,ACC00002117,ATM,1938.12,-266571.44,JPY,Amazon
TXN0000011231,2024-08-25T04:24:12,ACC00005477,Transfer,56.99,-266514.45,EUR,Shell
TXN0000011232,2024-01-17T22:48:29,ACC00001788,Credit,172.79,-266341.66,USD,Target
TXN0000011233,2024-09-10T21:29:09,ACC00004942,Debit,1695.82,-268037.48,GBP,Starbucks
TXN0000011234,2024-08-26T15:49:00,ACC00005588,Debit,1013.26,-269050.74,JPY,Shell
TXN0000011235,2024-09-19T19:45:22,ACC00003700,Transfer,1334.86,-267715.88,USD,Starbucks
TXN0000011236,2024-02-09T14:52:21,ACC00009808,ATM,1886.63,-269602.51,JPY,Shell
TXN0000011237,2024-01-12T07:21:47,ACC00008369,Transfer,1208.94,-268393.57,JPY,Online Store
TXN0000011238,2024-11-08T22:21:02,ACC00009862,ATM,424.34,-268817.91,EUR,Grocery
TXN0000011239,2024-05-18T09:14:48,ACC00009353,Payment,952.76,-269770.67,GBP,Starbucks
TXN0000011240,2024-10-27T14:06:00,ACC00009368,ATM,660.37,-270431.04,EUR,Amazon
TXN0000011241,2024-12-30T07:48:01,ACC00004115,ATM,1655.3,-272086.34,JPY,Amazon
TXN0000011242,2024-02-21T17:45:05,ACC00009260,Payment,1439.17,-273525.51,EUR,Online Store
TXN0000011243,2024-12-26T12:36:24,ACC00001632,Transfer,1107.89,-272417.62,JPY,Restaurant
TXN0000011244,2024-11-10T05:21:01,ACC00001194,Payment,537.45,-272955.07,JPY,Online Store
TXN0000011245,2024-10-29T14:52:41,ACC00000183,Debit,419.93,-273375.0,JPY,Shell
TXN0000011246,2024-02-25T19:09:17,ACC00001204,Credit,1878.89,-271496.11,USD,Restaurant
TXN0000011247,2024-11-18T15:42:04,ACC00002762,Debit,1124.74,-272620.85,GBP,Target
TXN0000011248,2024-02-07T13:52:02,ACC00002349,Payment,1627.84,-274248.69,JPY,Online Store
TXN0000011249,2024-06-25T08:52:46,ACC00004666,Transfer,1803.02,-272445.67,GBP,Shell
TXN0000011250,2024-07-26T11:07:11,ACC00001258,Credit,75.5,-272370.17,JPY,Online Store
TXN0000011251,2024-10-03T16:46:01,ACC00008803,Payment,800.16,-273170.33,JPY,Shell
TXN0000011252,2024-02-26T14:44:31,ACC00009154,Credit,1071.28,-272099.05,JPY,Starbucks
TXN0000011253,2024-06-19T05:53:14,ACC00002440,ATM,1392.2,-273491.25,JPY,Target
TXN0000011254,2024-08-12T18:16:07,ACC00000223,Payment,411.17,-273902.42,USD,Starbucks
TXN0000011255,2024-03-29T12:44:43,ACC00009061,Payment,1352.7,-275255.12,JPY,Amazon
TXN0000011256,2024-02-04T08:19:31,ACC00005625,Transfer,1118.19,-274136.93,USD,Amazon
TXN0000011257,2024-09-02T17:15:23,ACC00007296,Transfer,440.51,-273696.42,EUR,Starbucks
TXN0000011258,2024-02-17T09:36:06,ACC00001110,ATM,1961.45,-275657.87,USD,Grocery
TXN0000011259,2024-07-10T06:09:21,ACC00009273,Credit,1641.55,-274016.32,JPY,Starbucks
TXN0000011260,2024-02-01T06:57:58,ACC00001901,Payment,839.24,-274855.56,USD,Grocery
TXN0000011261,2024-01-03T01:27:01,ACC00003209,Payment,1913.23,-276768.79,GBP,Walmart
TXN0000011262,2024-04-01T07:43:00,ACC00006495,Credit,822.16,-275946.63,EUR,Starbucks
TXN0000011263,2024-11-07T09:33:22,ACC00008044,Transfer,1321.76,-274624.87,EUR,Target
TXN0000011264,2024-04-17T21:42:22,ACC00009248,Debit,1661.85,-276286.72,EUR,Shell
TXN0000011265,2024-08-09T13:37:28,ACC00007024,Transfer,1686.04,-274600.68,USD,Restaurant
TXN0000011266,2024-07-21T23:39:57,ACC00004843,ATM,1298.49,-275899.17,GBP,Grocery
TXN0000011267,2024-11-24T18:25:57,ACC00008647,Credit,1469.58,-274429.59,USD,Walmart
TXN0000011268,2024-08-01T18:06:48,ACC00007910,ATM,680.75,-275110.34,USD,Grocery
TXN0000011269,2024-12-12T00:41:54,ACC00003859,Payment,497.02,-275607.36,EUR,Walmart
TXN0000011270,2024-06-11T12:04:29,ACC00009227,ATM,1397.67,-277005.03,USD,Grocery
TXN0000011271,2024-08-15T15:20:58,ACC00007618,Debit,220.07,-277225.1,USD,Restaurant
TXN0000011272,2024-07-15T05:42:15,ACC00005883,Payment,1660.1,-278885.2,JPY,Restaurant
TXN0000011273,2024-08-07T23:07:58,ACC00001279,Debit,410.73,-279295.93,GBP,Shell
TXN0000011274,2024-05-03T17:08:35,ACC00001186,Payment,245.78,-279541.71,USD,Restaurant
TXN0000011275,2024-03-16T13:09:44,ACC00009215,Credit,1216.05,-278325.66,GBP,Online Store
TXN0000011276,2024-05-21T18:31:59,ACC00008745,Payment,1633.02,-279958.68,USD,Starbucks
TXN0000011277,2024-11-14T03:17:50,ACC00000755,Credit,1532.45,-278426.23,GBP,Starbucks
TXN0000011278,2024-09-13T16:30:06,ACC00009955,Credit,1896.69,-276529.54,USD,Grocery
TXN0000011279,2024-01-28T03:15:17,ACC00004321,ATM,1561.44,-278090.98,JPY,Amazon
TXN0000011280,2024-08-29T02:45:42,ACC00009043,Payment,1173.24,-279264.22,JPY,Amazon
TXN0000011281,2024-06-06T13:43:39,ACC00000949,Credit,1108.65,-278155.57,USD,Starbucks
TXN0000011282,2024-03-18T21:29:13,ACC00008212,Transfer,1284.03,-276871.54,GBP,Restaurant
TXN0000011283,2024-02-05T14:28:50,ACC00003158,Debit,532.68,-277404.22,GBP,Restaurant
TXN0000011284,2024-02-13T03:04:50,ACC00008078,Payment,561.14,-277965.36,EUR,Amazon
TXN0000011285,2024-01-30T14:05:07,ACC00005176,Payment,986.51,-278951.87,JPY,Shell
TXN0000011286,2024-11-19T14:09:18,ACC00008230,ATM,1125.12,-280076.99,GBP,Target
TXN0000011287,2024-10-02T09:20:14,ACC00004321,Credit,724.38,-279352.61,GBP,Grocery
TXN0000011288,2024-06-12T02:09:00,ACC00003704,ATM,1439.33,-280791.94,JPY,Target
TXN0000011289,2024-01-31T10:42:52,ACC00005430,Transfer,1500.67,-279291.27,EUR,Target
TXN0000011290,2024-12-01T13:14:05,ACC00002852,Payment,429.28,-279720.55,USD,Shell
TXN0000011291,2024-06-04T00:36:41,ACC00001855,Payment,1352.91,-281073.46,JPY,Walmart
TXN0000011292,2024-02-13T12:46:28,ACC00004602,Payment,513.47,-281586.93,EUR,Restaurant
TXN0000011293,2024-06-16T16:41:08,ACC00005444,Credit,1296.4,-280290.53,GBP,Shell
TXN0000011294,2024-01-23T13:01:28,ACC00002738,ATM,1499.02,-281789.55,EUR,Walmart
TXN0000011295,2024-09-25T19:31:16,ACC00008148,Payment,521.0,-282310.55,EUR,Online Store
TXN0000011296,2024-03-05T00:48:30,ACC00007823,Debit,1605.11,-283915.66,JPY,Target
TXN0000011297,2024-12-21T08:56:13,ACC00004983,Payment,1096.93,-285012.59,USD,Walmart
TXN0000011298,2024-03-31T20:22:53,ACC00003091,Transfer,448.95,-284563.64,USD,Grocery
TXN0000011299,2024-04-21T00:12:05,ACC00001477,ATM,1850.55,-286414.19,USD,Restaurant
TXN0000011300,2024-03-09T23:45:31,ACC00001249,Credit,593.83,-285820.36,EUR,Target
TXN0000011301,2024-04-22T09:27:53,ACC00007231,Payment,1412.57,-287232.93,USD,Amazon
TXN0000011302,2024-08-15T07:55:23,ACC00009546,Payment,1392.73,-288625.66,EUR,Starbucks
TXN0000011303,2024-12-27T02:59:02,ACC00003306,Credit,1918.59,-286707.07,JPY,Amazon
TXN0000011304,2024-01-25T17:40:33,ACC00005619,Debit,1164.79,-287871.86,GBP,Shell
TXN0000011305,2024-12-25T21:11:54,ACC00006777,Transfer,513.3,-287358.56,GBP,Grocery
TXN0000011306,2024-01-20T14:46:57,ACC00001004,Transfer,212.81,-287145.75,USD,Walmart
TXN0000011307,2024-02-29T07:05:08,ACC00007183,Credit,303.36,-286842.39,JPY,Amazon
TXN0000011308,2024-12-12T20:07:15,ACC00000567,Debit,168.89,-287011.28,GBP,Shell
TXN0000011309,2024-04-26T21:36:25,ACC00008284,Payment,673.03,-287684.31,EUR,Starbucks
TXN0000011310,2024-04-14T08:33:34,ACC00006820,ATM,1033.63,-288717.94,USD,Shell
TXN0000011311,2024-07-01T09:32:54,ACC00006662,Transfer,418.29,-288299.65,EUR,Amazon
TXN0000011312,2024-09-23T12:32:27,ACC00005778,Debit,1381.55,-289681.2,GBP,Online Store
TXN0000011313,2024-05-21T19:10:36,ACC00009258,Debit,1660.7,-291341.9,GBP,Grocery
TXN0000011314,2024-02-16T05:52:19,ACC00005988,Payment,1523.43,-292865.33,GBP,Grocery
TXN0000011315,2024-03-30T17:35:40,ACC00007594,Payment,1832.31,-294697.64,GBP,Starbucks
TXN0000011316,2024-11-21T00:21:04,ACC00009093,ATM,1281.28,-295978.92,JPY,Walmart
TXN0000011317,2024-06-21T11:24:20,ACC00005406,Debit,513.02,-296491.94,EUR,Shell
TXN0000011318,2024-11-29T00:29:59,ACC00009676,Credit,1367.27,-295124.67,JPY,Shell
TXN0000011319,2024-12-14T02:05:24,ACC00009727,Credit,434.63,-294690.04,GBP,Shell
TXN0000011320,2024-03-29T10:36:34,ACC00002396,Debit,634.28,-295324.32,JPY,Shell
TXN0000011321,2024-01-26T08:57:02,ACC00009997,Debit,94.29,-295418.61,GBP,Online Store
TXN0000011322,2024-03-21T08:04:54,ACC00008912,ATM,194.02,-295612.63,USD,Restaurant
TXN0000011323,2024-02-09T18:43:43,ACC00009550,Transfer,1855.0,-293757.63,EUR,Online Store
TXN0000011324,2024-05-07T00:49:11,ACC00005522,Transfer,1137.57,-292620.06,GBP,Shell
TXN0000011325,2024-01-23T20:38:15,ACC00000223,Debit,187.97,-292808.03,JPY,Walmart
TXN0000011326,2024-09-06T00:12:54,ACC00004207,Debit,1519.71,-294327.74,JPY,Amazon
TXN0000011327,2024-10-31T08:46:07,ACC00009573,Payment,1909.02,-296236.76,GBP,Shell
TXN0000011328,2024-04-26T02:56:48,ACC00003514,Transfer,932.8,-295303.96,EUR,Restaurant
TXN0000011329,2024-10-29T20:03:05,ACC00005559,Transfer,627.23,-294676.73,JPY,Grocery
TXN0000011330,2024-02-03T15:15:48,ACC00007370,Credit,1137.57,-293539.16,JPY,Grocery
TXN0000011331,2024-02-27T08:15:29,ACC00007903,Transfer,1310.97,-292228.19,USD,Restaurant
TXN0000011332,2024-07-15T13:17:26,ACC00009761,Debit,699.73,-292927.92,EUR,Target
TXN0000011333,2024-03-10T08:23:38,ACC00001714,Debit,850.12,-293778.04,GBP,Online Store
TXN0000011334,2024-02-07T03:06:57,ACC00008787,Debit,1287.18,-295065.22,GBP,Amazon
TXN0000011335,2024-01-05T13:00:25,ACC00004779,ATM,40.27,-295105.49,USD,Starbucks
TXN0000011336,2024-07-15T12:15:49,ACC00003383,Debit,1134.0,-296239.49,USD,Restaurant
TXN0000011337,2024-10-07T16:33:31,ACC00002465,ATM,749.01,-296988.5,GBP,Amazon
TXN0000011338,2024-09-26T06:35:47,ACC00005706,Debit,876.77,-297865.27,EUR,Walmart
TXN0000011339,2024-01-11T10:42:50,ACC00003690,ATM,33.26,-297898.53,JPY,Starbucks
TXN0000011340,2024-08-17T05:36:36,ACC00002743,Credit,1327.87,-296570.66,USD,Restaurant
TXN0000011341,2024-11-24T02:40:38,ACC00005132,Debit,1459.46,-298030.12,JPY,Restaurant
TXN0000011342,2024-08-05T16:26:48,ACC00000759,Debit,1540.99,-299571.11,GBP,Shell
TXN0000011343,2024-09-18T22:18:25,ACC00000753,ATM,848.42,-300419.53,EUR,Walmart
TXN0000011344,2024-11-23T14:36:20,ACC00005600,Credit,70.94,-300348.59,USD,Target
TXN0000011345,2024-09-08T08:34:49,ACC00006934,Credit,326.4,-300022.19,USD,Walmart
TXN0000011346,2024-11-10T22:26:10,ACC00007918,Payment,375.63,-300397.82,EUR,Target
TXN0000011347,2024-10-06T03:00:55,ACC00000022,Debit,174.0,-300571.82,JPY,Walmart
TXN0000011348,2024-08-29T12:31:59,ACC00002119,Credit,1340.99,-299230.83,JPY,Online Store
TXN0000011349,2024-04-24T03:05:03,ACC00007862,Credit,1354.48,-297876.35,JPY,Walmart
TXN0000011350,2024-04-29T18:07:54,ACC00001254,Transfer,1389.75,-296486.6,GBP,Amazon
TXN0000011351,2024-11-16T09:03:06,ACC00001529,Transfer,1974.06,-294512.54,USD,Shell
TXN0000011352,2024-09-06T11:59:31,ACC00005452,Credit,1462.21,-293050.33,EUR,Online Store
TXN0000011353,2024-06-30T07:05:31,ACC00004704,Payment,114.92,-293165.25,GBP,Restaurant
TXN0000011354,2024-08-01T06:58:24,ACC00002274,Transfer,85.26,-293079.99,JPY,Starbucks
TXN0000011355,2024-04-16T11:57:31,ACC00002664,Debit,1335.78,-294415.77,USD,Walmart
TXN0000011356,2024-08-24T01:52:52,ACC00003964,ATM,164.27,-294580.04,GBP,Restaurant
TXN0000011357,2024-03-30T05:55:35,ACC00002300,Debit,264.97,-294845.01,EUR,Walmart
TXN0000011358,2024-04-25T02:18:42,ACC00002995,Credit,414.63,-294430.38,GBP,Online Store
TXN0000011359,2024-03-16T05:24:25,ACC00004099,Payment,1702.08,-296132.46,EUR,Walmart
TXN0000011360,2024-07-17T00:24:23,ACC00003399,Payment,1562.0,-297694.46,GBP,Walmart
TXN0000011361,2024-06-29T16:46:38,ACC00009887,Payment,1304.67,-298999.13,GBP,Amazon
TXN0000011362,2024-02-22T15:49:36,ACC00007425,Debit,97.43,-299096.56,USD,Grocery
TXN0000011363,2024-08-09T10:30:35,ACC00001257,Payment,1042.13,-300138.69,EUR,Shell
TXN0000011364,2024-10-23T00:10:36,ACC00007057,Payment,1329.2,-301467.89,USD,Restaurant
TXN0000011365,2024-02-24T14:15:07,ACC00009839,Debit,1443.17,-302911.06,EUR,Amazon
TXN0000011366,2024-06-04T18:01:03,ACC00000307,Payment,279.97,-303191.03,EUR,Target
TXN0000011367,2024-08-07T23:51:44,ACC00003116,Credit,1645.15,-301545.88,JPY,Starbucks
TXN0000011368,2024-12-13T22:49:11,ACC00002147,Transfer,220.79,-301325.09,EUR,Online Store
TXN0000011369,2024-06-23T22:34:20,ACC00005214,Credit,621.57,-300703.52,JPY,Shell
TXN0000011370,2024-11-12T06:12:03,ACC00005300,Transfer,1461.9,-299241.62,EUR,Walmart
TXN0000011371,2024-03-23T18:55:39,ACC00003430,Debit,1465.03,-300706.65,GBP,Shell
TXN0000011372,2024-07-09T14:11:26,ACC00007605,Payment,1679.41,-302386.06,USD,Walmart
TXN0000011373,2024-03-12T00:51:41,ACC00008452,Payment,903.49,-303289.55,GBP,Target
TXN0000011374,2024-01-04T09:15:39,ACC00002100,Payment,1133.76,-304423.31,EUR,Target
TXN0000011375,2024-01-04T05:07:18,ACC00004089,ATM,971.09,-305394.4,GBP,Starbucks
TXN0000011376,2024-05-28T17:01:25,ACC00006613,Debit,1932.76,-307327.16,GBP,Walmart
TXN0000011377,2024-06-19T21:07:52,ACC00006744,Transfer,927.17,-306399.99,EUR,Restaurant
TXN0000011378,2024-12-17T21:20:51,ACC00001418,Debit,886.23,-307286.22,USD,Amazon
TXN0000011379,2024-05-10T23:49:35,ACC00005832,Credit,1617.23,-305668.99,USD,Amazon
TXN0000011380,2024-01-12T01:17:03,ACC00001221,ATM,425.87,-306094.86,USD,Shell
TXN0000011381,2024-10-16T13:52:07,ACC00007882,Credit,564.78,-305530.08,EUR,Restaurant
TXN0000011382,2024-11-05T20:24:38,ACC00004245,ATM,168.78,-305698.86,USD,Walmart
TXN0000011383,2024-06-03T05:24:14,ACC00000837,Credit,1252.4,-304446.46,JPY,Grocery
TXN0000011384,2024-01-21T06:58:25,ACC00001733,Payment,429.64,-304876.1,GBP,Grocery
TXN0000011385,2024-12-05T21:08:59,ACC00000899,Credit,986.92,-303889.18,JPY,Shell
TXN0000011386,2024-01-26T23:55:19,ACC00004862,Transfer,822.9,-303066.28,EUR,Online Store
TXN0000011387,2024-11-09T16:04:55,ACC00006382,Debit,1895.14,-304961.42,JPY,Restaurant
TXN0000011388,2024-02-26T04:12:27,ACC00006832,Payment,87.32,-305048.74,USD,Walmart
TXN0000011389,2024-04-05T00:56:40,ACC00002728,Debit,76.26,-305125.0,JPY,Shell
TXN0000011390,2024-02-03T07:36:28,ACC00001618,Debit,268.63,-305393.63,USD,Starbucks
TXN0000011391,2024-12-05T09:31:42,ACC00004254,Debit,545.95,-305939.58,USD,Online Store
TXN0000011392,2024-08-07T08:35:37,ACC00008025,Credit,1280.89,-304658.69,GBP,Shell
TXN0000011393,2024-03-29T05:11:32,ACC00002023,Transfer,1066.52,-303592.17,EUR,Amazon
TXN0000011394,2024-12-20T04:02:38,ACC00001002,Transfer,1501.32,-302090.85,EUR,Target
TXN0000011395,2024-08-11T21:56:37,ACC00008933,Transfer,1964.59,-300126.26,USD,Target
TXN0000011396,2024-06-25T06:35:41,ACC00003317,Debit,1840.12,-301966.38,JPY,Shell
TXN0000011397,2024-05-05T08:31:45,ACC00009632,Debit,1313.4,-303279.78,EUR,Restaurant
TXN0000011398,2024-07-24T23:08:17,ACC00005533,Credit,826.91,-302452.87,USD,Amazon
TXN0000011399,2024-11-16T09:46:56,ACC00007959,Transfer,1551.09,-300901.78,EUR,Target
TXN0000011400,2024-02-21T22:22:18,ACC00000338,Debit,1783.22,-302685.0,GBP,Online Store
TXN0000011401,2024-08-26T01:08:02,ACC00009338,Transfer,1939.3,-300745.7,GBP,Online Store
TXN0000011402,2024-11-23T18:14:17,ACC00007322,Debit,962.61,-301708.31,GBP,Shell
TXN0000011403,2024-09-21T07:23:28,ACC00001121,ATM,1138.59,-302846.9,JPY,Target
TXN0000011404,2024-10-28T09:06:59,ACC00008891,Payment,1711.77,-304558.67,USD,Amazon
TXN0000011405,2024-11-01T21:07:00,ACC00008809,ATM,246.04,-304804.71,USD,Grocery
TXN0000011406,2024-10-02T21:53:58,ACC00001469,Transfer,123.16,-304681.55,GBP,Walmart
TXN0000011407,2024-12-11T22:24:24,ACC00008696,ATM,587.65,-305269.2,GBP,Walmart
TXN0000011408,2024-04-28T12:38:32,ACC00007239,Debit,39.66,-305308.86,EUR,Walmart
TXN0000011409,2024-04-26T04:53:57,ACC00002274,Debit,1501.46,-306810.32,USD,Amazon
TXN0000011410,2024-10-13T18:10:59,ACC00004359,Payment,1379.65,-308189.97,GBP,Grocery
TXN0000011411,2024-01-16T15:19:03,ACC00001475,Transfer,623.55,-307566.42,USD,Target
TXN0000011412,2024-07-24T10:16:10,ACC00003858,ATM,977.33,-308543.75,JPY,Grocery
TXN0000011413,2024-09-20T13:55:28,ACC00004490,Payment,1312.92,-309856.67,EUR,Starbucks
TXN0000011414,2024-12-26T20:53:45,ACC00000902,Credit,1393.47,-308463.2,JPY,Shell
TXN0000011415,2024-10-26T18:04:50,ACC00001002,Debit,1997.31,-310460.51,EUR,Grocery
TXN0000011416,2024-04-15T10:55:21,ACC00007891,Debit,851.66,-311312.17,EUR,Target
TXN0000011417,2024-03-31T14:34:16,ACC00007831,ATM,1405.44,-312717.61,EUR,Target
TXN0000011418,2024-12-17T00:53:19,ACC00001519,ATM,1680.43,-314398.04,JPY,Amazon
TXN0000011419,2024-07-10T02:31:23,ACC00001735,Debit,132.78,-314530.82,GBP,Online Store
TXN0000011420,2024-01-22T22:00:23,ACC00009138,Transfer,1060.17,-313470.65,EUR,Shell
TXN0000011421,2024-01-12T14:25:36,ACC00004609,ATM,208.13,-313678.78,USD,Starbucks
TXN0000011422,2024-02-09T20:31:00,ACC00001071,Transfer,443.52,-313235.26,JPY,Shell
TXN0000011423,2024-03-11T03:27:22,ACC00009104,Transfer,943.6,-312291.66,USD,Starbucks
TXN0000011424,2024-10-15T08:30:30,ACC00002685,ATM,1585.17,-313876.83,EUR,Target
TXN0000011425,2024-12-07T11:09:22,ACC00005534,Debit,627.61,-314504.44,USD,Restaurant
TXN0000011426,2024-10-20T02:14:34,ACC00006831,ATM,95.21,-314599.65,USD,Amazon
TXN0000011427,2024-11-07T01:17:01,ACC00005386,Debit,761.75,-315361.4,EUR,Grocery
TXN0000011428,2024-08-25T11:39:48,ACC00005792,ATM,1343.36,-316704.76,EUR,Restaurant
TXN0000011429,2024-10-06T19:25:36,ACC00000917,ATM,1360.28,-318065.04,EUR,Amazon
TXN0000011430,2024-05-29T20:31:30,ACC00004259,ATM,820.55,-318885.59,EUR,Starbucks
TXN0000011431,2024-10-15T08:34:22,ACC00008944,Transfer,1049.81,-317835.78,EUR,Shell
TXN0000011432,2024-04-09T14:25:58,ACC00002089,Payment,1535.67,-319371.45,GBP,Online Store
TXN0000011433,2024-02-26T03:59:13,ACC00004786,ATM,644.86,-320016.31,EUR,Walmart
TXN0000011434,2024-09-23T12:09:50,ACC00006611,Transfer,1350.39,-318665.92,JPY,Target
TXN0000011435,2024-01-26T14:54:44,ACC00008491,Payment,1535.96,-320201.88,JPY,Target
TXN0000011436,2024-12-14T15:17:45,ACC00001205,ATM,966.98,-321168.86,GBP,Grocery
TXN0000011437,2024-06-08T00:45:40,ACC00008840,Payment,1870.63,-323039.49,JPY,Target
TXN0000011438,2024-07-27T23:58:38,ACC00005168,Transfer,1312.34,-321727.15,EUR,Restaurant
TXN0000011439,2024-05-05T05:46:24,ACC00008796,Debit,457.49,-322184.64,JPY,Amazon
TXN0000011440,2024-06-15T10:16:01,ACC00002676,Payment,1915.61,-324100.25,USD,Starbucks
TXN0000011441,2024-09-10T04:19:31,ACC00003155,Payment,1707.46,-325807.71,USD,Shell
TXN0000011442,2024-10-13T10:23:44,ACC00003092,Credit,1684.42,-324123.29,EUR,Starbucks
TXN0000011443,2024-06-03T07:38:40,ACC00005914,ATM,748.26,-324871.55,JPY,Amazon
TXN0000011444,2024-07-10T08:56:52,ACC00002953,Credit,1869.34,-323002.21,GBP,Amazon
TXN0000011445,2024-12-07T18:45:54,ACC00005773,Payment,765.11,-323767.32,EUR,Starbucks
TXN0000011446,2024-07-11T10:56:26,ACC00008098,ATM,286.74,-324054.06,GBP,Amazon
TXN0000011447,2024-12-29T05:39:57,ACC00008078,Payment,1108.54,-325162.6,JPY,Shell
TXN0000011448,2024-04-18T15:00:39,ACC00003215,Credit,452.24,-324710.36,JPY,Starbucks
TXN0000011449,2024-11-07T12:00:17,ACC00009314,Credit,1342.79,-323367.57,JPY,Shell
TXN0000011450,2024-04-25T11:33:03,ACC00005215,Debit,1005.96,-324373.53,USD,Restaurant
TXN0000011451,2024-11-17T11:41:54,ACC00004107,Payment,558.61,-324932.14,USD,Online Store
TXN0000011452,2024-10-16T08:40:44,ACC00001863,Payment,1128.87,-326061.01,USD,Walmart
TXN0000011453,2024-05-14T17:22:37,ACC00004364,ATM,672.03,-326733.04,EUR,Online Store
TXN0000011454,2024-10-16T06:30:29,ACC00007052,Debit,1552.37,-328285.41,EUR,Walmart
TXN0000011455,2024-02-17T09:56:06,ACC00006847,Transfer,1042.87,-327242.54,JPY,Online Store
TXN0000011456,2024-05-10T08:21:41,ACC00006485,Transfer,558.35,-326684.19,EUR,Grocery
TXN0000011457,2024-06-12T14:35:57,ACC00008171,ATM,1803.56,-328487.75,GBP,Walmart
TXN0000011458,2024-04-04T15:49:29,ACC00006000,Credit,464.82,-328022.93,GBP,Starbucks
TXN0000011459,2024-02-11T19:10:02,ACC00000396,ATM,960.3,-328983.23,EUR,Starbucks
TXN0000011460,2024-10-05T09:41:18,ACC00001464,Debit,372.66,-329355.89,USD,Online Store
TXN0000011461,2024-10-30T16:22:19,ACC00004569,Debit,870.66,-330226.55,EUR,Walmart
TXN0000011462,2024-12-03T18:47:26,ACC00004877,Debit,913.08,-331139.63,GBP,Online Store
TXN0000011463,2024-07-29T11:32:33,ACC00001336,Credit,1935.02,-329204.61,GBP,Online Store
TXN0000011464,2024-11-21T03:44:52,ACC00003284,Payment,771.85,-329976.46,EUR,Restaurant
TXN0000011465,2024-06-10T09:20:51,ACC00002406,Payment,291.2,-330267.66,JPY,Starbucks
TXN0000011466,2024-07-08T07:11:53,ACC00001102,Credit,1476.36,-328791.3,USD,Restaurant
TXN0000011467,2024-07-10T04:30:20,ACC00002612,Payment,1286.61,-330077.91,EUR,Shell
TXN0000011468,2024-12-26T06:31:04,ACC00006770,Payment,82.89,-330160.8,JPY,Amazon
TXN0000011469,2024-12-22T10:22:47,ACC00007995,Transfer,419.54,-329741.26,EUR,Amazon
TXN0000011470,2024-06-01T07:47:18,ACC00009607,Debit,1108.5,-330849.76,USD,Grocery
TXN0000011471,2024-10-20T11:58:08,ACC00007657,ATM,1542.47,-332392.23,USD,Target
TXN0000011472,2024-08-18T14:21:17,ACC00009585,ATM,1532.42,-333924.65,EUR,Online Store
TXN0000011473,2024-01-05T14:57:06,ACC00003942,Credit,1559.26,-332365.39,GBP,Grocery
TXN0000011474,2024-02-18T11:19:57,ACC00005892,Payment,1760.03,-334125.42,USD,Grocery
TXN0000011475,2024-01-17T10:57:47,ACC00004239,Transfer,527.46,-333597.96,USD,Online Store
TXN0000011476,2024-01-25T09:56:38,ACC00002088,Payment,794.4,-334392.36,GBP,Grocery
TXN0000011477,2024-10-05T17:41:25,ACC00002918,ATM,1455.48,-335847.84,JPY,Amazon
TXN0000011478,2024-06-02T10:28:26,ACC00005323,Transfer,1333.18,-334514.66,EUR,Target
TXN0000011479,2024-11-13T11:45:11,ACC00004879,Transfer,919.83,-333594.83,JPY,Target
TXN0000011480,2024-10-10T09:17:22,ACC00004517,Debit,1855.94,-335450.77,JPY,Amazon
TXN0000011481,2024-03-16T17:16:18,ACC00004587,ATM,1576.6,-337027.37,JPY,Grocery
TXN0000011482,2024-08-20T11:50:22,ACC00001188,ATM,879.99,-337907.36,EUR,Online Store
TXN0000011483,2024-04-26T16:33:23,ACC00003196,Transfer,1132.54,-336774.82,USD,Walmart
TXN0000011484,2024-05-31T01:56:10,ACC00009168,Debit,392.77,-337167.59,EUR,Target
TXN0000011485,2024-12-17T21:02:14,ACC00009714,ATM,1975.07,-339142.66,EUR,Online Store
TXN0000011486,2024-08-14T23:16:23,ACC00000403,ATM,1686.92,-340829.58,USD,Walmart
TXN0000011487,2024-07-23T13:21:20,ACC00002992,Payment,1981.38,-342810.96,USD,Restaurant
TXN0000011488,2024-06-25T18:42:03,ACC00005291,Debit,1982.33,-344793.29,JPY,Amazon
TXN0000011489,2024-07-20T16:26:16,ACC00000385,Payment,1811.92,-346605.21,JPY,Target
TXN0000011490,2024-06-23T20:21:13,ACC00002845,Credit,1391.08,-345214.13,GBP,Restaurant
TXN0000011491,2024-01-22T14:31:56,ACC00001736,Credit,565.57,-344648.56,GBP,Starbucks
TXN0000011492,2024-02-26T19:34:45,ACC00001661,Transfer,1683.85,-342964.71,GBP,Grocery
TXN0000011493,2024-09-22T02:10:08,ACC00006190,Credit,675.53,-342289.18,GBP,Shell
TXN0000011494,2024-10-14T23:31:02,ACC00008124,Transfer,1827.45,-340461.73,JPY,Online Store
TXN0000011495,2024-09-11T23:44:21,ACC00004459,Debit,123.82,-340585.55,EUR,Grocery
TXN0000011496,2024-05-06T14:15:37,ACC00000777,Transfer,1504.56,-339080.99,EUR,Grocery
TXN0000011497,2024-06-22T18:09:09,ACC00007574,ATM,1996.46,-341077.45,USD,Grocery
TXN0000011498,2024-02-22T04:33:11,ACC00005844,ATM,1104.83,-342182.28,JPY,Target
TXN0000011499,2024-08-16T02:27:46,ACC00002053,Debit,351.63,-342533.91,EUR,Shell
TXN0000011500,2024-05-26T03:53:03,ACC00002311,Payment,1088.47,-343622.38,USD,Amazon
TXN0000011501,2024-02-27T00:16:02,ACC00009331,Debit,722.97,-344345.35,JPY,Online Store
TXN0000011502,2024-03-19T01:11:54,ACC00007594,Payment,251.48,-344596.83,USD,Amazon
TXN0000011503,2024-02-09T23:08:04,ACC00005337,Transfer,1785.78,-342811.05,EUR,Amazon
TXN0000011504,2024-07-31T07:49:52,ACC00008224,ATM,1658.86,-344469.91,EUR,Starbucks
TXN0000011505,2024-01-22T10:06:25,ACC00009974,Payment,1375.9,-345845.81,USD,Amazon
TXN0000011506,2024-07-08T10:01:03,ACC00002891,Payment,90.18,-345935.99,USD,Online Store
TXN0000011507,2024-09-26T15:49:37,ACC00009739,Credit,1536.0,-344399.99,USD,Grocery
TXN0000011508,2024-03-25T07:11:09,ACC00009724,Credit,1053.14,-343346.85,EUR,Online Store
TXN0000011509,2024-10-15T18:29:32,ACC00002069,Credit,663.49,-342683.36,JPY,Target
TXN0000011510,2024-12-15T16:18:09,ACC00001895,ATM,128.42,-342811.78,EUR,Restaurant
TXN0000011511,2024-11-08T18:46:43,ACC00004483,Transfer,988.81,-341822.97,JPY,Target
TXN0000011512,2024-12-19T01:27:23,ACC00003671,Credit,69.46,-341753.51,USD,Restaurant
TXN0000011513,2024-10-22T07:27:14,ACC00007756,Payment,904.17,-342657.68,GBP,Target
TXN0000011514,2024-11-19T06:31:29,ACC00008143,Transfer,53.45,-342604.23,USD,Starbucks
TXN0000011515,2024-11-10T06:23:44,ACC00007975,Payment,498.21,-343102.44,USD,Shell
TXN0000011516,2024-03-01T04:49:12,ACC00002279,Debit,818.1,-343920.54,USD,Grocery
TXN0000011517,2024-01-07T18:08:42,ACC00008517,Payment,181.01,-344101.55,JPY,Online Store
TXN0000011518,2024-12-06T06:48:50,ACC00009606,Credit,650.96,-343450.59,GBP,Restaurant
TXN0000011519,2024-08-16T15:09:47,ACC00002268,Debit,1720.92,-345171.51,GBP,Restaurant
TXN0000011520,2024-05-27T10:05:33,ACC00005146,ATM,562.19,-345733.7,JPY,Target
TXN0000011521,2024-04-13T16:19:32,ACC00006165,Credit,317.88,-345415.82,USD,Amazon
TXN0000011522,2024-11-07T10:23:39,ACC00003565,Credit,780.68,-344635.14,EUR,Amazon
TXN0000011523,2024-04-26T17:36:54,ACC00006617,Debit,1360.25,-345995.39,EUR,Restaurant
TXN0000011524,2024-09-26T17:20:54,ACC00007482,Credit,1681.1,-344314.29,USD,Amazon
TXN0000011525,2024-01-09T17:45:47,ACC00006510,Credit,791.19,-343523.1,JPY,Walmart
TXN0000011526,2024-04-30T10:06:34,ACC00002540,Debit,1831.23,-345354.33,JPY,Target
TXN0000011527,2024-08-24T05:51:03,ACC00003753,Debit,659.23,-346013.56,EUR,Grocery
TXN0000011528,2024-05-11T00:03:16,ACC00003757,Transfer,622.0,-345391.56,USD,Amazon
TXN0000011529,2024-10-23T22:55:22,ACC00003554,Credit,487.86,-344903.7,GBP,Target
TXN0000011530,2024-02-13T00:04:41,ACC00005150,Payment,445.21,-345348.91,EUR,Target
TXN0000011531,2024-03-18T10:09:15,ACC00001665,Transfer,1266.66,-344082.25,JPY,Online Store
TXN0000011532,2024-03-31T15:00:25,ACC00005421,Credit,1275.91,-342806.34,USD,Starbucks
TXN0000011533,2024-02-01T03:58:24,ACC00007177,Payment,1780.37,-344586.71,GBP,Shell
TXN0000011534,2024-09-21T12:26:35,ACC00002988,Debit,944.39,-345531.1,USD,Target
TXN0000011535,2024-05-09T03:28:59,ACC00006567,Debit,1173.61,-346704.71,JPY,Online Store
TXN0000011536,2024-10-02T13:20:10,ACC00004679,Transfer,407.21,-346297.5,EUR,Grocery
TXN0000011537,2024-01-03T00:48:39,ACC00009736,Payment,562.44,-346859.94,JPY,Grocery
TXN0000011538,2024-11-19T00:37:01,ACC00009904,ATM,1313.66,-348173.6,USD,Grocery
TXN0000011539,2024-10-03T15:18:23,ACC00008324,Credit,1292.21,-346881.39,JPY,Amazon
TXN0000011540,2024-06-30T23:38:16,ACC00006101,Debit,1745.49,-348626.88,USD,Shell
TXN0000011541,2024-06-04T16:04:57,ACC00000479,Payment,1699.32,-350326.2,JPY,Restaurant
TXN0000011542,2024-11-21T19:30:13,ACC00007862,Transfer,96.29,-350229.91,EUR,Shell
TXN0000011543,2024-11-26T16:43:55,ACC00009012,ATM,1976.18,-352206.09,GBP,Restaurant
TXN0000011544,2024-11-25T22:52:07,ACC00000243,ATM,1817.29,-354023.38,JPY,Grocery
TXN0000011545,2024-05-03T14:41:41,ACC00007624,Transfer,220.1,-353803.28,EUR,Amazon
TXN0000011546,2024-07-23T00:31:41,ACC00004713,Credit,1046.11,-352757.17,USD,Amazon
TXN0000011547,2024-12-15T11:19:20,ACC00009657,Debit,289.46,-353046.63,USD,Walmart
TXN0000011548,2024-06-26T07:20:13,ACC00008147,ATM,1152.93,-354199.56,JPY,Walmart
TXN0000011549,2024-02-14T15:26:42,ACC00004815,Transfer,533.82,-353665.74,USD,Online Store
TXN0000011550,2024-06-17T21:24:16,ACC00003127,Debit,1173.43,-354839.17,EUR,Walmart
TXN0000011551,2024-11-24T15:12:32,ACC00004162,Credit,791.05,-354048.12,USD,Starbucks
TXN0000011552,2024-04-19T09:11:30,ACC00000250,ATM,903.46,-354951.58,JPY,Starbucks
TXN0000011553,2024-09-23T09:55:00,ACC00000947,Credit,926.05,-354025.53,JPY,Starbucks
TXN0000011554,2024-03-28T23:07:33,ACC00008966,ATM,970.02,-354995.55,GBP,Shell
TXN0000011555,2024-09-05T22:25:26,ACC00008484,Debit,1245.39,-356240.94,EUR,Restaurant
TXN0000011556,2024-06-23T20:33:13,ACC00009670,Debit,1304.31,-357545.25,GBP,Restaurant
TXN0000011557,2024-10-30T22:12:02,ACC00007463,ATM,585.5,-358130.75,EUR,Starbucks
TXN0000011558,2024-02-13T20:21:31,ACC00008228,Debit,101.79,-358232.54,USD,Target
TXN0000011559,2024-12-12T18:30:13,ACC00007909,Payment,842.31,-359074.85,EUR,Shell
TXN0000011560,2024-03-22T23:58:09,ACC00003781,Debit,314.21,-359389.06,JPY,Shell
TXN0000011561,2024-01-21T01:04:43,ACC00003751,Payment,1764.45,-361153.51,EUR,Amazon
TXN0000011562,2024-02-26T00:06:27,ACC00009842,Payment,1292.9,-362446.41,GBP,Starbucks
TXN0000011563,2024-11-21T17:48:42,ACC00003224,Transfer,327.38,-362119.03,JPY,Target
TXN0000011564,2024-09-11T19:32:16,ACC00009310,Payment,1583.15,-363702.18,JPY,Online Store
TXN0000011565,2024-11-01T11:23:19,ACC00004673,Debit,31.75,-363733.93,USD,Amazon
TXN0000011566,2024-04-11T19:56:38,ACC00006806,Transfer,1349.32,-362384.61,EUR,Amazon
TXN0000011567,2024-05-26T20:48:26,ACC00005801,Debit,1751.07,-364135.68,USD,Target
TXN0000011568,2024-02-12T19:52:09,ACC00002415,Credit,93.74,-364041.94,GBP,Starbucks
TXN0000011569,2024-11-05T02:30:27,ACC00006546,Transfer,1906.13,-362135.81,JPY,Shell
TXN0000011570,2024-10-29T05:49:31,ACC00005243,Debit,339.1,-362474.91,GBP,Online Store
TXN0000011571,2024-06-02T05:30:24,ACC00006517,Credit,1933.35,-360541.56,GBP,Online Store
TXN0000011572,2024-04-23T20:58:41,ACC00009452,Credit,128.72,-360412.84,EUR,Grocery
TXN0000011573,2024-03-19T19:36:20,ACC00006105,ATM,740.39,-361153.23,JPY,Online Store
TXN0000011574,2024-12-26T17:50:44,ACC00006485,Transfer,1050.84,-360102.39,JPY,Target
TXN0000011575,2024-11-23T22:21:30,ACC00008978,Credit,1462.19,-358640.2,EUR,Amazon
TXN0000011576,2024-12-23T13:26:10,ACC00003932,Credit,614.24,-358025.96,GBP,Online Store
TXN0000011577,2024-03-06T08:44:27,ACC00005052,ATM,1274.15,-359300.11,USD,Target
TXN0000011578,2024-07-04T10:43:34,ACC00008887,Debit,1580.84,-360880.95,USD,Amazon
TXN0000011579,2024-10-26T07:02:35,ACC00009316,Credit,1951.89,-358929.06,GBP,Restaurant
TXN0000011580,2024-05-07T19:49:20,ACC00009595,Debit,1073.99,-360003.05,JPY,Restaurant
TXN0000011581,2024-09-29T10:00:45,ACC00002436,ATM,73.81,-360076.86,JPY,Restaurant
TXN0000011582,2024-05-11T06:11:33,ACC00009843,Debit,703.11,-360779.97,JPY,Online Store
TXN0000011583,2024-04-26T16:51:44,ACC00002761,ATM,1332.64,-362112.61,EUR,Restaurant
TXN0000011584,2024-12-25T10:01:01,ACC00001749,Payment,837.26,-362949.87,JPY,Starbucks
TXN0000011585,2024-04-24T19:42:32,ACC00009833,Debit,549.66,-363499.53,GBP,Grocery
TXN0000011586,2024-01-12T04:07:36,ACC00006652,Credit,552.36,-362947.17,JPY,Restaurant
TXN0000011587,2024-06-15T00:42:58,ACC00007155,Credit,787.99,-362159.18,USD,Starbucks
TXN0000011588,2024-05-06T07:13:35,ACC00002354,Debit,1711.6,-363870.78,JPY,Target
TXN0000011589,2024-03-12T17:25:50,ACC00005445,Transfer,1807.27,-362063.51,JPY,Shell
TXN0000011590,2024-03-23T07:30:30,ACC00002966,Credit,1101.99,-360961.52,JPY,Shell
TXN0000011591,2024-05-20T18:20:09,ACC00003737,Payment,1190.24,-362151.76,JPY,Walmart
TXN0000011592,2024-02-15T11:36:13,ACC00008981,ATM,788.58,-362940.34,EUR,Online Store
TXN0000011593,2024-04-09T15:42:10,ACC00002923,Debit,1018.58,-363958.92,USD,Restaurant
TXN0000011594,2024-04-01T21:59:36,ACC00001485,Credit,398.8,-363560.12,JPY,Target
TXN0000011595,2024-12-21T17:31:11,ACC00004747,Payment,373.99,-363934.11,EUR,Online Store
TXN0000011596,2024-04-12T08:47:38,ACC00009188,Debit,1829.32,-365763.43,GBP,Amazon
TXN0000011597,2024-08-16T15:40:58,ACC00007851,Payment,1698.78,-367462.21,USD,Walmart
TXN0000011598,2024-05-06T16:34:12,ACC00007487,Payment,1397.11,-368859.32,EUR,Restaurant
TXN0000011599,2024-09-18T23:09:02,ACC00005222,ATM,536.63,-369395.95,USD,Online Store
TXN0000011600,2024-12-16T10:38:51,ACC00000660,Payment,886.34,-370282.29,GBP,Restaurant
TXN0000011601,2024-01-28T23:49:41,ACC00006177,Debit,674.03,-370956.32,GBP,Online Store
TXN0000011602,2024-08-03T21:23:34,ACC00008618,Credit,1011.09,-369945.23,EUR,Grocery
TXN0000011603,2024-11-14T15:13:40,ACC00008826,Transfer,1290.61,-368654.62,USD,Restaurant
TXN0000011604,2024-02-25T05:53:44,ACC00005648,Credit,1829.54,-366825.08,USD,Shell
TXN0000011605,2024-10-16T18:26:43,ACC00009735,Credit,1069.71,-365755.37,JPY,Amazon
TXN0000011606,2024-06-08T11:40:50,ACC00001830,Payment,64.86,-365820.23,GBP,Grocery
TXN0000011607,2024-12-07T20:17:00,ACC00006566,Credit,1742.71,-364077.52,USD,Target
TXN0000011608,2024-07-17T18:48:34,ACC00009459,Payment,1604.99,-365682.51,JPY,Grocery
TXN0000011609,2024-07-24T13:30:46,ACC00008392,Debit,1622.8,-367305.31,GBP,Starbucks
TXN0000011610,2024-12-01T09:53:31,ACC00007847,Credit,67.78,-367237.53,GBP,Restaurant
TXN0000011611,2024-03-28T02:30:52,ACC00006886,Payment,1016.04,-368253.57,EUR,Amazon
TXN0000011612,2024-07-15T11:11:28,ACC00004358,Payment,291.23,-368544.8,EUR,Online Store
TXN0000011613,2024-03-22T10:42:07,ACC00006313,Payment,715.39,-369260.19,JPY,Target
TXN0000011614,2024-06-10T09:56:45,ACC00002964,Payment,289.14,-369549.33,JPY,Grocery
TXN0000011615,2024-11-17T00:52:48,ACC00007705,ATM,279.1,-369828.43,USD,Amazon
TXN0000011616,2024-09-21T02:58:33,ACC00008064,Credit,751.29,-369077.14,JPY,Grocery
TXN0000011617,2024-04-04T03:27:35,ACC00003927,Payment,1931.8,-371008.94,GBP,Walmart
TXN0000011618,2024-01-07T11:46:26,ACC00000841,Credit,1087.52,-369921.42,EUR,Target
TXN0000011619,2024-12-18T02:54:37,ACC00004149,Debit,298.97,-370220.39,GBP,Target
TXN0000011620,2024-10-03T20:59:49,ACC00002848,ATM,1910.91,-372131.3,USD,Starbucks
TXN0000011621,2024-02-29T17:48:30,ACC00005493,Transfer,861.22,-371270.08,EUR,Walmart
TXN0000011622,2024-01-15T01:30:03,ACC00007180,ATM,1424.65,-372694.73,EUR,Shell
TXN0000011623,2024-01-27T08:51:33,ACC00004661,Payment,1947.85,-374642.58,GBP,Target
TXN0000011624,2024-10-15T02:30:36,ACC00005702,Transfer,870.03,-373772.55,GBP,Restaurant
TXN0000011625,2024-10-15T05:59:19,ACC00007337,Credit,1333.27,-372439.28,GBP,Grocery
TXN0000011626,2024-09-08T08:32:26,ACC00006357,Credit,1922.27,-370517.01,USD,Amazon
TXN0000011627,2024-08-13T01:11:06,ACC00005684,ATM,1820.95,-372337.96,EUR,Online Store
TXN0000011628,2024-12-14T05:09:47,ACC00000999,Transfer,134.56,-372203.4,EUR,Amazon
TXN0000011629,2024-11-27T23:40:54,ACC00008488,Transfer,88.98,-372114.42,JPY,Target
TXN0000011630,2024-08-08T00:02:57,ACC00009360,ATM,552.47,-372666.89,USD,Target
TXN0000011631,2024-01-02T12:50:55,ACC00007052,ATM,835.27,-373502.16,JPY,Online Store
TXN0000011632,2024-08-12T18:34:14,ACC00006217,ATM,1803.76,-375305.92,USD,Target
TXN0000011633,2024-10-13T02:39:14,ACC00001521,Payment,516.43,-375822.35,JPY,Amazon
TXN0000011634,2024-05-10T12:46:03,ACC00007371,Debit,1770.71,-377593.06,USD,Target
TXN0000011635,2024-08-25T21:15:14,ACC00004213,ATM,1528.89,-379121.95,EUR,Restaurant
TXN0000011636,2024-05-04T02:34:38,ACC00000033,ATM,112.18,-379234.13,GBP,Shell
TXN0000011637,2024-06-05T00:30:46,ACC00003218,ATM,1639.42,-380873.55,USD,Shell
TXN0000011638,2024-03-02T08:23:00,ACC00005747,ATM,1596.6,-382470.15,JPY,Amazon
TXN0000011639,2024-06-07T06:17:30,ACC00003100,Transfer,1008.82,-381461.33,GBP,Walmart
TXN0000011640,2024-05-22T14:55:33,ACC00001790,ATM,293.26,-381754.59,JPY,Amazon
TXN0000011641,2024-07-02T22:52:56,ACC00007613,ATM,135.8,-381890.39,JPY,Walmart
TXN0000011642,2024-04-10T08:19:51,ACC00000014,Credit,1731.32,-380159.07,EUR,Online Store
TXN0000011643,2024-02-05T16:20:24,ACC00004248,ATM,1215.39,-381374.46,EUR,Restaurant
TXN0000011644,2024-09-13T21:53:29,ACC00004004,Credit,808.55,-380565.91,USD,Walmart
TXN0000011645,2024-09-04T22:43:18,ACC00004820,Transfer,364.78,-380201.13,JPY,Grocery
TXN0000011646,2024-09-24T06:46:27,ACC00006922,ATM,475.98,-380677.11,JPY,Starbucks
TXN0000011647,2024-03-12T01:12:08,ACC00007492,Transfer,1665.77,-379011.34,JPY,Walmart
TXN0000011648,2024-02-18T16:08:10,ACC00001829,ATM,424.2,-379435.54,EUR,Restaurant
TXN0000011649,2024-08-22T18:52:52,ACC00008508,ATM,24.67,-379460.21,GBP,Target
TXN0000011650,2024-07-16T06:59:46,ACC00003024,Payment,282.25,-379742.46,GBP,Shell
TXN0000011651,2024-03-14T12:24:19,ACC00007265,Credit,459.85,-379282.61,USD,Walmart
TXN0000011652,2024-07-13T04:56:34,ACC00004739,Payment,237.28,-379519.89,EUR,Grocery
TXN0000011653,2024-06-15T21:39:05,ACC00004596,Payment,917.44,-380437.33,USD,Starbucks
TXN0000011654,2024-02-04T23:40:33,ACC00007477,Credit,1879.26,-378558.07,EUR,Restaurant
TXN0000011655,2024-08-17T19:12:13,ACC00001827,Payment,514.54,-379072.61,JPY,Restaurant
TXN0000011656,2024-11-18T07:58:38,ACC00006062,Payment,397.39,-379470.0,USD,Restaurant
TXN0000011657,2024-02-29T13:54:50,ACC00001358,Debit,521.45,-379991.45,EUR,Online Store
TXN0000011658,2024-05-11T08:35:17,ACC00008041,Credit,1719.55,-378271.9,GBP,Online Store
TXN0000011659,2024-06-09T00:12:53,ACC00008914,Payment,551.68,-378823.58,USD,Restaurant
TXN0000011660,2024-10-28T20:47:57,ACC00005902,Transfer,1941.88,-376881.7,USD,Amazon
TXN0000011661,2024-04-09T07:29:38,ACC00000271,Debit,1402.23,-378283.93,USD,Amazon
TXN0000011662,2024-07-03T16:35:49,ACC00002097,Payment,93.46,-378377.39,USD,Shell
TXN0000011663,2024-01-07T07:53:44,ACC00006419,ATM,160.56,-378537.95,USD,Starbucks
TXN0000011664,2024-06-13T07:20:31,ACC00005273,Debit,562.25,-379100.2,GBP,Grocery
TXN0000011665,2024-04-01T14:04:04,ACC00008813,ATM,877.69,-379977.89,USD,Restaurant
TXN0000011666,2024-08-05T08:27:05,ACC00009948,Credit,1844.36,-378133.53,EUR,Restaurant
TXN0000011667,2024-07-11T10:33:35,ACC00002401,Transfer,1097.27,-377036.26,USD,Walmart
TXN0000011668,2024-05-20T11:44:14,ACC00000064,Transfer,309.49,-376726.77,EUR,Shell
TXN0000011669,2024-10-15T11:44:43,ACC00007788,ATM,1222.14,-377948.91,JPY,Starbucks
TXN0000011670,2024-11-07T02:03:14,ACC00002880,Payment,181.2,-378130.11,JPY,Walmart
TXN0000011671,2024-02-27T03:52:11,ACC00002284,Transfer,1364.87,-376765.24,GBP,Grocery
TXN0000011672,2024-02-10T08:02:25,ACC00000158,Transfer,604.8,-376160.44,GBP,Amazon
TXN0000011673,2024-12-18T11:54:25,ACC00000549,Payment,772.63,-376933.07,USD,Target
TXN0000011674,2024-05-06T18:23:08,ACC00009463,ATM,1261.03,-378194.1,USD,Walmart
TXN0000011675,2024-07-14T09:04:26,ACC00001869,Payment,1350.73,-379544.83,EUR,Grocery
TXN0000011676,2024-12-21T11:42:27,ACC00005136,Credit,1813.21,-377731.62,USD,Grocery
TXN0000011677,2024-02-18T21:52:48,ACC00007820,Transfer,538.34,-377193.28,JPY,Target
TXN0000011678,2024-06-16T12:06:14,ACC00000502,Transfer,1328.72,-375864.56,USD,Target
TXN0000011679,2024-04-02T05:19:00,ACC00008841,Transfer,29.17,-375835.39,EUR,Amazon
TXN0000011680,2024-12-24T00:15:34,ACC00009781,ATM,586.58,-376421.97,JPY,Starbucks
TXN0000011681,2024-01-22T23:25:58,ACC00008739,Debit,966.48,-377388.45,JPY,Starbucks
TXN0000011682,2024-03-27T12:20:20,ACC00007609,Debit,662.36,-378050.81,GBP,Walmart
TXN0000011683,2024-05-05T09:43:59,ACC00001885,Debit,162.01,-378212.82,JPY,Shell
TXN0000011684,2024-02-21T23:55:57,ACC00005353,ATM,1969.89,-380182.71,JPY,Grocery
TXN0000011685,2024-10-22T05:08:45,ACC00007881,Payment,1002.05,-381184.76,USD,Walmart
TXN0000011686,2024-07-23T12:45:58,ACC00000921,ATM,158.88,-381343.64,USD,Walmart
TXN0000011687,2024-10-23T10:57:45,ACC00003896,ATM,523.67,-381867.31,JPY,Starbucks
TXN0000011688,2024-11-18T00:02:13,ACC00007637,Transfer,660.69,-381206.62,JPY,Amazon
TXN0000011689,2024-06-01T02:17:27,ACC00004189,ATM,782.27,-381988.89,JPY,Target
TXN0000011690,2024-12-16T18:56:07,ACC00002862,Payment,144.36,-382133.25,USD,Shell
TXN0000011691,2024-08-25T23:26:03,ACC00003746,ATM,1629.84,-383763.09,EUR,Online Store
TXN0000011692,2024-03-12T02:16:43,ACC00001512,Transfer,477.6,-383285.49,USD,Starbucks
TXN0000011693,2024-04-18T23:37:50,ACC00006450,Credit,691.06,-382594.43,EUR,Walmart
TXN0000011694,2024-01-11T05:52:52,ACC00004466,Credit,784.97,-381809.46,USD,Amazon
TXN0000011695,2024-07-08T08:28:47,ACC00005212,Debit,599.14,-382408.6,GBP,Walmart
TXN0000011696,2024-04-03T01:21:58,ACC00003487,Credit,874.32,-381534.28,USD,Walmart
TXN0000011697,2024-09-02T06:34:26,ACC00006016,Payment,1295.24,-382829.52,USD,Restaurant
TXN0000011698,2024-01-02T10:25:55,ACC00009622,Transfer,430.64,-382398.88,GBP,Starbucks
TXN0000011699,2024-01-20T01:39:13,ACC00008694,ATM,1138.85,-383537.73,USD,Amazon
TXN0000011700,2024-04-10T18:37:11,ACC00005457,ATM,1653.41,-385191.14,JPY,Amazon
TXN0000011701,2024-01-31T04:17:39,ACC00006897,Transfer,374.04,-384817.1,JPY,Restaurant
TXN0000011702,2024-02-06T12:24:03,ACC00002012,Transfer,52.99,-384764.11,EUR,Restaurant
TXN0000011703,2024-08-04T19:18:08,ACC00003803,Debit,949.66,-385713.77,JPY,Shell
TXN0000011704,2024-07-15T09:46:03,ACC00004716,Debit,249.21,-385962.98,GBP,Target
TXN0000011705,2024-09-27T12:58:56,ACC00000566,Payment,1206.69,-387169.67,EUR,Shell
TXN0000011706,2024-02-21T09:52:38,ACC00002354,Payment,1130.48,-388300.15,USD,Online Store
TXN0000011707,2024-10-16T09:12:34,ACC00000182,Debit,504.94,-388805.09,GBP,Online Store
TXN0000011708,2024-03-31T02:55:32,ACC00008936,Debit,1711.2,-390516.29,JPY,Walmart
TXN0000011709,2024-03-18T07:15:21,ACC00007037,ATM,1927.7,-392443.99,GBP,Grocery
TXN0000011710,2024-08-09T03:08:22,ACC00003777,Transfer,1349.27,-391094.72,GBP,Shell
TXN0000011711,2024-12-04T19:10:07,ACC00003598,Transfer,1984.43,-389110.29,USD,Walmart
TXN0000011712,2024-03-31T04:12:42,ACC00008146,ATM,1284.15,-390394.44,EUR,Target
TXN0000011713,2024-07-19T11:08:45,ACC00005713,Transfer,281.78,-390112.66,GBP,Restaurant
TXN0000011714,2024-08-31T01:39:37,ACC00009104,Credit,1813.21,-388299.45,EUR,Restaurant
TXN0000011715,2024-03-31T22:34:24,ACC00009964,Credit,948.93,-387350.52,USD,Restaurant
TXN0000011716,2024-09-22T16:00:10,ACC00009828,Payment,511.5,-387862.02,EUR,Walmart
TXN0000011717,2024-09-06T16:41:25,ACC00001296,Transfer,1840.46,-386021.56,GBP,Shell
TXN0000011718,2024-06-29T09:03:52,ACC00008953,Debit,281.41,-386302.97,EUR,Shell
TXN0000011719,2024-07-27T23:45:03,ACC00006009,ATM,282.11,-386585.08,EUR,Restaurant
TXN0000011720,2024-09-01T18:08:57,ACC00009738,Payment,1860.87,-388445.95,GBP,Walmart
TXN0000011721,2024-06-03T16:56:15,ACC00006064,Payment,1357.74,-389803.69,EUR,Walmart
TXN0000011722,2024-01-08T19:01:47,ACC00004334,Transfer,30.46,-389773.23,USD,Restaurant
TXN0000011723,2024-05-17T17:02:38,ACC00008727,Credit,1188.11,-388585.12,EUR,Walmart
TXN0000011724,2024-08-11T00:29:48,ACC00006936,Debit,1348.64,-389933.76,USD,Target
TXN0000011725,2024-05-08T13:49:46,ACC00008937,ATM,1946.18,-391879.94,EUR,Amazon
TXN0000011726,2024-07-05T10:56:40,ACC00003487,Debit,200.35,-392080.29,USD,Walmart
TXN0000011727,2024-06-16T22:18:09,ACC00004833,Payment,1795.1,-393875.39,EUR,Restaurant
TXN0000011728,2024-10-28T03:57:43,ACC00002678,Transfer,1789.87,-392085.52,GBP,Online Store
TXN0000011729,2024-06-09T00:12:45,ACC00000840,Payment,682.11,-392767.63,JPY,Restaurant
TXN0000011730,2024-06-06T18:51:51,ACC00007325,Credit,1854.1,-390913.53,USD,Online Store
TXN0000011731,2024-08-12T04:14:00,ACC00009526,Debit,1491.73,-392405.26,EUR,Shell
TXN0000011732,2024-06-02T22:59:03,ACC00004736,Transfer,265.89,-392139.37,JPY,Target
TXN0000011733,2024-11-10T10:02:03,ACC00009325,Debit,639.1,-392778.47,USD,Starbucks
TXN0000011734,2024-03-02T17:32:08,ACC00004107,Transfer,972.89,-391805.58,GBP,Grocery
TXN0000011735,2024-08-05T00:52:58,ACC00007681,Payment,1741.18,-393546.76,EUR,Amazon
TXN0000011736,2024-04-24T20:02:29,ACC00005036,ATM,1054.85,-394601.61,JPY,Grocery
TXN0000011737,2024-03-24T17:46:40,ACC00005196,Credit,1801.54,-392800.07,JPY,Starbucks
TXN0000011738,2024-11-04T03:40:10,ACC00005554,Debit,660.64,-393460.71,GBP,Online Store
TXN0000011739,2024-09-12T16:22:33,ACC00001658,Payment,259.65,-393720.36,EUR,Target
TXN0000011740,2024-05-30T11:13:57,ACC00005029,ATM,703.12,-394423.48,GBP,Grocery
TXN0000011741,2024-04-08T22:41:48,ACC00005184,Transfer,98.14,-394325.34,USD,Online Store
TXN0000011742,2024-04-25T16:55:56,ACC00004133,ATM,257.07,-394582.41,EUR,Target
TXN0000011743,2024-05-17T06:36:21,ACC00006909,Credit,796.34,-393786.07,EUR,Restaurant
TXN0000011744,2024-08-08T04:52:27,ACC00004211,Payment,356.15,-394142.22,JPY,Amazon
TXN0000011745,2024-10-27T16:15:59,ACC00004189,ATM,1923.67,-396065.89,GBP,Starbucks
TXN0000011746,2024-12-12T09:33:56,ACC00005303,Transfer,740.39,-395325.5,EUR,Online Store
TXN0000011747,2024-04-01T13:13:36,ACC00004842,Credit,406.69,-394918.81,EUR,Amazon
TXN0000011748,2024-05-26T00:29:40,ACC00006623,Transfer,215.06,-394703.75,GBP,Amazon
TXN0000011749,2024-08-19T07:39:39,ACC00007894,ATM,518.12,-395221.87,JPY,Target
TXN0000011750,2024-05-04T19:21:43,ACC00006991,Credit,227.35,-394994.52,USD,Target
TXN0000011751,2024-09-06T12:40:56,ACC00008845,Transfer,207.35,-394787.17,USD,Target
TXN0000011752,2024-10-27T02:23:39,ACC00003797,Credit,1255.5,-393531.67,EUR,Walmart
TXN0000011753,2024-11-05T16:02:02,ACC00006425,ATM,1599.34,-395131.01,GBP,Restaurant
TXN0000011754,2024-03-05T11:55:03,ACC00000701,ATM,894.76,-396025.77,USD,Target
TXN0000011755,2024-10-12T10:53:51,ACC00006606,Credit,467.19,-395558.58,GBP,Walmart
TXN0000011756,2024-01-07T14:43:43,ACC00003471,Transfer,1051.49,-394507.09,EUR,Online Store
TXN0000011757,2024-07-30T11:42:57,ACC00006725,Debit,1247.91,-395755.0,USD,Grocery
TXN0000011758,2024-06-03T07:56:48,ACC00009164,Payment,1083.49,-396838.49,USD,Restaurant
TXN0000011759,2024-07-05T02:06:21,ACC00000054,Credit,1880.15,-394958.34,USD,Shell
TXN0000011760,2024-02-13T07:32:20,ACC00003654,Payment,1767.49,-396725.83,GBP,Walmart
TXN0000011761,2024-06-27T17:54:47,ACC00001997,Credit,1580.28,-395145.55,JPY,Starbucks
TXN0000011762,2024-10-14T00:25:01,ACC00005344,Payment,1172.74,-396318.29,USD,Online Store
TXN0000011763,2024-02-07T10:45:11,ACC00002693,Transfer,658.05,-395660.24,JPY,Starbucks
TXN0000011764,2024-09-15T06:00:17,ACC00005831,Credit,981.41,-394678.83,JPY,Starbucks
TXN0000011765,2024-11-20T22:35:11,ACC00007057,Credit,1486.26,-393192.57,GBP,Grocery
TXN0000011766,2024-06-25T21:46:19,ACC00000082,ATM,163.26,-393355.83,JPY,Starbucks
TXN0000011767,2024-10-08T02:57:09,ACC00000971,Transfer,1488.11,-391867.72,GBP,Target
TXN0000011768,2024-04-11T10:53:26,ACC00004164,Debit,1651.17,-393518.89,EUR,Online Store
TXN0000011769,2024-12-21T12:01:57,ACC00002773,Payment,22.89,-393541.78,USD,Amazon
TXN0000011770,2024-11-26T08:58:44,ACC00008765,Payment,1702.1,-395243.88,GBP,Target
TXN0000011771,2024-04-09T13:27:49,ACC00007617,Payment,634.67,-395878.55,GBP,Shell
TXN0000011772,2024-12-20T19:27:15,ACC00009405,Payment,818.86,-396697.41,GBP,Grocery
TXN0000011773,2024-09-12T16:48:54,ACC00005692,Debit,834.31,-397531.72,GBP,Walmart
TXN0000011774,2024-01-06T17:22:46,ACC00001498,Transfer,101.69,-397430.03,EUR,Online Store
TXN0000011775,2024-02-27T17:53:49,ACC00007125,Debit,731.64,-398161.67,EUR,Walmart
TXN0000011776,2024-03-16T19:34:32,ACC00001294,Payment,1087.64,-399249.31,GBP,Restaurant
TXN0000011777,2024-03-02T08:49:12,ACC00000856,Debit,1031.15,-400280.46,JPY,Starbucks
TXN0000011778,2024-12-20T22:44:44,ACC00000667,Payment,1955.44,-402235.9,JPY,Starbucks
TXN0000011779,2024-05-13T15:13:22,ACC00004813,Transfer,1838.85,-400397.05,USD,Starbucks
TXN0000011780,2024-11-01T00:59:57,ACC00008350,Credit,310.92,-400086.13,USD,Target
TXN0000011781,2024-06-18T04:20:11,ACC00000850,Transfer,1876.8,-398209.33,GBP,Walmart
TXN0000011782,2024-06-16T10:27:02,ACC00005039,Transfer,931.89,-397277.44,USD,Grocery
TXN0000011783,2024-07-11T17:55:03,ACC00008912,ATM,1508.37,-398785.81,JPY,Grocery
TXN0000011784,2024-08-24T15:30:58,ACC00007903,Debit,537.97,-399323.78,USD,Grocery
TXN0000011785,2024-11-09T01:16:23,ACC00002991,Payment,1217.96,-400541.74,EUR,Online Store
TXN0000011786,2024-04-27T17:44:54,ACC00003584,Debit,1119.51,-401661.25,USD,Amazon
TXN0000011787,2024-11-13T19:28:53,ACC00008301,Debit,1652.18,-403313.43,JPY,Starbucks
TXN0000011788,2024-01-05T05:50:03,ACC00006400,Debit,1509.97,-404823.4,JPY,Grocery
TXN0000011789,2024-05-24T22:13:40,ACC00004506,Payment,1522.95,-406346.35,USD,Target
TXN0000011790,2024-02-17T12:55:38,ACC00007992,ATM,1145.65,-407492.0,USD,Target
TXN0000011791,2024-04-30T18:27:56,ACC00008301,Debit,332.85,-407824.85,JPY,Target
TXN0000011792,2024-09-04T01:28:26,ACC00000726,ATM,1168.83,-408993.68,JPY,Grocery
TXN0000011793,2024-10-26T04:40:22,ACC00007332,Transfer,1480.52,-407513.16,JPY,Starbucks
TXN0000011794,2024-04-14T21:44:18,ACC00003872,Payment,1482.86,-408996.02,USD,Shell
TXN0000011795,2024-09-26T21:29:28,ACC00006558,Debit,1133.52,-410129.54,JPY,Online Store
TXN0000011796,2024-02-16T08:35:09,ACC00003980,Debit,1355.4,-411484.94,USD,Online Store
TXN0000011797,2024-11-08T08:39:33,ACC00008151,Transfer,1206.97,-410277.97,JPY,Online Store
TXN0000011798,2024-05-03T06:21:44,ACC00003572,Transfer,227.27,-410050.7,JPY,Online Store
TXN0000011799,2024-02-22T00:24:37,ACC00006707,Credit,481.98,-409568.72,EUR,Online Store
TXN0000011800,2024-02-25T04:30:37,ACC00000044,Payment,1149.51,-410718.23,USD,Target
TXN0000011801,2024-01-20T21:14:17,ACC00001821,Credit,1740.1,-408978.13,JPY,Grocery
TXN0000011802,2024-12-25T15:05:18,ACC00008194,Credit,778.17,-408199.96,JPY,Shell
TXN0000011803,2024-04-02T09:22:08,ACC00000924,Payment,415.28,-408615.24,USD,Walmart
TXN0000011804,2024-02-24T09:39:14,ACC00008854,Transfer,1678.1,-406937.14,EUR,Starbucks
TXN0000011805,2024-08-21T18:51:47,ACC00003897,Transfer,404.77,-406532.37,USD,Online Store
TXN0000011806,2024-09-14T21:05:41,ACC00006125,Debit,1396.06,-407928.43,GBP,Shell
TXN0000011807,2024-04-30T16:58:51,ACC00008340,Transfer,1193.29,-406735.14,GBP,Amazon
TXN0000011808,2024-09-09T00:20:32,ACC00003334,Debit,1724.16,-408459.3,EUR,Walmart
TXN0000011809,2024-10-07T19:08:18,ACC00008937,ATM,268.05,-408727.35,USD,Grocery
TXN0000011810,2024-02-25T07:26:02,ACC00007203,Transfer,1866.58,-406860.77,GBP,Restaurant
TXN0000011811,2024-09-11T14:52:06,ACC00000111,ATM,852.15,-407712.92,EUR,Target
TXN0000011812,2024-08-12T15:04:44,ACC00003307,Payment,240.93,-407953.85,EUR,Starbucks
TXN0000011813,2024-01-16T18:27:42,ACC00004661,Transfer,845.3,-407108.55,GBP,Starbucks
TXN0000011814,2024-08-07T03:47:02,ACC00000797,Transfer,222.2,-406886.35,EUR,Online Store
TXN0000011815,2024-09-14T18:18:36,ACC00006063,Transfer,155.24,-406731.11,USD,Target
TXN0000011816,2024-01-24T14:59:57,ACC00009336,ATM,793.11,-407524.22,JPY,Starbucks
TXN0000011817,2024-10-17T00:03:58,ACC00008473,Payment,1387.65,-408911.87,EUR,Target
TXN0000011818,2024-12-03T08:31:43,ACC00009727,Payment,1781.93,-410693.8,JPY,Walmart
TXN0000011819,2024-02-09T21:39:34,ACC00002886,Transfer,1672.26,-409021.54,EUR,Online Store
TXN0000011820,2024-08-28T04:02:21,ACC00004144,Transfer,1482.91,-407538.63,USD,Amazon
TXN0000011821,2024-03-03T17:46:32,ACC00003184,Credit,1585.29,-405953.34,EUR,Starbucks
TXN0000011822,2024-12-07T04:27:15,ACC00000041,Transfer,1270.54,-404682.8,JPY,Restaurant
TXN0000011823,2024-11-10T21:18:28,ACC00001972,ATM,332.41,-405015.21,USD,Walmart
TXN0000011824,2024-01-27T12:27:40,ACC00000999,Transfer,973.57,-404041.64,JPY,Grocery
TXN0000011825,2024-07-25T23:54:40,ACC00000189,ATM,225.71,-404267.35,JPY,Grocery
TXN0000011826,2024-02-16T21:21:54,ACC00005001,Credit,515.92,-403751.43,EUR,Target
TXN0000011827,2024-11-27T01:56:13,ACC00007426,ATM,138.28,-403889.71,GBP,Starbucks
TXN0000011828,2024-03-01T03:26:39,ACC00009132,Payment,1754.4,-405644.11,GBP,Shell
TXN0000011829,2024-12-11T18:22:47,ACC00009250,Debit,1257.3,-406901.41,JPY,Online Store
TXN0000011830,2024-05-16T05:30:49,ACC00004859,ATM,558.55,-407459.96,EUR,Target
TXN0000011831,2024-12-17T21:01:33,ACC00008906,Transfer,823.23,-406636.73,GBP,Grocery
TXN0000011832,2024-08-07T22:08:45,ACC00001795,Transfer,1373.17,-405263.56,JPY,Online Store
TXN0000011833,2024-07-29T19:53:06,ACC00003374,Debit,1305.88,-406569.44,GBP,Target
TXN0000011834,2024-08-20T08:38:06,ACC00009361,ATM,675.74,-407245.18,GBP,Walmart
TXN0000011835,2024-09-16T04:46:33,ACC00003519,ATM,1658.9,-408904.08,GBP,Grocery
TXN0000011836,2024-08-18T22:32:27,ACC00007469,Debit,521.22,-409425.3,EUR,Online Store
TXN0000011837,2024-02-11T12:07:37,ACC00007327,Payment,925.57,-410350.87,USD,Starbucks
TXN0000011838,2024-03-15T23:06:35,ACC00007356,Transfer,1328.73,-409022.14,JPY,Target
TXN0000011839,2024-05-05T17:47:31,ACC00009286,Debit,1039.12,-410061.26,JPY,Starbucks
TXN0000011840,2024-01-29T03:50:27,ACC00004378,Transfer,645.34,-409415.92,USD,Target
TXN0000011841,2024-05-04T06:00:17,ACC00003526,Debit,238.56,-409654.48,EUR,Restaurant
TXN0000011842,2024-03-09T04:10:08,ACC00003210,Payment,1486.27,-411140.75,USD,Walmart
TXN0000011843,2024-11-14T07:46:50,ACC00006047,Credit,198.95,-410941.8,EUR,Amazon
TXN0000011844,2024-04-06T14:42:51,ACC00002654,Credit,494.74,-410447.06,GBP,Target
TXN0000011845,2024-02-24T20:11:15,ACC00001120,Credit,48.66,-410398.4,JPY,Online Store
TXN0000011846,2024-06-23T02:43:11,ACC00009781,Payment,654.99,-411053.39,USD,Online Store
TXN0000011847,2024-10-04T15:29:10,ACC00002114,Credit,1085.05,-409968.34,JPY,Grocery
TXN0000011848,2024-10-23T06:51:26,ACC00008613,Debit,253.55,-410221.89,USD,Shell
TXN0000011849,2024-07-08T16:48:30,ACC00004096,ATM,1753.59,-411975.48,JPY,Restaurant
TXN0000011850,2024-12-10T00:23:14,ACC00004530,Transfer,1453.6,-410521.88,JPY,Online Store
TXN0000011851,2024-05-25T20:24:33,ACC00005626,Credit,1616.31,-408905.57,GBP,Grocery
TXN0000011852,2024-05-29T06:28:25,ACC00009875,Transfer,99.98,-408805.59,USD,Walmart
TXN0000011853,2024-08-10T19:31:45,ACC00000980,Transfer,1458.47,-407347.12,USD,Shell
TXN0000011854,2024-10-30T07:51:31,ACC00009103,Payment,1755.58,-409102.7,USD,Online Store
TXN0000011855,2024-02-04T04:29:46,ACC00006892,Payment,1229.21,-410331.91,JPY,Grocery
TXN0000011856,2024-12-05T05:38:00,ACC00009798,Credit,1923.33,-408408.58,USD,Shell
TXN0000011857,2024-02-28T12:55:21,ACC00002215,Payment,597.41,-409005.99,GBP,Restaurant
TXN0000011858,2024-04-30T14:44:01,ACC00004108,Payment,1259.7,-410265.69,JPY,Amazon
TXN0000011859,2024-11-17T02:12:29,ACC00008236,Payment,55.6,-410321.29,GBP,Online Store
TXN0000011860,2024-10-13T16:53:10,ACC00000955,Credit,480.18,-409841.11,JPY,Shell
TXN0000011861,2024-06-14T17:42:07,ACC00007676,Payment,967.56,-410808.67,GBP,Walmart
TXN0000011862,2024-08-27T11:10:02,ACC00004517,Debit,1243.0,-412051.67,GBP,Walmart
TXN0000011863,2024-09-17T00:38:00,ACC00007797,Credit,1120.83,-410930.84,EUR,Walmart
TXN0000011864,2024-06-27T00:29:09,ACC00007238,Credit,1301.05,-409629.79,GBP,Grocery
TXN0000011865,2024-01-12T13:23:50,ACC00009405,Debit,1647.6,-411277.39,JPY,Grocery
TXN0000011866,2024-08-02T21:51:39,ACC00005931,Transfer,180.92,-411096.47,USD,Restaurant
TXN0000011867,2024-08-16T17:25:20,ACC00008228,Debit,59.48,-411155.95,JPY,Walmart
TXN0000011868,2024-03-25T19:38:37,ACC00000856,Transfer,1553.53,-409602.42,JPY,Amazon
TXN0000011869,2024-11-16T17:21:27,ACC00000744,ATM,1660.53,-411262.95,EUR,Amazon
TXN0000011870,2024-02-24T11:09:06,ACC00002376,ATM,584.79,-411847.74,USD,Restaurant
TXN0000011871,2024-02-22T10:58:58,ACC00000306,Debit,1536.27,-413384.01,JPY,Amazon
TXN0000011872,2024-06-04T21:22:13,ACC00006247,Credit,1306.53,-412077.48,USD,Target
TXN0000011873,2024-07-24T06:04:48,ACC00006120,ATM,79.06,-412156.54,EUR,Target
TXN0000011874,2024-06-24T21:01:59,ACC00001458,ATM,209.66,-412366.2,JPY,Restaurant
TXN0000011875,2024-03-29T11:32:17,ACC00009928,Debit,778.85,-413145.05,GBP,Amazon
TXN0000011876,2024-04-17T22:29:24,ACC00003924,Transfer,622.24,-412522.81,USD,Target
TXN0000011877,2024-10-25T07:25:58,ACC00009586,Transfer,1650.72,-410872.09,JPY,Amazon
TXN0000011878,2024-04-07T15:06:16,ACC00003764,ATM,361.08,-411233.17,USD,Restaurant
TXN0000011879,2024-09-29T21:34:08,ACC00001472,Payment,633.8,-411866.97,JPY,Grocery
TXN0000011880,2024-06-12T13:50:07,ACC00007537,Payment,1569.14,-413436.11,JPY,Shell
TXN0000011881,2024-01-22T12:59:02,ACC00001672,Credit,1083.78,-412352.33,USD,Target
TXN0000011882,2024-11-04T16:47:49,ACC00005468,Credit,739.73,-411612.6,USD,Online Store
TXN0000011883,2024-12-22T23:02:24,ACC00005041,Transfer,771.71,-410840.89,JPY,Restaurant
TXN0000011884,2024-04-27T23:35:29,ACC00003764,Credit,1835.72,-409005.17,EUR,Grocery
TXN0000011885,2024-05-14T22:09:06,ACC00004999,Credit,1059.95,-407945.22,GBP,Amazon
TXN0000011886,2024-04-15T21:09:58,ACC00003825,ATM,678.07,-408623.29,EUR,Grocery
TXN0000011887,2024-03-12T16:59:29,ACC00000077,Credit,724.82,-407898.47,EUR,Amazon
TXN0000011888,2024-02-11T00:33:18,ACC00002413,Payment,1714.67,-409613.14,USD,Starbucks
TXN0000011889,2024-06-12T06:20:53,ACC00000341,Credit,196.52,-409416.62,EUR,Shell
TXN0000011890,2024-01-09T00:58:08,ACC00006261,ATM,55.43,-409472.05,GBP,Target
TXN0000011891,2024-08-18T22:21:25,ACC00003615,Payment,258.83,-409730.88,USD,Walmart
TXN0000011892,2024-09-11T08:15:36,ACC00005057,Transfer,645.25,-409085.63,JPY,Online Store
TXN0000011893,2024-11-23T20:32:30,ACC00007361,Payment,1850.09,-410935.72,USD,Walmart
TXN0000011894,2024-06-13T17:32:52,ACC00002714,Transfer,1135.97,-409799.75,GBP,Walmart
TXN0000011895,2024-06-06T10:19:22,ACC00006677,Transfer,498.0,-409301.75,GBP,Restaurant
TXN0000011896,2024-05-10T05:26:16,ACC00004989,Credit,1310.21,-407991.54,USD,Starbucks
TXN0000011897,2024-03-18T21:10:37,ACC00004220,Credit,467.32,-407524.22,GBP,Online Store
TXN0000011898,2024-11-09T19:45:56,ACC00004075,ATM,1844.7,-409368.92,GBP,Shell
TXN0000011899,2024-08-27T12:44:09,ACC00004922,Payment,1018.85,-410387.77,USD,Restaurant
TXN0000011900,2024-07-03T21:33:44,ACC00009480,ATM,42.72,-410430.49,USD,Walmart
TXN0000011901,2024-08-01T03:24:53,ACC00001254,Transfer,334.92,-410095.57,JPY,Amazon
TXN0000011902,2024-11-10T12:55:59,ACC00006368,Payment,1523.49,-411619.06,USD,Grocery
TXN0000011903,2024-02-28T17:15:05,ACC00003655,Payment,195.79,-411814.85,USD,Walmart
TXN0000011904,2024-12-19T10:31:51,ACC00002779,Credit,1554.61,-410260.24,JPY,Shell
TXN0000011905,2024-02-13T16:21:16,ACC00001769,Credit,176.52,-410083.72,GBP,Target
TXN0000011906,2024-03-29T01:12:41,ACC00000153,ATM,881.59,-410965.31,JPY,Shell
TXN0000011907,2024-02-02T14:46:50,ACC00004585,Payment,1326.41,-412291.72,USD,Amazon
TXN0000011908,2024-09-05T06:15:39,ACC00007224,Debit,1516.83,-413808.55,EUR,Target
TXN0000011909,2024-12-05T14:13:28,ACC00004876,Payment,228.82,-414037.37,JPY,Target
TXN0000011910,2024-03-08T12:39:39,ACC00005586,Payment,1332.87,-415370.24,EUR,Online Store
TXN0000011911,2024-02-24T23:30:17,ACC00008053,Payment,1329.56,-416699.8,GBP,Restaurant
TXN0000011912,2024-06-25T00:02:01,ACC00008835,Debit,297.09,-416996.89,JPY,Amazon
TXN0000011913,2024-06-26T04:56:27,ACC00000321,Credit,1821.32,-415175.57,EUR,Online Store
TXN0000011914,2024-02-29T02:12:57,ACC00008351,Credit,749.51,-414426.06,GBP,Amazon
TXN0000011915,2024-11-16T08:30:11,ACC00005883,Transfer,749.83,-413676.23,JPY,Online Store
TXN0000011916,2024-01-21T21:52:01,ACC00004929,Credit,349.48,-413326.75,USD,Amazon
TXN0000011917,2024-02-19T05:34:50,ACC00003634,Transfer,804.93,-412521.82,USD,Target
TXN0000011918,2024-02-14T21:52:59,ACC00002941,Payment,1807.68,-414329.5,USD,Target
TXN0000011919,2024-10-09T10:03:35,ACC00007934,ATM,1975.33,-416304.83,EUR,Walmart
TXN0000011920,2024-03-20T22:40:51,ACC00006773,Debit,1052.82,-417357.65,JPY,Grocery
TXN0000011921,2024-08-31T10:55:27,ACC00004905,Credit,453.87,-416903.78,USD,Target
TXN0000011922,2024-01-05T07:02:59,ACC00008517,ATM,750.23,-417654.01,EUR,Amazon
TXN0000011923,2024-04-07T12:59:08,ACC00000236,Debit,1832.52,-419486.53,EUR,Online Store
TXN0000011924,2024-06-21T19:43:14,ACC00003612,Transfer,1623.77,-417862.76,EUR,Starbucks
TXN0000011925,2024-05-16T11:17:51,ACC00005010,Payment,1686.42,-419549.18,USD,Grocery
TXN0000011926,2024-07-21T10:20:02,ACC00005973,Credit,1724.81,-417824.37,USD,Grocery
TXN0000011927,2024-12-19T05:13:44,ACC00003998,Payment,856.69,-418681.06,GBP,Grocery
TXN0000011928,2024-01-14T11:18:05,ACC00004506,Debit,288.85,-418969.91,JPY,Shell
TXN0000011929,2024-04-14T22:14:48,ACC00002073,Debit,272.31,-419242.22,USD,Online Store
TXN0000011930,2024-05-03T12:44:36,ACC00005296,ATM,1893.49,-421135.71,JPY,Starbucks
TXN0000011931,2024-05-07T05:45:24,ACC00001366,Payment,826.93,-421962.64,GBP,Shell
TXN0000011932,2024-04-07T21:36:39,ACC00004813,ATM,1637.71,-423600.35,EUR,Restaurant
TXN0000011933,2024-07-16T05:40:47,ACC00005995,Debit,1816.99,-425417.34,USD,Target
TXN0000011934,2024-08-06T19:12:05,ACC00002938,Payment,1120.04,-426537.38,JPY,Grocery
TXN0000011935,2024-10-24T08:13:00,ACC00005556,Transfer,893.13,-425644.25,GBP,Shell
TXN0000011936,2024-05-31T03:14:31,ACC00003326,Transfer,799.99,-424844.26,EUR,Starbucks
TXN0000011937,2024-04-04T06:47:01,ACC00005475,Transfer,1374.11,-423470.15,JPY,Grocery
TXN0000011938,2024-08-23T14:48:37,ACC00006859,ATM,677.93,-424148.08,JPY,Amazon
TXN0000011939,2024-05-06T11:14:19,ACC00006835,Credit,1646.62,-422501.46,GBP,Amazon
TXN0000011940,2024-06-02T07:59:28,ACC00005555,ATM,142.87,-422644.33,USD,Grocery
TXN0000011941,2024-01-26T12:30:51,ACC00004513,Payment,1199.03,-423843.36,GBP,Target
TXN0000011942,2024-10-25T23:13:41,ACC00006970,Credit,86.39,-423756.97,GBP,Target
TXN0000011943,2024-02-03T06:06:32,ACC00000239,Debit,1821.1,-425578.07,USD,Amazon
TXN0000011944,2024-06-24T18:24:15,ACC00000900,Transfer,1129.12,-424448.95,USD,Restaurant
TXN0000011945,2024-08-19T08:45:42,ACC00009679,Debit,1782.72,-426231.67,EUR,Walmart
TXN0000011946,2024-11-16T20:26:15,ACC00003455,ATM,803.23,-427034.9,USD,Shell
TXN0000011947,2024-10-11T18:29:04,ACC00000706,Credit,912.41,-426122.49,EUR,Walmart
TXN0000011948,2024-10-02T16:50:56,ACC00003901,Debit,409.51,-426532.0,JPY,Online Store
TXN0000011949,2024-12-12T03:37:40,ACC00003248,Debit,640.99,-427172.99,USD,Restaurant
TXN0000011950,2024-06-04T11:17:38,ACC00002889,Credit,407.3,-426765.69,EUR,Grocery
TXN0000011951,2024-12-02T00:10:52,ACC00006400,Transfer,958.84,-425806.85,GBP,Amazon
TXN0000011952,2024-05-26T01:55:45,ACC00002093,Payment,956.2,-426763.05,USD,Amazon
TXN0000011953,2024-02-24T18:42:01,ACC00007012,Payment,1032.55,-427795.6,EUR,Target
TXN0000011954,2024-11-07T01:36:55,ACC00000350,Transfer,1135.6,-426660.0,EUR,Restaurant
TXN0000011955,2024-12-12T13:05:53,ACC00006215,Debit,1449.36,-428109.36,USD,Amazon
TXN0000011956,2024-09-05T16:56:38,ACC00008649,Transfer,455.03,-427654.33,EUR,Grocery
TXN0000011957,2024-05-03T09:31:44,ACC00009018,Transfer,1423.53,-426230.8,EUR,Shell
TXN0000011958,2024-06-26T15:41:50,ACC00006819,Credit,683.16,-425547.64,USD,Shell
TXN0000011959,2024-12-16T12:26:39,ACC00002060,Credit,1707.9,-423839.74,JPY,Starbucks
TXN0000011960,2024-09-06T09:31:22,ACC00002836,ATM,1302.05,-425141.79,JPY,Amazon
TXN0000011961,2024-12-28T16:53:02,ACC00006276,Debit,839.78,-425981.57,JPY,Amazon
TXN0000011962,2024-08-24T16:57:11,ACC00007468,Debit,352.1,-426333.67,GBP,Online Store
TXN0000011963,2024-01-29T22:49:26,ACC00002036,Debit,580.72,-426914.39,USD,Shell
TXN0000011964,2024-03-01T03:04:27,ACC00005516,Credit,1641.96,-425272.43,GBP,Starbucks
TXN0000011965,2024-08-31T12:43:05,ACC00004525,ATM,22.07,-425294.5,GBP,Starbucks
TXN0000011966,2024-05-24T21:58:55,ACC00003235,Credit,794.04,-424500.46,USD,Walmart
TXN0000011967,2024-05-25T12:40:18,ACC00009485,ATM,1655.71,-426156.17,JPY,Grocery
TXN0000011968,2024-04-30T15:47:10,ACC00009516,ATM,1679.0,-427835.17,JPY,Online Store
TXN0000011969,2024-02-06T18:23:01,ACC00001349,Transfer,463.09,-427372.08,GBP,Restaurant
TXN0000011970,2024-11-11T09:58:54,ACC00006791,Payment,1688.23,-429060.31,EUR,Shell
TXN0000011971,2024-10-08T14:01:34,ACC00007273,Credit,563.03,-428497.28,USD,Amazon
TXN0000011972,2024-10-02T10:10:30,ACC00002705,ATM,647.28,-429144.56,EUR,Starbucks
TXN0000011973,2024-09-14T11:46:22,ACC00007979,Payment,1028.45,-430173.01,GBP,Target
TXN0000011974,2024-11-23T06:27:34,ACC00006929,ATM,241.02,-430414.03,EUR,Amazon
TXN0000011975,2024-06-23T01:37:21,ACC00001706,Credit,279.96,-430134.07,USD,Target
TXN0000011976,2024-12-09T23:13:08,ACC00005898,ATM,1776.92,-431910.99,GBP,Grocery
TXN0000011977,2024-12-14T16:27:32,ACC00002609,Transfer,1738.39,-430172.6,EUR,Grocery
TXN0000011978,2024-02-20T15:20:09,ACC00008397,Transfer,1006.63,-429165.97,USD,Starbucks
TXN0000011979,2024-05-16T17:24:23,ACC00007686,ATM,495.15,-429661.12,EUR,Restaurant
TXN0000011980,2024-07-08T10:07:27,ACC00002904,Debit,310.61,-429971.73,EUR,Online Store
TXN0000011981,2024-11-13T22:04:31,ACC00007530,Payment,268.25,-430239.98,GBP,Target
TXN0000011982,2024-12-12T23:49:17,ACC00007382,Transfer,1778.58,-428461.4,GBP,Amazon
TXN0000011983,2024-10-24T11:07:46,ACC00009735,Credit,68.78,-428392.62,JPY,Restaurant
TXN0000011984,2024-03-30T20:40:05,ACC00003961,Debit,1580.22,-429972.84,GBP,Target
TXN0000011985,2024-12-30T20:30:06,ACC00008383,Transfer,1552.71,-428420.13,GBP,Shell
TXN0000011986,2024-06-30T03:25:14,ACC00007543,Credit,1987.61,-426432.52,USD,Shell
TXN0000011987,2024-08-01T10:17:59,ACC00006276,ATM,521.65,-426954.17,EUR,Restaurant
TXN0000011988,2024-10-01T09:03:58,ACC00005925,Payment,166.9,-427121.07,USD,Restaurant
TXN0000011989,2024-12-01T23:32:02,ACC00004243,ATM,300.86,-427421.93,GBP,Starbucks
TXN0000011990,2024-09-08T12:43:57,ACC00005679,Transfer,1895.97,-425525.96,JPY,Starbucks
TXN0000011991,2024-07-27T09:20:58,ACC00008888,ATM,918.63,-426444.59,USD,Target
TXN0000011992,2024-08-31T11:06:19,ACC00005356,Transfer,1860.19,-424584.4,JPY,Online Store
TXN0000011993,2024-02-18T22:39:01,ACC00008195,Debit,1521.15,-426105.55,GBP,Grocery
TXN0000011994,2024-02-04T22:44:53,ACC00003727,Credit,986.85,-425118.7,EUR,Restaurant
TXN0000011995,2024-10-28T19:11:53,ACC00000195,Debit,68.44,-425187.14,EUR,Walmart
TXN0000011996,2024-08-28T04:27:41,ACC00008122,ATM,692.81,-425879.95,GBP,Grocery
TXN0000011997,2024-12-04T08:26:18,ACC00005587,Debit,1712.89,-427592.84,USD,Starbucks
TXN0000011998,2024-04-18T08:48:15,ACC00004032,Debit,1067.65,-428660.49,USD,Starbucks
TXN0000011999,2024-08-17T09:39:25,ACC00004763,Debit,355.98,-429016.47,USD,Amazon
TXN0000012000,2024-12-24T02:08:35,ACC00000374,Credit,1306.78,-427709.69,GBP,Online Store
TXN0000012001,2024-05-12T03:07:13,ACC00007102,Payment,1280.84,-428990.53,USD,Online Store
TXN0000012002,2024-06-03T21:42:35,ACC00003923,Payment,906.35,-429896.88,USD,Online Store
TXN0000012003,2024-07-11T12:59:23,ACC00008884,Payment,1558.74,-431455.62,EUR,Grocery
TXN0000012004,2024-08-19T08:24:29,ACC00004164,Debit,1563.23,-433018.85,GBP,Target
TXN0000012005,2024-09-09T13:18:05,ACC00003013,Transfer,11.21,-433007.64,USD,Target
TXN0000012006,2024-12-10T23:28:24,ACC00005344,Transfer,1468.4,-431539.24,JPY,Walmart
TXN0000012007,2024-05-13T00:28:58,ACC00001106,ATM,608.82,-432148.06,EUR,Online Store
TXN0000012008,2024-01-08T01:32:42,ACC00007357,Debit,1940.11,-434088.17,USD,Restaurant
TXN0000012009,2024-06-06T22:52:01,ACC00004934,Credit,1173.21,-432914.96,USD,Shell
TXN0000012010,2024-05-21T10:57:24,ACC00000757,Credit,1453.26,-431461.7,JPY,Grocery
TXN0000012011,2024-10-17T13:08:05,ACC00007320,ATM,619.74,-432081.44,EUR,Amazon
TXN0000012012,2024-12-30T08:45:11,ACC00004953,Payment,423.84,-432505.28,JPY,Target
TXN0000012013,2024-06-07T12:40:28,ACC00009048,Payment,1896.38,-434401.66,JPY,Starbucks
TXN0000012014,2024-04-19T12:42:04,ACC00002625,Debit,1503.37,-435905.03,USD,Shell
TXN0000012015,2024-09-05T23:17:25,ACC00008488,Debit,590.25,-436495.28,USD,Online Store
TXN0000012016,2024-09-17T03:44:02,ACC00004206,Debit,1311.7,-437806.98,GBP,Shell
TXN0000012017,2024-05-10T22:15:49,ACC00003492,Credit,1643.61,-436163.37,EUR,Grocery
TXN0000012018,2024-11-04T11:23:52,ACC00008759,Payment,197.93,-436361.3,USD,Grocery
TXN0000012019,2024-06-04T10:16:25,ACC00009529,Credit,1749.65,-434611.65,JPY,Online Store
TXN0000012020,2024-04-06T04:37:19,ACC00009666,Debit,432.26,-435043.91,EUR,Shell
TXN0000012021,2024-01-18T03:54:00,ACC00000863,ATM,78.39,-435122.3,GBP,Grocery
TXN0000012022,2024-05-29T00:05:22,ACC00001495,Credit,313.29,-434809.01,JPY,Shell
TXN0000012023,2024-08-15T14:12:49,ACC00009555,ATM,47.52,-434856.53,JPY,Starbucks
TXN0000012024,2024-07-20T11:16:19,ACC00004527,Debit,736.44,-435592.97,JPY,Walmart
TXN0000012025,2024-03-25T07:08:25,ACC00007907,ATM,1776.17,-437369.14,GBP,Online Store
TXN0000012026,2024-07-20T12:18:40,ACC00009657,ATM,601.26,-437970.4,JPY,Grocery
TXN0000012027,2024-11-15T00:53:57,ACC00009615,Transfer,1773.04,-436197.36,GBP,Online Store
TXN0000012028,2024-04-13T16:18:01,ACC00000071,ATM,1805.13,-438002.49,USD,Online Store
TXN0000012029,2024-12-20T06:50:45,ACC00007624,Credit,1308.1,-436694.39,JPY,Walmart
TXN0000012030,2024-10-27T03:05:37,ACC00002548,ATM,1528.32,-438222.71,JPY,Shell
TXN0000012031,2024-06-08T20:12:16,ACC00003449,Debit,1275.4,-439498.11,JPY,Amazon
TXN0000012032,2024-05-22T01:33:32,ACC00006500,Transfer,1552.67,-437945.44,EUR,Starbucks
TXN0000012033,2024-03-18T19:10:47,ACC00002270,Credit,1016.85,-436928.59,EUR,Walmart
TXN0000012034,2024-11-08T08:46:24,ACC00000090,ATM,781.21,-437709.8,EUR,Walmart
TXN0000012035,2024-02-14T21:51:51,ACC00001687,Transfer,1440.09,-436269.71,GBP,Starbucks
TXN0000012036,2024-05-21T23:08:34,ACC00000528,Debit,1768.0,-438037.71,USD,Target
TXN0000012037,2024-04-18T13:08:49,ACC00001443,Transfer,488.6,-437549.11,EUR,Amazon
TXN0000012038,2024-01-19T09:53:34,ACC00002854,Debit,867.51,-438416.62,EUR,Starbucks
TXN0000012039,2024-05-12T02:08:49,ACC00002496,Credit,1334.67,-437081.95,GBP,Starbucks
TXN0000012040,2024-05-26T18:47:49,ACC00002297,ATM,165.7,-437247.65,JPY,Restaurant
TXN0000012041,2024-09-27T19:07:27,ACC00003121,Credit,1923.61,-435324.04,EUR,Starbucks
TXN0000012042,2024-11-17T10:34:43,ACC00004876,Credit,386.36,-434937.68,EUR,Restaurant
TXN0000012043,2024-02-27T16:07:35,ACC00006684,Payment,1325.37,-436263.05,EUR,Amazon
TXN0000012044,2024-10-15T06:47:24,ACC00006768,Debit,1024.0,-437287.05,GBP,Restaurant
TXN0000012045,2024-03-11T18:59:45,ACC00005208,ATM,515.15,-437802.2,GBP,Walmart
TXN0000012046,2024-11-27T21:47:02,ACC00007934,Debit,548.49,-438350.69,EUR,Target
TXN0000012047,2024-04-28T02:24:38,ACC00003162,ATM,860.46,-439211.15,USD,Amazon
TXN0000012048,2024-06-15T08:45:52,ACC00003570,ATM,1115.88,-440327.03,GBP,Starbucks
TXN0000012049,2024-05-30T06:42:47,ACC00004911,Debit,1933.03,-442260.06,GBP,Amazon
TXN0000012050,2024-04-13T05:35:17,ACC00002552,ATM,881.69,-443141.75,USD,Online Store
TXN0000012051,2024-05-14T03:28:03,ACC00003190,Payment,1768.81,-444910.56,EUR,Amazon
TXN0000012052,2024-09-09T00:11:16,ACC00007242,ATM,1516.14,-446426.7,GBP,Restaurant
TXN0000012053,2024-11-15T21:35:43,ACC00002440,Transfer,1679.07,-444747.63,JPY,Walmart
TXN0000012054,2024-08-09T00:11:16,ACC00005565,Credit,1430.8,-443316.83,USD,Amazon
TXN0000012055,2024-05-10T01:43:53,ACC00005977,Credit,264.22,-443052.61,GBP,Amazon
TXN0000012056,2024-09-16T18:04:18,ACC00009627,Credit,473.35,-442579.26,USD,Online Store
TXN0000012057,2024-04-18T03:24:08,ACC00003176,Transfer,652.71,-441926.55,JPY,Target
TXN0000012058,2024-06-16T19:47:01,ACC00006734,Transfer,1343.07,-440583.48,USD,Restaurant
TXN0000012059,2024-11-11T22:43:34,ACC00000516,Payment,190.6,-440774.08,JPY,Target
TXN0000012060,2024-05-29T14:33:02,ACC00008247,Payment,215.03,-440989.11,JPY,Target
TXN0000012061,2024-10-24T07:58:37,ACC00000445,Transfer,914.69,-440074.42,JPY,Restaurant
TXN0000012062,2024-07-04T02:17:48,ACC00000782,Transfer,1659.56,-438414.86,JPY,Walmart
TXN0000012063,2024-09-28T01:11:39,ACC00001899,Credit,1057.43,-437357.43,GBP,Amazon
TXN0000012064,2024-04-08T23:10:21,ACC00005872,ATM,1685.66,-439043.09,GBP,Starbucks
TXN0000012065,2024-03-14T16:59:14,ACC00002699,Payment,1210.22,-440253.31,JPY,Shell
TXN0000012066,2024-09-18T21:34:27,ACC00000040,Payment,1748.91,-442002.22,GBP,Online Store
TXN0000012067,2024-04-02T19:07:57,ACC00006810,Credit,630.14,-441372.08,JPY,Online Store
TXN0000012068,2024-01-05T14:21:18,ACC00007356,Payment,798.4,-442170.48,EUR,Online Store
TXN0000012069,2024-03-25T06:45:37,ACC00008703,Credit,1948.04,-440222.44,GBP,Walmart
TXN0000012070,2024-03-14T17:27:46,ACC00004480,Payment,970.7,-441193.14,GBP,Grocery
TXN0000012071,2024-08-21T18:50:44,ACC00004139,ATM,1756.54,-442949.68,GBP,Shell
TXN0000012072,2024-11-10T12:17:17,ACC00008496,Transfer,1068.36,-441881.32,GBP,Shell
TXN0000012073,2024-09-08T01:57:24,ACC00005765,Transfer,1397.08,-440484.24,GBP,Shell
TXN0000012074,2024-10-16T21:45:01,ACC00001803,Transfer,671.46,-439812.78,EUR,Shell
TXN0000012075,2024-12-09T19:01:34,ACC00002913,Debit,867.63,-440680.41,EUR,Grocery
TXN0000012076,2024-10-04T17:22:39,ACC00005379,Credit,1818.87,-438861.54,EUR,Grocery
TXN0000012077,2024-02-17T11:22:15,ACC00008628,Debit,841.1,-439702.64,GBP,Target
TXN0000012078,2024-04-16T18:53:49,ACC00009035,Debit,1777.53,-441480.17,GBP,Shell
TXN0000012079,2024-09-10T21:25:43,ACC00004429,Debit,495.7,-441975.87,JPY,Amazon
TXN0000012080,2024-11-07T03:15:40,ACC00007089,Debit,1984.09,-443959.96,GBP,Starbucks
TXN0000012081,2024-04-24T22:38:54,ACC00007974,Transfer,1661.03,-442298.93,GBP,Starbucks
TXN0000012082,2024-01-17T00:49:33,ACC00000361,Payment,810.08,-443109.01,EUR,Amazon
TXN0000012083,2024-07-25T23:05:24,ACC00007272,ATM,171.35,-443280.36,GBP,Starbucks
TXN0000012084,2024-04-03T14:19:02,ACC00003145,ATM,212.7,-443493.06,USD,Starbucks
TXN0000012085,2024-05-12T04:57:07,ACC00008508,Debit,221.38,-443714.44,USD,Walmart
TXN0000012086,2024-10-11T15:17:30,ACC00008556,ATM,825.44,-444539.88,GBP,Shell
TXN0000012087,2024-05-10T09:23:04,ACC00007265,Debit,1769.61,-446309.49,JPY,Walmart
TXN0000012088,2024-01-12T01:51:36,ACC00006254,Payment,828.75,-447138.24,EUR,Amazon
TXN0000012089,2024-03-15T01:59:05,ACC00001094,Payment,1786.58,-448924.82,EUR,Restaurant
TXN0000012090,2024-03-25T19:32:33,ACC00009309,Payment,1936.92,-450861.74,USD,Starbucks
TXN0000012091,2024-12-11T12:47:09,ACC00006217,Debit,1051.77,-451913.51,GBP,Target
TXN0000012092,2024-05-20T12:53:14,ACC00002981,Credit,1714.58,-450198.93,GBP,Shell
TXN0000012093,2024-07-13T04:35:08,ACC00005904,Debit,1174.13,-451373.06,EUR,Target
TXN0000012094,2024-07-06T18:29:10,ACC00001988,Transfer,1638.87,-449734.19,USD,Starbucks
TXN0000012095,2024-06-08T09:36:39,ACC00005453,Debit,355.98,-450090.17,EUR,Starbucks
TXN0000012096,2024-01-31T00:23:06,ACC00004411,ATM,1997.11,-452087.28,JPY,Grocery
TXN0000012097,2024-05-21T11:25:46,ACC00004162,Transfer,196.22,-451891.06,EUR,Online Store
TXN0000012098,2024-12-02T08:34:26,ACC00002254,Transfer,1210.72,-450680.34,USD,Walmart
TXN0000012099,2024-12-10T09:46:29,ACC00006077,Payment,1866.94,-452547.28,GBP,Amazon
TXN0000012100,2024-11-09T05:15:16,ACC00006369,Debit,1914.13,-454461.41,USD,Online Store
TXN0000012101,2024-11-06T04:21:44,ACC00001156,Debit,860.5,-455321.91,JPY,Grocery
TXN0000012102,2024-07-22T10:02:48,ACC00008263,Transfer,100.26,-455221.65,JPY,Shell
TXN0000012103,2024-01-14T20:09:33,ACC00005063,Payment,561.87,-455783.52,GBP,Online Store
TXN0000012104,2024-01-12T00:42:19,ACC00006111,Payment,960.72,-456744.24,JPY,Walmart
TXN0000012105,2024-09-14T00:47:44,ACC00009285,Credit,234.31,-456509.93,GBP,Starbucks
TXN0000012106,2024-10-19T05:41:27,ACC00002449,Payment,281.78,-456791.71,USD,Target
TXN0000012107,2024-08-11T05:24:09,ACC00008160,Debit,917.09,-457708.8,USD,Target
TXN0000012108,2024-07-30T21:43:48,ACC00005185,Payment,188.61,-457897.41,JPY,Online Store
TXN0000012109,2024-08-06T23:29:24,ACC00002541,Debit,807.42,-458704.83,USD,Target
TXN0000012110,2024-08-14T21:34:10,ACC00000060,Transfer,1489.25,-457215.58,USD,Online Store
TXN0000012111,2024-02-12T08:48:20,ACC00002378,Credit,19.44,-457196.14,USD,Online Store
TXN0000012112,2024-10-06T02:23:47,ACC00008892,ATM,1884.9,-459081.04,JPY,Target
TXN0000012113,2024-01-01T07:21:35,ACC00005715,ATM,1550.94,-460631.98,EUR,Target
TXN0000012114,2024-08-30T23:11:34,ACC00003965,Debit,20.91,-460652.89,EUR,Shell
TXN0000012115,2024-07-15T01:14:24,ACC00007243,Transfer,659.97,-459992.92,USD,Starbucks
TXN0000012116,2024-10-14T17:05:23,ACC00000958,Debit,811.01,-460803.93,EUR,Restaurant
TXN0000012117,2024-01-16T03:44:14,ACC00007437,Debit,374.89,-461178.82,EUR,Walmart
TXN0000012118,2024-07-18T07:16:09,ACC00007472,Credit,1247.42,-459931.4,USD,Restaurant
TXN0000012119,2024-07-18T19:55:15,ACC00009304,ATM,1498.67,-461430.07,JPY,Target
TXN0000012120,2024-07-30T22:02:36,ACC00001624,Credit,1285.9,-460144.17,USD,Amazon
TXN0000012121,2024-05-07T05:54:41,ACC00003078,Credit,1204.08,-458940.09,JPY,Walmart
TXN0000012122,2024-11-13T15:23:30,ACC00000707,Payment,840.41,-459780.5,GBP,Online Store
TXN0000012123,2024-07-12T04:06:48,ACC00009859,Debit,497.34,-460277.84,USD,Online Store
TXN0000012124,2024-03-03T05:27:15,ACC00009087,Payment,11.56,-460289.4,GBP,Target
TXN0000012125,2024-03-26T00:47:46,ACC00009237,Transfer,736.62,-459552.78,USD,Shell
TXN0000012126,2024-07-10T21:17:25,ACC00009739,Credit,1611.33,-457941.45,GBP,Starbucks
TXN0000012127,2024-07-08T18:02:42,ACC00009342,ATM,1608.45,-459549.9,USD,Restaurant
TXN0000012128,2024-08-19T16:15:19,ACC00004054,Debit,1045.44,-460595.34,JPY,Grocery
TXN0000012129,2024-07-04T20:36:03,ACC00001026,Transfer,1032.11,-459563.23,USD,Grocery
TXN0000012130,2024-11-09T18:41:19,ACC00003432,Payment,227.79,-459791.02,EUR,Grocery
TXN0000012131,2024-08-13T22:07:22,ACC00004733,Debit,1229.47,-461020.49,JPY,Amazon
TXN0000012132,2024-07-07T11:21:13,ACC00002463,Credit,1643.64,-459376.85,EUR,Grocery
TXN0000012133,2024-12-28T02:57:51,ACC00004898,Payment,1600.49,-460977.34,GBP,Starbucks
TXN0000012134,2024-05-22T06:55:42,ACC00000264,Transfer,717.08,-460260.26,JPY,Target
TXN0000012135,2024-10-01T10:12:53,ACC00006130,Credit,1815.17,-458445.09,GBP,Amazon
TXN0000012136,2024-04-11T21:34:14,ACC00006535,ATM,1804.27,-460249.36,USD,Grocery
TXN0000012137,2024-08-28T20:24:59,ACC00004660,ATM,761.02,-461010.38,EUR,Shell
TXN0000012138,2024-11-30T15:07:59,ACC00009746,Credit,1026.8,-459983.58,EUR,Restaurant
TXN0000012139,2024-04-13T07:25:43,ACC00006412,Payment,1284.97,-461268.55,JPY,Starbucks
TXN0000012140,2024-07-15T12:06:59,ACC00000475,Debit,1474.01,-462742.56,JPY,Online Store
TXN0000012141,2024-04-12T17:46:15,ACC00006269,ATM,403.83,-463146.39,GBP,Shell
TXN0000012142,2024-08-22T21:10:13,ACC00009920,Payment,1810.07,-464956.46,JPY,Amazon
TXN0000012143,2024-11-15T13:04:39,ACC00008149,Transfer,865.59,-464090.87,USD,Walmart
TXN0000012144,2024-04-15T12:52:45,ACC00003580,Credit,629.05,-463461.82,USD,Grocery
TXN0000012145,2024-07-11T04:13:57,ACC00005571,Payment,1294.78,-464756.6,USD,Grocery
TXN0000012146,2024-08-13T07:11:28,ACC00003587,Debit,276.54,-465033.14,USD,Starbucks
TXN0000012147,2024-07-11T23:41:56,ACC00004329,Payment,177.07,-465210.21,EUR,Shell
TXN0000012148,2024-10-18T12:56:57,ACC00006448,Credit,1186.5,-464023.71,GBP,Grocery
TXN0000012149,2024-01-06T06:24:33,ACC00007302,Payment,684.48,-464708.19,JPY,Target
TXN0000012150,2024-10-31T20:09:04,ACC00007940,Debit,1148.64,-465856.83,USD,Online Store
TXN0000012151,2024-12-22T07:44:48,ACC00006754,Debit,765.76,-466622.59,EUR,Starbucks
TXN0000012152,2024-01-04T10:34:30,ACC00009742,Credit,71.45,-466551.14,USD,Starbucks
TXN0000012153,2024-06-19T04:44:49,ACC00003275,Debit,425.34,-466976.48,EUR,Shell
TXN0000012154,2024-12-22T23:16:08,ACC00001787,Transfer,1469.58,-465506.9,EUR,Amazon
TXN0000012155,2024-03-03T07:52:35,ACC00005323,Transfer,1625.13,-463881.77,GBP,Walmart
TXN0000012156,2024-12-09T04:26:07,ACC00003926,Debit,1933.65,-465815.42,EUR,Grocery
TXN0000012157,2024-10-20T02:46:38,ACC00003535,Payment,182.6,-465998.02,GBP,Restaurant
TXN0000012158,2024-11-12T17:19:43,ACC00004853,Credit,202.32,-465795.7,USD,Starbucks
TXN0000012159,2024-08-21T07:16:27,ACC00006116,ATM,1167.64,-466963.34,GBP,Online Store
TXN0000012160,2024-07-29T01:02:43,ACC00007691,Transfer,1829.49,-465133.85,JPY,Target
TXN0000012161,2024-07-14T21:36:52,ACC00008684,ATM,1134.67,-466268.52,GBP,Starbucks
TXN0000012162,2024-02-10T18:07:41,ACC00008180,Payment,1316.05,-467584.57,JPY,Starbucks
TXN0000012163,2024-09-30T06:35:34,ACC00008210,Payment,999.47,-468584.04,GBP,Amazon
TXN0000012164,2024-04-07T04:55:20,ACC00008784,ATM,56.43,-468640.47,JPY,Walmart
TXN0000012165,2024-11-08T16:46:45,ACC00004361,ATM,1726.11,-470366.58,JPY,Amazon
TXN0000012166,2024-07-10T21:49:31,ACC00008009,Credit,1369.58,-468997.0,EUR,Starbucks
TXN0000012167,2024-04-24T19:54:09,ACC00005575,Debit,949.83,-469946.83,JPY,Amazon
TXN0000012168,2024-02-03T15:29:49,ACC00008812,Debit,1866.48,-471813.31,EUR,Amazon
TXN0000012169,2024-05-21T04:09:10,ACC00008763,Payment,205.71,-472019.02,EUR,Target
TXN0000012170,2024-07-03T05:45:05,ACC00004810,Debit,1870.94,-473889.96,GBP,Target
TXN0000012171,2024-07-13T03:09:14,ACC00005704,Transfer,934.46,-472955.5,USD,Starbucks
TXN0000012172,2024-12-10T16:43:20,ACC00007828,Credit,561.15,-472394.35,JPY,Starbucks
TXN0000012173,2024-06-16T10:10:54,ACC00002778,Transfer,1633.9,-470760.45,EUR,Walmart
TXN0000012174,2024-09-12T17:43:17,ACC00006639,ATM,1713.76,-472474.21,JPY,Target
TXN0000012175,2024-11-26T16:29:49,ACC00005905,Debit,1831.25,-474305.46,GBP,Online Store
TXN0000012176,2024-06-20T05:49:29,ACC00005290,Credit,395.7,-473909.76,GBP,Online Store
TXN0000012177,2024-05-11T01:54:30,ACC00002251,Credit,1316.5,-472593.26,JPY,Starbucks
TXN0000012178,2024-10-31T20:05:49,ACC00000946,Credit,1352.88,-471240.38,JPY,Amazon
TXN0000012179,2024-06-25T11:38:29,ACC00004298,ATM,780.3,-472020.68,JPY,Amazon
TXN0000012180,2024-08-19T13:54:51,ACC00000099,Transfer,1084.95,-470935.73,EUR,Target
TXN0000012181,2024-04-14T12:46:20,ACC00000135,Credit,1759.94,-469175.79,EUR,Restaurant
TXN0000012182,2024-10-07T20:48:24,ACC00000286,Transfer,390.71,-468785.08,GBP,Online Store
TXN0000012183,2024-03-08T18:13:38,ACC00003967,ATM,821.92,-469607.0,GBP,Amazon
TXN0000012184,2024-09-05T04:29:12,ACC00008622,Transfer,635.57,-468971.43,JPY,Shell
TXN0000012185,2024-11-30T12:33:45,ACC00004670,Credit,1434.37,-467537.06,EUR,Shell
TXN0000012186,2024-10-08T18:26:34,ACC00008759,Credit,1892.0,-465645.06,USD,Target
TXN0000012187,2024-02-27T23:43:47,ACC00005044,Transfer,1073.15,-464571.91,GBP,Shell
TXN0000012188,2024-10-29T20:40:40,ACC00001873,Credit,1440.02,-463131.89,EUR,Online Store
TXN0000012189,2024-03-04T08:45:05,ACC00009305,ATM,1213.3,-464345.19,JPY,Amazon
TXN0000012190,2024-05-12T20:36:19,ACC00004596,Payment,767.58,-465112.77,GBP,Walmart
TXN0000012191,2024-04-11T21:11:10,ACC00002551,Credit,1055.94,-464056.83,EUR,Amazon
TXN0000012192,2024-06-02T15:00:52,ACC00006773,Payment,1639.3,-465696.13,EUR,Online Store
TXN0000012193,2024-10-13T21:36:25,ACC00007960,Debit,444.57,-466140.7,JPY,Grocery
TXN0000012194,2024-03-19T18:55:06,ACC00007589,Payment,608.7,-466749.4,JPY,Walmart
TXN0000012195,2024-03-16T15:55:41,ACC00009668,Debit,562.77,-467312.17,GBP,Walmart
TXN0000012196,2024-06-18T06:28:11,ACC00002654,ATM,535.79,-467847.96,GBP,Grocery
TXN0000012197,2024-03-14T00:42:12,ACC00004356,Transfer,673.7,-467174.26,JPY,Starbucks
TXN0000012198,2024-05-11T08:54:39,ACC00007236,ATM,1703.75,-468878.01,EUR,Grocery
TXN0000012199,2024-02-08T07:09:35,ACC00005359,Debit,591.41,-469469.42,JPY,Restaurant
TXN0000012200,2024-08-03T16:20:30,ACC00009592,Debit,550.91,-470020.33,EUR,Amazon
TXN0000012201,2024-02-23T07:34:45,ACC00000598,Payment,1830.65,-471850.98,USD,Online Store
TXN0000012202,2024-12-23T03:35:49,ACC00003857,Transfer,200.98,-471650.0,JPY,Target
TXN0000012203,2024-12-12T22:30:46,ACC00003773,ATM,625.78,-472275.78,USD,Target
TXN0000012204,2024-10-05T06:24:19,ACC00008628,Transfer,165.86,-472109.92,GBP,Online Store
TXN0000012205,2024-10-23T10:30:44,ACC00006435,Credit,1504.97,-470604.95,JPY,Restaurant
TXN0000012206,2024-06-16T09:08:50,ACC00008859,Credit,1908.78,-468696.17,EUR,Grocery
TXN0000012207,2024-11-01T09:08:53,ACC00004791,Payment,1973.76,-470669.93,GBP,Shell
TXN0000012208,2024-05-05T15:31:20,ACC00007656,Debit,1267.8,-471937.73,USD,Restaurant
TXN0000012209,2024-08-02T17:37:41,ACC00002023,Transfer,839.03,-471098.7,USD,Shell
TXN0000012210,2024-06-17T05:00:03,ACC00009293,Payment,1043.55,-472142.25,EUR,Grocery
TXN0000012211,2024-07-24T08:50:22,ACC00009611,ATM,1845.79,-473988.04,JPY,Restaurant
TXN0000012212,2024-05-24T07:10:50,ACC00004561,Debit,577.66,-474565.7,USD,Grocery
TXN0000012213,2024-08-09T20:50:53,ACC00006069,Payment,941.06,-475506.76,USD,Online Store
TXN0000012214,2024-05-24T15:13:31,ACC00005274,Payment,304.93,-475811.69,JPY,Amazon
TXN0000012215,2024-02-21T14:00:06,ACC00009988,Credit,253.23,-475558.46,USD,Grocery
TXN0000012216,2024-01-18T15:49:57,ACC00003025,Debit,588.87,-476147.33,USD,Starbucks
TXN0000012217,2024-02-19T01:50:42,ACC00004824,Payment,1922.34,-478069.67,GBP,Shell
TXN0000012218,2024-03-01T18:52:42,ACC00000049,ATM,1100.8,-479170.47,USD,Walmart
TXN0000012219,2024-05-30T07:02:11,ACC00001684,ATM,837.29,-480007.76,JPY,Amazon
TXN0000012220,2024-07-21T07:29:39,ACC00005490,ATM,314.31,-480322.07,EUR,Restaurant
TXN0000012221,2024-02-22T04:27:07,ACC00007293,Credit,527.34,-479794.73,GBP,Restaurant
TXN0000012222,2024-01-28T10:48:48,ACC00008355,Credit,922.27,-478872.46,GBP,Target
TXN0000012223,2024-05-29T16:43:35,ACC00001709,Debit,1991.21,-480863.67,EUR,Restaurant
TXN0000012224,2024-07-24T22:24:02,ACC00001194,Debit,1899.83,-482763.5,JPY,Amazon
TXN0000012225,2024-06-10T14:40:07,ACC00002030,Debit,1238.93,-484002.43,GBP,Walmart
TXN0000012226,2024-06-26T06:25:15,ACC00003966,Payment,1378.16,-485380.59,JPY,Starbucks
TXN0000012227,2024-12-29T02:06:24,ACC00000883,Transfer,1017.14,-484363.45,GBP,Starbucks
TXN0000012228,2024-09-18T12:24:27,ACC00009592,ATM,1003.6,-485367.05,JPY,Restaurant
TXN0000012229,2024-03-09T00:58:26,ACC00000859,Payment,398.08,-485765.13,USD,Grocery
TXN0000012230,2024-05-26T08:52:24,ACC00008279,Payment,891.72,-486656.85,GBP,Walmart
TXN0000012231,2024-01-12T07:28:03,ACC00002325,Credit,1990.75,-484666.1,GBP,Target
TXN0000012232,2024-06-10T07:07:23,ACC00002367,Payment,1929.91,-486596.01,JPY,Walmart
TXN0000012233,2024-07-09T02:31:25,ACC00006137,Debit,753.51,-487349.52,GBP,Grocery
TXN0000012234,2024-11-01T03:00:58,ACC00001171,Debit,762.81,-488112.33,USD,Shell
TXN0000012235,2024-08-14T18:49:33,ACC00001249,Debit,110.86,-488223.19,EUR,Restaurant
TXN0000012236,2024-11-08T07:13:03,ACC00008020,Transfer,842.86,-487380.33,GBP,Grocery
TXN0000012237,2024-01-23T07:14:18,ACC00008004,Credit,418.49,-486961.84,GBP,Online Store
TXN0000012238,2024-04-08T13:57:45,ACC00007515,Credit,103.35,-486858.49,USD,Grocery
TXN0000012239,2024-01-03T00:50:21,ACC00005741,Credit,1600.59,-485257.9,EUR,Starbucks
TXN0000012240,2024-11-05T21:06:05,ACC00005875,Transfer,423.72,-484834.18,EUR,Grocery
TXN0000012241,2024-01-21T00:54:02,ACC00002575,Payment,1741.01,-486575.19,EUR,Grocery
TXN0000012242,2024-04-11T10:18:33,ACC00006154,Transfer,682.98,-485892.21,EUR,Shell
TXN0000012243,2024-03-23T01:23:38,ACC00002203,Credit,1240.0,-484652.21,EUR,Online Store
TXN0000012244,2024-07-29T00:09:15,ACC00004001,Transfer,581.5,-484070.71,USD,Starbucks
TXN0000012245,2024-03-15T03:50:21,ACC00003915,ATM,1049.06,-485119.77,GBP,Target
TXN0000012246,2024-09-05T21:00:55,ACC00009240,Debit,162.1,-485281.87,GBP,Starbucks
TXN0000012247,2024-12-26T18:18:19,ACC00005720,Transfer,1354.11,-483927.76,EUR,Starbucks
TXN0000012248,2024-10-09T21:15:27,ACC00009395,Credit,1453.71,-482474.05,USD,Shell
TXN0000012249,2024-10-10T21:56:00,ACC00004742,Payment,1659.59,-484133.64,JPY,Shell
TXN0000012250,2024-11-11T12:47:41,ACC00007315,Payment,132.78,-484266.42,JPY,Online Store
TXN0000012251,2024-12-02T03:46:22,ACC00004342,Transfer,674.4,-483592.02,EUR,Online Store
TXN0000012252,2024-05-24T09:52:16,ACC00003918,Transfer,960.74,-482631.28,GBP,Amazon
TXN0000012253,2024-08-15T08:34:49,ACC00002621,Transfer,1853.29,-480777.99,JPY,Grocery
TXN0000012254,2024-08-09T02:35:26,ACC00004125,Payment,1651.97,-482429.96,GBP,Target
TXN0000012255,2024-10-31T19:30:49,ACC00007912,Transfer,1450.34,-480979.62,EUR,Starbucks
TXN0000012256,2024-06-28T06:24:05,ACC00002273,Transfer,129.74,-480849.88,USD,Amazon
TXN0000012257,2024-05-18T05:18:42,ACC00007774,Transfer,1409.66,-479440.22,JPY,Starbucks
TXN0000012258,2024-07-29T10:10:53,ACC00000434,Credit,856.18,-478584.04,USD,Amazon
TXN0000012259,2024-03-22T02:43:56,ACC00005460,Credit,959.43,-477624.61,GBP,Amazon
TXN0000012260,2024-03-02T17:17:36,ACC00008883,Transfer,1975.65,-475648.96,GBP,Grocery
TXN0000012261,2024-04-17T17:34:03,ACC00005550,Credit,135.54,-475513.42,JPY,Restaurant
TXN0000012262,2024-10-18T07:20:18,ACC00001316,ATM,1938.77,-477452.19,JPY,Grocery
TXN0000012263,2024-09-23T03:03:45,ACC00008105,Payment,139.64,-477591.83,JPY,Grocery
TXN0000012264,2024-05-14T12:38:48,ACC00005986,Payment,1704.47,-479296.3,GBP,Starbucks
TXN0000012265,2024-03-05T05:27:17,ACC00004778,Payment,1579.29,-480875.59,USD,Online Store
TXN0000012266,2024-10-25T17:02:14,ACC00005398,Credit,1395.75,-479479.84,USD,Walmart
TXN0000012267,2024-04-14T05:39:21,ACC00001208,ATM,173.09,-479652.93,GBP,Grocery
TXN0000012268,2024-12-17T02:39:19,ACC00006605,ATM,211.17,-479864.1,JPY,Walmart
TXN0000012269,2024-04-27T09:06:17,ACC00007230,Transfer,290.86,-479573.24,GBP,Shell
TXN0000012270,2024-10-20T21:08:02,ACC00001237,Payment,661.45,-480234.69,GBP,Starbucks
TXN0000012271,2024-01-28T21:58:23,ACC00003946,Payment,798.86,-481033.55,JPY,Shell
TXN0000012272,2024-10-01T17:20:29,ACC00007003,ATM,1608.12,-482641.67,EUR,Starbucks
TXN0000012273,2024-08-25T18:45:23,ACC00002314,Credit,1699.08,-480942.59,USD,Target
TXN0000012274,2024-05-12T06:14:59,ACC00004904,Payment,1196.87,-482139.46,GBP,Target
TXN0000012275,2024-05-16T10:40:26,ACC00009312,Credit,1729.62,-480409.84,JPY,Restaurant
TXN0000012276,2024-06-12T05:31:37,ACC00003402,Debit,435.42,-480845.26,GBP,Walmart
TXN0000012277,2024-06-20T03:07:31,ACC00001068,Debit,1042.48,-481887.74,GBP,Starbucks
TXN0000012278,2024-11-30T00:07:51,ACC00001235,Debit,1377.06,-483264.8,USD,Online Store
TXN0000012279,2024-06-21T14:40:34,ACC00009615,ATM,624.35,-483889.15,EUR,Target
TXN0000012280,2024-08-27T12:47:25,ACC00007267,Transfer,1769.86,-482119.29,JPY,Shell
TXN0000012281,2024-06-05T13:27:01,ACC00002826,Payment,684.2,-482803.49,GBP,Online Store
TXN0000012282,2024-03-12T20:35:20,ACC00006814,Debit,595.8,-483399.29,EUR,Restaurant
TXN0000012283,2024-05-25T10:47:50,ACC00007049,Transfer,629.87,-482769.42,GBP,Starbucks
TXN0000012284,2024-01-26T16:26:43,ACC00001024,Payment,914.26,-483683.68,EUR,Shell
TXN0000012285,2024-07-12T14:17:58,ACC00006443,Transfer,1339.29,-482344.39,GBP,Amazon
TXN0000012286,2024-09-11T04:54:26,ACC00003609,ATM,1913.92,-484258.31,JPY,Shell
TXN0000012287,2024-09-14T20:39:53,ACC00000527,Payment,471.74,-484730.05,USD,Target
TXN0000012288,2024-04-23T15:27:35,ACC00004590,ATM,1932.93,-486662.98,USD,Shell
TXN0000012289,2024-11-11T13:40:24,ACC00007056,Transfer,1577.47,-485085.51,EUR,Grocery
TXN0000012290,2024-07-07T11:31:55,ACC00004945,Credit,373.87,-484711.64,GBP,Target
TXN0000012291,2024-09-28T20:52:12,ACC00002874,Transfer,1770.73,-482940.91,EUR,Grocery
TXN0000012292,2024-04-27T02:53:17,ACC00008067,ATM,276.73,-483217.64,GBP,Restaurant
TXN0000012293,2024-04-29T04:42:49,ACC00001961,ATM,647.74,-483865.38,USD,Restaurant
TXN0000012294,2024-01-21T21:35:39,ACC00007632,Payment,92.92,-483958.3,USD,Shell
TXN0000012295,2024-06-07T11:35:05,ACC00002019,ATM,966.01,-484924.31,JPY,Restaurant
TXN0000012296,2024-03-02T18:30:44,ACC00003414,Transfer,320.74,-484603.57,EUR,Target
TXN0000012297,2024-12-12T12:54:46,ACC00008468,ATM,1450.29,-486053.86,USD,Shell
TXN0000012298,2024-07-20T18:15:37,ACC00005029,Transfer,745.26,-485308.6,USD,Walmart
TXN0000012299,2024-04-15T01:10:30,ACC00003329,Payment,34.06,-485342.66,EUR,Walmart
TXN0000012300,2024-01-28T06:28:11,ACC00004499,Credit,519.5,-484823.16,JPY,Restaurant
TXN0000012301,2024-11-02T07:04:12,ACC00007721,Debit,128.83,-484951.99,EUR,Restaurant
TXN0000012302,2024-04-15T19:18:13,ACC00000945,Payment,523.36,-485475.35,USD,Starbucks
TXN0000012303,2024-05-02T14:23:48,ACC00003051,Payment,366.69,-485842.04,EUR,Amazon
TXN0000012304,2024-09-03T10:27:25,ACC00005414,Credit,1441.96,-484400.08,EUR,Target
TXN0000012305,2024-11-27T18:15:53,ACC00004388,ATM,1424.2,-485824.28,EUR,Target
TXN0000012306,2024-05-28T04:11:03,ACC00005722,ATM,914.77,-486739.05,EUR,Restaurant
TXN0000012307,2024-02-19T01:33:28,ACC00005997,ATM,330.41,-487069.46,USD,Shell
TXN0000012308,2024-09-27T17:15:50,ACC00005810,Credit,619.83,-486449.63,USD,Restaurant
TXN0000012309,2024-01-05T20:35:45,ACC00003213,Credit,1506.32,-484943.31,GBP,Grocery
TXN0000012310,2024-04-21T20:42:01,ACC00004121,Transfer,1955.98,-482987.33,JPY,Target
TXN0000012311,2024-09-26T14:15:53,ACC00002971,Transfer,1516.18,-481471.15,JPY,Target
TXN0000012312,2024-10-15T12:58:52,ACC00007917,Credit,40.2,-481430.95,GBP,Restaurant
TXN0000012313,2024-02-12T22:22:13,ACC00003572,Credit,1210.56,-480220.39,JPY,Shell
TXN0000012314,2024-11-18T19:34:48,ACC00000388,Credit,1967.65,-478252.74,JPY,Target
TXN0000012315,2024-03-02T22:06:27,ACC00007409,Payment,87.59,-478340.33,USD,Starbucks
TXN0000012316,2024-04-07T07:50:31,ACC00002720,ATM,1936.54,-480276.87,USD,Walmart
TXN0000012317,2024-12-17T13:33:57,ACC00005887,Debit,481.43,-480758.3,JPY,Restaurant
TXN0000012318,2024-10-29T00:33:56,ACC00004101,ATM,1404.74,-482163.04,EUR,Amazon
TXN0000012319,2024-08-26T11:54:17,ACC00001075,Debit,49.62,-482212.66,USD,Walmart
TXN0000012320,2024-12-26T13:53:16,ACC00006378,ATM,67.39,-482280.05,JPY,Amazon
TXN0000012321,2024-08-03T12:03:12,ACC00007392,Payment,1907.61,-484187.66,GBP,Restaurant
TXN0000012322,2024-07-27T11:38:32,ACC00003639,Transfer,695.58,-483492.08,USD,Shell
TXN0000012323,2024-07-04T15:34:04,ACC00002848,Debit,420.99,-483913.07,USD,Online Store
TXN0000012324,2024-07-19T00:38:33,ACC00005931,Transfer,262.04,-483651.03,GBP,Target
TXN0000012325,2024-01-01T06:25:31,ACC00006142,ATM,1166.18,-484817.21,JPY,Target
TXN0000012326,2024-04-21T20:54:28,ACC00008119,Debit,871.23,-485688.44,USD,Online Store
TXN0000012327,2024-07-11T10:47:17,ACC00006867,Credit,529.21,-485159.23,JPY,Walmart
TXN0000012328,2024-11-07T03:25:41,ACC00001505,ATM,717.18,-485876.41,GBP,Walmart
TXN0000012329,2024-06-23T10:56:48,ACC00001206,Debit,669.83,-486546.24,GBP,Amazon
TXN0000012330,2024-10-18T06:51:53,ACC00008601,Debit,988.96,-487535.2,USD,Walmart
TXN0000012331,2024-03-31T02:47:40,ACC00004481,ATM,1656.69,-489191.89,EUR,Starbucks
TXN0000012332,2024-11-01T15:59:55,ACC00006802,Payment,622.1,-489813.99,GBP,Grocery
TXN0000012333,2024-10-21T00:00:41,ACC00007154,ATM,977.12,-490791.11,JPY,Target
TXN0000012334,2024-04-07T04:32:12,ACC00002022,Credit,658.39,-490132.72,EUR,Grocery
TXN0000012335,2024-05-18T23:48:13,ACC00003983,Debit,904.72,-491037.44,EUR,Target
TXN0000012336,2024-10-22T04:03:16,ACC00006413,Transfer,712.56,-490324.88,USD,Starbucks
TXN0000012337,2024-08-12T05:24:34,ACC00004097,ATM,1999.89,-492324.77,USD,Shell
TXN0000012338,2024-06-13T09:25:03,ACC00002892,Debit,782.13,-493106.9,GBP,Walmart
TXN0000012339,2024-03-12T09:24:59,ACC00004639,Payment,1660.25,-494767.15,EUR,Amazon
TXN0000012340,2024-04-19T20:05:11,ACC00000007,Debit,1990.52,-496757.67,EUR,Online Store
TXN0000012341,2024-12-04T14:57:44,ACC00008634,ATM,1167.3,-497924.97,EUR,Grocery
TXN0000012342,2024-12-12T19:51:20,ACC00002997,Credit,1416.51,-496508.46,EUR,Grocery
TXN0000012343,2024-09-24T16:50:06,ACC00003803,ATM,891.87,-497400.33,GBP,Shell
TXN0000012344,2024-02-27T16:48:38,ACC00004991,Credit,1464.61,-495935.72,EUR,Grocery
TXN0000012345,2024-12-12T08:50:42,ACC00002650,ATM,1759.36,-497695.08,GBP,Shell
TXN0000012346,2024-10-23T11:02:30,ACC00002155,Payment,53.81,-497748.89,USD,Shell
TXN0000012347,2024-06-21T03:09:29,ACC00008514,Payment,1654.37,-499403.26,USD,Restaurant
TXN0000012348,2024-03-23T02:39:37,ACC00009213,Transfer,153.07,-499250.19,EUR,Target
TXN0000012349,2024-04-19T17:22:38,ACC00006053,Credit,919.66,-498330.53,EUR,Shell
TXN0000012350,2024-04-27T19:45:57,ACC00004398,Payment,506.48,-498837.01,EUR,Online Store
TXN0000012351,2024-03-05T10:29:33,ACC00006461,Payment,1718.01,-500555.02,GBP,Amazon
TXN0000012352,2024-10-09T10:10:00,ACC00006529,Transfer,151.2,-500403.82,EUR,Grocery
TXN0000012353,2024-09-05T14:19:55,ACC00004996,Transfer,182.87,-500220.95,EUR,Walmart
TXN0000012354,2024-05-22T06:54:23,ACC00000216,Credit,801.31,-499419.64,JPY,Online Store
TXN0000012355,2024-03-25T17:49:44,ACC00008272,Credit,1998.71,-497420.93,GBP,Restaurant
TXN0000012356,2024-05-28T12:16:44,ACC00007411,Credit,1905.43,-495515.5,GBP,Walmart
TXN0000012357,2024-12-30T03:45:00,ACC00000804,Debit,1618.22,-497133.72,EUR,Target
TXN0000012358,2024-04-21T08:16:56,ACC00009084,ATM,1754.0,-498887.72,USD,Online Store
TXN0000012359,2024-08-05T15:08:06,ACC00005617,Debit,494.76,-499382.48,USD,Walmart
TXN0000012360,2024-10-29T18:03:46,ACC00001660,ATM,247.17,-499629.65,JPY,Online Store
TXN0000012361,2024-04-25T10:49:30,ACC00008675,Payment,946.78,-500576.43,GBP,Amazon
TXN0000012362,2024-08-20T10:02:04,ACC00001380,Credit,167.62,-500408.81,GBP,Online Store
TXN0000012363,2024-09-19T00:00:32,ACC00005456,Transfer,991.01,-499417.8,EUR,Amazon
TXN0000012364,2024-01-06T03:07:56,ACC00005637,Debit,728.15,-500145.95,JPY,Starbucks
TXN0000012365,2024-02-08T08:03:58,ACC00006782,Payment,1831.5,-501977.45,USD,Amazon
TXN0000012366,2024-04-22T15:26:43,ACC00002179,ATM,1033.84,-503011.29,GBP,Online Store
TXN0000012367,2024-12-04T16:43:06,ACC00002187,Payment,1025.71,-504037.0,EUR,Walmart
TXN0000012368,2024-11-24T19:39:35,ACC00007868,Credit,424.66,-503612.34,USD,Target
TXN0000012369,2024-09-21T07:19:34,ACC00007396,Transfer,668.36,-502943.98,GBP,Starbucks
TXN0000012370,2024-10-14T12:25:27,ACC00005788,Debit,1815.8,-504759.78,JPY,Walmart
TXN0000012371,2024-03-07T20:10:28,ACC00005799,Debit,1419.49,-506179.27,USD,Target
TXN0000012372,2024-07-10T00:30:14,ACC00004086,ATM,15.32,-506194.59,USD,Target
TXN0000012373,2024-05-20T04:56:54,ACC00004184,Credit,385.16,-505809.43,USD,Walmart
TXN0000012374,2024-01-21T16:35:22,ACC00006151,Transfer,503.66,-505305.77,GBP,Target
TXN0000012375,2024-07-06T07:18:17,ACC00009852,Payment,1726.47,-507032.24,USD,Grocery
TXN0000012376,2024-09-08T13:48:19,ACC00007706,Credit,475.23,-506557.01,GBP,Grocery
TXN0000012377,2024-11-01T10:54:30,ACC00000222,Credit,764.17,-505792.84,EUR,Online Store
TXN0000012378,2024-03-17T15:37:53,ACC00000559,Credit,823.92,-504968.92,JPY,Target
TXN0000012379,2024-02-26T04:56:08,ACC00003035,Debit,1691.32,-506660.24,USD,Amazon
TXN0000012380,2024-03-27T19:38:20,ACC00003415,Payment,990.81,-507651.05,USD,Online Store
TXN0000012381,2024-03-13T19:39:42,ACC00008500,Payment,1690.19,-509341.24,JPY,Grocery
TXN0000012382,2024-11-11T06:12:50,ACC00001812,Debit,40.54,-509381.78,GBP,Starbucks
TXN0000012383,2024-06-12T07:34:11,ACC00006232,ATM,412.03,-509793.81,GBP,Walmart
TXN0000012384,2024-10-16T17:57:31,ACC00001914,ATM,836.28,-510630.09,GBP,Online Store
TXN0000012385,2024-06-15T02:12:44,ACC00004164,Debit,846.06,-511476.15,EUR,Target
TXN0000012386,2024-04-26T20:35:38,ACC00000997,Debit,1423.5,-512899.65,EUR,Restaurant
TXN0000012387,2024-05-12T05:12:19,ACC00006914,Transfer,1478.05,-511421.6,USD,Grocery
TXN0000012388,2024-08-18T13:01:58,ACC00005184,Credit,314.25,-511107.35,JPY,Restaurant
TXN0000012389,2024-09-20T23:24:17,ACC00003845,Transfer,827.81,-510279.54,GBP,Target
TXN0000012390,2024-01-30T23:50:55,ACC00007520,Debit,1291.69,-511571.23,JPY,Starbucks
TXN0000012391,2024-07-07T12:14:50,ACC00009015,Payment,869.4,-512440.63,USD,Restaurant
TXN0000012392,2024-12-28T09:37:08,ACC00003898,ATM,367.52,-512808.15,JPY,Amazon
TXN0000012393,2024-12-28T14:00:40,ACC00003723,ATM,277.02,-513085.17,GBP,Restaurant
TXN0000012394,2024-10-14T02:17:10,ACC00008386,Payment,741.75,-513826.92,EUR,Shell
TXN0000012395,2024-11-30T10:21:47,ACC00004350,Transfer,1347.26,-512479.66,JPY,Grocery
TXN0000012396,2024-10-24T11:08:57,ACC00002502,Debit,1015.95,-513495.61,EUR,Shell
TXN0000012397,2024-01-11T10:01:07,ACC00004575,Transfer,459.59,-513036.02,JPY,Shell
TXN0000012398,2024-08-08T03:34:26,ACC00009469,Transfer,208.96,-512827.06,JPY,Restaurant
TXN0000012399,2024-09-23T20:09:07,ACC00005447,ATM,1787.85,-514614.91,USD,Target
TXN0000012400,2024-08-30T07:23:54,ACC00009106,Credit,617.07,-513997.84,JPY,Shell
TXN0000012401,2024-04-08T17:53:07,ACC00000974,Payment,184.18,-514182.02,EUR,Grocery
TXN0000012402,2024-09-21T05:54:31,ACC00006295,Payment,652.73,-514834.75,USD,Target
TXN0000012403,2024-07-09T15:32:27,ACC00006940,Credit,135.07,-514699.68,GBP,Target
TXN0000012404,2024-03-16T02:19:01,ACC00000130,Credit,1594.33,-513105.35,JPY,Shell
TXN0000012405,2024-11-25T03:39:54,ACC00000389,Debit,524.07,-513629.42,USD,Starbucks
TXN0000012406,2024-11-12T01:33:08,ACC00006310,ATM,1369.7,-514999.12,USD,Online Store
TXN0000012407,2024-04-02T00:46:59,ACC00002205,Debit,976.08,-515975.2,USD,Shell
TXN0000012408,2024-10-13T00:01:38,ACC00004782,ATM,1707.27,-517682.47,JPY,Target
TXN0000012409,2024-04-26T19:20:13,ACC00005840,ATM,1941.96,-519624.43,USD,Shell
TXN0000012410,2024-01-22T15:44:33,ACC00009279,Payment,1553.41,-521177.84,JPY,Amazon
TXN0000012411,2024-12-08T07:21:10,ACC00007353,Transfer,1455.43,-519722.41,USD,Shell
TXN0000012412,2024-04-15T11:29:00,ACC00009024,Transfer,513.64,-519208.77,GBP,Walmart
TXN0000012413,2024-12-03T10:03:39,ACC00006574,Debit,1089.13,-520297.9,GBP,Starbucks
TXN0000012414,2024-09-13T22:18:47,ACC00008257,Debit,240.92,-520538.82,JPY,Amazon
TXN0000012415,2024-02-03T22:38:09,ACC00002945,Credit,339.27,-520199.55,EUR,Online Store
TXN0000012416,2024-07-20T03:31:57,ACC00001082,Payment,1589.11,-521788.66,GBP,Target
TXN0000012417,2024-07-09T02:31:31,ACC00003165,Credit,1966.47,-519822.19,USD,Shell
TXN0000012418,2024-10-31T23:15:30,ACC00005356,Transfer,1220.88,-518601.31,GBP,Restaurant
TXN0000012419,2024-02-04T01:18:51,ACC00003734,Payment,1741.22,-520342.53,GBP,Grocery
TXN0000012420,2024-03-12T13:59:36,ACC00008869,Debit,24.13,-520366.66,USD,Target
TXN0000012421,2024-08-11T01:52:19,ACC00002188,Transfer,1261.57,-519105.09,EUR,Grocery
TXN0000012422,2024-05-09T22:37:05,ACC00003186,Transfer,1163.09,-517942.0,USD,Online Store
TXN0000012423,2024-09-15T05:27:04,ACC00000397,Payment,332.1,-518274.1,JPY,Restaurant
TXN0000012424,2024-08-01T15:20:31,ACC00003470,Debit,1272.68,-519546.78,USD,Restaurant
TXN0000012425,2024-12-02T01:59:08,ACC00004020,Transfer,1789.05,-517757.73,EUR,Restaurant
TXN0000012426,2024-01-16T17:34:59,ACC00007081,Credit,769.76,-516987.97,JPY,Walmart
TXN0000012427,2024-01-27T12:53:25,ACC00000075,Credit,44.38,-516943.59,EUR,Amazon
TXN0000012428,2024-12-07T06:10:27,ACC00006784,Payment,721.93,-517665.52,GBP,Shell
TXN0000012429,2024-09-13T16:28:02,ACC00000506,Debit,833.88,-518499.4,GBP,Walmart
TXN0000012430,2024-02-27T10:25:39,ACC00004578,Transfer,492.75,-518006.65,USD,Target
TXN0000012431,2024-01-11T10:42:46,ACC00004760,Debit,1724.34,-519730.99,JPY,Amazon
TXN0000012432,2024-06-23T18:53:22,ACC00002487,Credit,800.92,-518930.07,EUR,Grocery
TXN0000012433,2024-04-12T01:37:16,ACC00007815,Payment,424.96,-519355.03,GBP,Online Store
TXN0000012434,2024-01-21T13:20:17,ACC00002808,Debit,1077.82,-520432.85,GBP,Walmart
TXN0000012435,2024-06-30T18:16:10,ACC00004769,Payment,1959.86,-522392.71,USD,Amazon
TXN0000012436,2024-04-24T06:14:30,ACC00001303,Debit,743.24,-523135.95,EUR,Starbucks
TXN0000012437,2024-12-14T17:43:33,ACC00000905,Debit,292.71,-523428.66,JPY,Grocery
TXN0000012438,2024-05-08T12:17:44,ACC00006597,Credit,1520.36,-521908.3,GBP,Shell
TXN0000012439,2024-05-13T05:03:58,ACC00009052,ATM,309.4,-522217.7,JPY,Walmart
TXN0000012440,2024-10-04T21:06:16,ACC00007157,Payment,1135.26,-523352.96,GBP,Online Store
TXN0000012441,2024-01-23T18:57:12,ACC00007436,Payment,296.11,-523649.07,EUR,Target
TXN0000012442,2024-02-15T22:43:39,ACC00004172,ATM,907.45,-524556.52,JPY,Shell
TXN0000012443,2024-04-23T07:42:20,ACC00000160,Debit,1392.23,-525948.75,EUR,Amazon
TXN0000012444,2024-01-10T16:45:41,ACC00007537,ATM,1445.74,-527394.49,EUR,Shell
TXN0000012445,2024-04-25T19:21:28,ACC00003545,ATM,695.53,-528090.02,EUR,Starbucks
TXN0000012446,2024-07-09T10:55:48,ACC00008503,Payment,1489.0,-529579.02,EUR,Grocery
TXN0000012447,2024-03-06T04:24:33,ACC00007027,ATM,1645.86,-531224.88,JPY,Shell
TXN0000012448,2024-04-23T15:19:20,ACC00007938,Debit,129.32,-531354.2,JPY,Walmart
TXN0000012449,2024-07-06T18:56:59,ACC00003895,Transfer,285.61,-531068.59,JPY,Grocery
TXN0000012450,2024-07-02T09:34:38,ACC00008758,Debit,1891.23,-532959.82,JPY,Grocery
TXN0000012451,2024-07-26T22:52:00,ACC00002065,Payment,223.03,-533182.85,USD,Target
TXN0000012452,2024-09-11T20:22:06,ACC00006004,Payment,1525.23,-534708.08,USD,Online Store
TXN0000012453,2024-09-02T08:57:43,ACC00005233,Payment,1680.82,-536388.9,USD,Grocery
TXN0000012454,2024-05-20T14:46:54,ACC00006876,Payment,161.75,-536550.65,USD,Shell
TXN0000012455,2024-03-24T15:30:36,ACC00009812,ATM,974.56,-537525.21,JPY,Amazon
TXN0000012456,2024-06-18T04:11:44,ACC00000049,Debit,626.67,-538151.88,USD,Starbucks
TXN0000012457,2024-07-16T06:48:17,ACC00003593,Payment,372.75,-538524.63,EUR,Restaurant
TXN0000012458,2024-03-05T09:42:20,ACC00004534,Transfer,332.87,-538191.76,GBP,Grocery
TXN0000012459,2024-12-20T06:54:17,ACC00007741,ATM,1658.32,-539850.08,USD,Target
TXN0000012460,2024-08-15T17:35:19,ACC00002593,Debit,912.45,-540762.53,JPY,Restaurant
TXN0000012461,2024-01-23T09:45:03,ACC00002762,Credit,806.67,-539955.86,USD,Restaurant
TXN0000012462,2024-03-26T10:03:31,ACC00003199,ATM,638.35,-540594.21,GBP,Shell
TXN0000012463,2024-02-08T20:21:59,ACC00003359,Credit,1263.68,-539330.53,USD,Shell
TXN0000012464,2024-05-30T09:13:27,ACC00002135,Debit,840.4,-540170.93,EUR,Walmart
TXN0000012465,2024-02-19T15:05:21,ACC00003781,Payment,1093.1,-541264.03,EUR,Grocery
TXN0000012466,2024-12-06T15:11:16,ACC00008413,Debit,959.3,-542223.33,EUR,Restaurant
TXN0000012467,2024-02-13T20:28:59,ACC00005508,Credit,390.03,-541833.3,JPY,Starbucks
TXN0000012468,2024-10-26T20:06:21,ACC00008367,Transfer,1388.82,-540444.48,EUR,Target
TXN0000012469,2024-06-24T00:25:53,ACC00007452,Credit,1254.79,-539189.69,JPY,Online Store
TXN0000012470,2024-09-26T23:26:50,ACC00009740,Debit,1482.33,-540672.02,GBP,Grocery
TXN0000012471,2024-02-15T13:50:55,ACC00005772,Transfer,555.45,-540116.57,JPY,Shell
TXN0000012472,2024-09-24T12:22:10,ACC00004193,Credit,340.08,-539776.49,USD,Walmart
TXN0000012473,2024-11-20T04:02:12,ACC00003737,Transfer,587.99,-539188.5,EUR,Online Store
TXN0000012474,2024-07-31T14:42:17,ACC00003129,ATM,1070.22,-540258.72,JPY,Starbucks
TXN0000012475,2024-03-31T04:11:45,ACC00002913,Debit,1742.58,-542001.3,GBP,Amazon
TXN0000012476,2024-06-01T07:13:29,ACC00009226,ATM,955.91,-542957.21,JPY,Shell
TXN0000012477,2024-04-16T22:43:17,ACC00001022,Transfer,1088.29,-541868.92,EUR,Restaurant
TXN0000012478,2024-02-14T14:48:14,ACC00008627,ATM,48.06,-541916.98,JPY,Walmart
TXN0000012479,2024-02-26T01:47:27,ACC00005080,Debit,1602.98,-543519.96,USD,Amazon
TXN0000012480,2024-07-06T08:46:03,ACC00008200,Payment,273.79,-543793.75,USD,Starbucks
TXN0000012481,2024-12-10T20:19:12,ACC00000342,Payment,1633.15,-545426.9,GBP,Walmart
TXN0000012482,2024-04-15T01:23:14,ACC00002087,ATM,1896.2,-547323.1,EUR,Shell
TXN0000012483,2024-12-13T20:24:49,ACC00007705,Payment,1607.42,-548930.52,USD,Shell
TXN0000012484,2024-03-16T19:00:03,ACC00005853,Payment,1761.08,-550691.6,USD,Online Store
TXN0000012485,2024-06-22T15:01:09,ACC00007940,ATM,1727.53,-552419.13,EUR,Restaurant
TXN0000012486,2024-09-14T20:21:57,ACC00006714,Debit,99.59,-552518.72,EUR,Shell
TXN0000012487,2024-02-27T16:28:51,ACC00007049,Debit,959.71,-553478.43,EUR,Grocery
TXN0000012488,2024-06-26T03:55:49,ACC00008515,ATM,1068.44,-554546.87,EUR,Starbucks
TXN0000012489,2024-05-07T02:08:37,ACC00001239,Debit,1476.95,-556023.82,GBP,Shell
TXN0000012490,2024-02-12T02:54:29,ACC00000896,Transfer,597.39,-555426.43,USD,Grocery
TXN0000012491,2024-04-05T03:14:09,ACC00004322,Credit,132.19,-555294.24,USD,Target
TXN0000012492,2024-08-26T19:49:39,ACC00009727,Payment,1174.79,-556469.03,GBP,Starbucks
TXN0000012493,2024-08-17T18:34:43,ACC00002451,Payment,962.66,-557431.69,EUR,Restaurant
TXN0000012494,2024-05-14T04:53:23,ACC00009691,Debit,1155.12,-558586.81,USD,Target
TXN0000012495,2024-10-27T21:16:37,ACC00008057,Payment,1311.12,-559897.93,JPY,Walmart
TXN0000012496,2024-04-24T08:57:52,ACC00008486,Payment,1637.26,-561535.19,JPY,Starbucks
TXN0000012497,2024-10-11T01:07:30,ACC00004730,Transfer,823.95,-560711.24,USD,Restaurant
TXN0000012498,2024-06-20T20:46:33,ACC00001974,Debit,1557.51,-562268.75,EUR,Restaurant
TXN0000012499,2024-01-16T01:15:25,ACC00004646,Debit,975.56,-563244.31,JPY,Shell
TXN0000012500,2024-10-16T05:35:42,ACC00002352,Transfer,941.75,-562302.56,USD,Online Store
TXN0000012501,2024-06-17T08:38:41,ACC00008670,Credit,919.57,-561382.99,USD,Target
TXN0000012502,2024-05-16T04:22:37,ACC00004814,Debit,1518.03,-562901.02,JPY,Restaurant
TXN0000012503,2024-02-05T20:12:57,ACC00009032,Transfer,1886.82,-561014.2,GBP,Starbucks
TXN0000012504,2024-12-04T17:06:06,ACC00001814,Debit,1893.98,-562908.18,EUR,Shell
TXN0000012505,2024-10-30T13:03:43,ACC00007786,Debit,101.0,-563009.18,EUR,Starbucks
TXN0000012506,2024-03-29T09:06:27,ACC00000187,Credit,406.65,-562602.53,JPY,Starbucks
TXN0000012507,2024-04-16T14:21:27,ACC00001075,Debit,1768.08,-564370.61,EUR,Shell
TXN0000012508,2024-08-16T21:56:11,ACC00009238,Payment,1271.8,-565642.41,JPY,Grocery
TXN0000012509,2024-03-06T19:39:03,ACC00001011,Credit,1881.21,-563761.2,GBP,Shell
TXN0000012510,2024-11-11T12:09:33,ACC00006218,Credit,17.05,-563744.15,GBP,Walmart
TXN0000012511,2024-06-15T18:27:17,ACC00000021,Credit,484.96,-563259.19,EUR,Amazon
TXN0000012512,2024-09-12T09:36:35,ACC00003331,Debit,1972.65,-565231.84,USD,Amazon
TXN0000012513,2024-10-18T23:27:04,ACC00005732,ATM,1706.31,-566938.15,EUR,Walmart
TXN0000012514,2024-06-11T17:29:41,ACC00008366,Transfer,1982.43,-564955.72,USD,Amazon
TXN0000012515,2024-05-20T09:37:36,ACC00003660,Debit,656.94,-565612.66,EUR,Restaurant
TXN0000012516,2024-08-14T15:04:58,ACC00006565,Debit,1331.24,-566943.9,EUR,Shell
TXN0000012517,2024-10-31T12:52:27,ACC00005067,ATM,1670.9,-568614.8,USD,Restaurant
TXN0000012518,2024-03-15T23:40:02,ACC00003972,ATM,1660.72,-570275.52,GBP,Online Store
TXN0000012519,2024-11-13T07:27:47,ACC00002940,Debit,999.29,-571274.81,GBP,Grocery
TXN0000012520,2024-05-31T07:40:53,ACC00008053,ATM,1216.69,-572491.5,USD,Online Store
TXN0000012521,2024-05-03T02:01:25,ACC00008010,ATM,654.97,-573146.47,JPY,Target
TXN0000012522,2024-08-14T08:50:44,ACC00009056,Payment,1625.22,-574771.69,USD,Walmart
TXN0000012523,2024-02-06T12:28:02,ACC00000546,Transfer,1970.64,-572801.05,EUR,Shell
TXN0000012524,2024-08-13T02:00:02,ACC00009870,Transfer,759.86,-572041.19,GBP,Target
TXN0000012525,2024-06-30T07:17:09,ACC00003462,Transfer,1000.79,-571040.4,GBP,Amazon
TXN0000012526,2024-05-30T14:35:08,ACC00005685,Transfer,1350.18,-569690.22,JPY,Shell
TXN0000012527,2024-09-18T01:01:33,ACC00005863,Credit,450.43,-569239.79,EUR,Amazon
TXN0000012528,2024-02-18T12:46:29,ACC00004656,ATM,1209.02,-570448.81,GBP,Walmart
TXN0000012529,2024-08-21T16:58:03,ACC00000330,Payment,1248.19,-571697.0,USD,Amazon
TXN0000012530,2024-07-17T09:56:37,ACC00000752,Payment,1923.17,-573620.17,JPY,Online Store
TXN0000012531,2024-10-25T08:09:10,ACC00002858,Credit,73.02,-573547.15,EUR,Walmart
TXN0000012532,2024-03-21T00:51:14,ACC00005474,Payment,1758.79,-575305.94,GBP,Starbucks
TXN0000012533,2024-06-06T05:03:14,ACC00006328,Payment,12.67,-575318.61,GBP,Target
TXN0000012534,2024-07-24T05:48:31,ACC00009587,Payment,923.61,-576242.22,JPY,Grocery
TXN0000012535,2024-03-14T12:46:07,ACC00009394,Transfer,256.95,-575985.27,JPY,Amazon
TXN0000012536,2024-07-29T04:53:01,ACC00005145,Transfer,1158.52,-574826.75,GBP,Walmart
TXN0000012537,2024-02-03T14:39:30,ACC00001845,Payment,596.06,-575422.81,EUR,Starbucks
TXN0000012538,2024-12-29T21:38:15,ACC00008165,Debit,642.19,-576065.0,GBP,Shell
TXN0000012539,2024-05-25T02:29:36,ACC00000649,Debit,563.74,-576628.74,GBP,Grocery
TXN0000012540,2024-12-25T19:09:54,ACC00001194,ATM,1733.92,-578362.66,USD,Target
TXN0000012541,2024-05-08T13:17:47,ACC00002703,Transfer,1357.37,-577005.29,EUR,Restaurant
TXN0000012542,2024-11-23T00:19:23,ACC00005893,Transfer,1301.97,-575703.32,EUR,Shell
TXN0000012543,2024-01-10T11:45:18,ACC00003586,Credit,711.71,-574991.61,EUR,Shell
TXN0000012544,2024-11-11T07:35:43,ACC00001641,Transfer,1125.44,-573866.17,JPY,Starbucks
TXN0000012545,2024-12-28T18:47:00,ACC00004631,Credit,600.57,-573265.6,USD,Walmart
TXN0000012546,2024-02-20T12:58:08,ACC00005386,Debit,95.28,-573360.88,USD,Online Store
TXN0000012547,2024-01-20T20:58:55,ACC00006558,Credit,259.25,-573101.63,EUR,Shell
TXN0000012548,2024-11-03T01:35:27,ACC00007608,Payment,1206.31,-574307.94,GBP,Restaurant
TXN0000012549,2024-01-20T08:17:31,ACC00002666,ATM,1470.78,-575778.72,JPY,Online Store
TXN0000012550,2024-10-06T05:49:22,ACC00007959,Credit,45.62,-575733.1,USD,Walmart
TXN0000012551,2024-10-10T02:33:47,ACC00005323,ATM,759.69,-576492.79,JPY,Amazon
TXN0000012552,2024-11-07T12:13:48,ACC00009882,Credit,1335.77,-575157.02,GBP,Walmart
TXN0000012553,2024-07-14T15:11:41,ACC00006032,Payment,748.92,-575905.94,GBP,Online Store
TXN0000012554,2024-08-06T00:44:11,ACC00007804,Payment,1876.46,-577782.4,EUR,Online Store
TXN0000012555,2024-04-29T12:08:42,ACC00002017,Debit,1783.39,-579565.79,JPY,Online Store
TXN0000012556,2024-12-12T00:27:08,ACC00001437,ATM,1523.0,-581088.79,USD,Grocery
TXN0000012557,2024-11-02T04:13:15,ACC00007900,Debit,1216.23,-582305.02,EUR,Amazon
TXN0000012558,2024-04-22T04:52:28,ACC00002081,Transfer,191.25,-582113.77,GBP,Restaurant
TXN0000012559,2024-04-13T03:59:42,ACC00003561,Transfer,407.23,-581706.54,JPY,Grocery
TXN0000012560,2024-03-23T11:19:52,ACC00002413,Payment,871.85,-582578.39,EUR,Online Store
TXN0000012561,2024-11-07T21:38:53,ACC00009362,Transfer,1888.92,-580689.47,EUR,Walmart
TXN0000012562,2024-06-26T01:28:13,ACC00008297,Debit,675.75,-581365.22,GBP,Shell
TXN0000012563,2024-03-09T08:35:53,ACC00006613,Credit,1598.17,-579767.05,EUR,Amazon
TXN0000012564,2024-12-04T11:52:46,ACC00005771,ATM,1846.49,-581613.54,USD,Grocery
TXN0000012565,2024-11-07T01:27:14,ACC00009416,Debit,1266.07,-582879.61,JPY,Grocery
TXN0000012566,2024-01-06T22:31:16,ACC00003464,ATM,1432.45,-584312.06,GBP,Online Store
TXN0000012567,2024-03-16T14:36:46,ACC00004417,ATM,1739.62,-586051.68,USD,Target
TXN0000012568,2024-05-30T08:42:29,ACC00008951,Transfer,541.71,-585509.97,USD,Target
TXN0000012569,2024-12-23T23:49:28,ACC00000287,Credit,713.21,-584796.76,EUR,Restaurant
TXN0000012570,2024-10-10T06:52:19,ACC00001473,Payment,1526.57,-586323.33,JPY,Amazon
TXN0000012571,2024-01-04T09:08:11,ACC00006309,Transfer,1989.92,-584333.41,JPY,Walmart
TXN0000012572,2024-01-17T13:18:51,ACC00008429,Debit,1927.13,-586260.54,EUR,Shell
TXN0000012573,2024-03-13T21:51:39,ACC00000770,Credit,867.15,-585393.39,GBP,Target
TXN0000012574,2024-02-05T01:31:47,ACC00004827,ATM,248.66,-585642.05,JPY,Target
TXN0000012575,2024-06-27T12:55:18,ACC00003598,Credit,720.33,-584921.72,JPY,Online Store
TXN0000012576,2024-09-04T09:11:21,ACC00007359,Credit,1637.59,-583284.13,USD,Restaurant
TXN0000012577,2024-09-19T03:09:28,ACC00007508,Debit,1339.04,-584623.17,EUR,Amazon
TXN0000012578,2024-12-12T00:29:16,ACC00006448,Credit,1971.12,-582652.05,USD,Shell
TXN0000012579,2024-07-21T07:09:06,ACC00007935,Debit,146.3,-582798.35,EUR,Online Store
TXN0000012580,2024-11-15T16:50:30,ACC00001930,Transfer,1439.14,-581359.21,GBP,Walmart
TXN0000012581,2024-06-25T15:26:31,ACC00000941,Payment,1513.55,-582872.76,USD,Starbucks
TXN0000012582,2024-05-13T13:26:25,ACC00001832,Credit,535.86,-582336.9,USD,Starbucks
TXN0000012583,2024-08-26T23:05:32,ACC00007086,Credit,1353.42,-580983.48,EUR,Restaurant
TXN0000012584,2024-10-25T04:56:21,ACC00001992,Transfer,1572.97,-579410.51,USD,Walmart
TXN0000012585,2024-04-03T19:36:27,ACC00004916,Debit,1789.27,-581199.78,JPY,Shell
TXN0000012586,2024-05-03T10:09:16,ACC00005761,Credit,123.01,-581076.77,USD,Shell
TXN0000012587,2024-05-15T10:37:47,ACC00004672,Credit,356.39,-580720.38,JPY,Restaurant
TXN0000012588,2024-10-18T08:05:34,ACC00005694,ATM,539.47,-581259.85,USD,Grocery
TXN0000012589,2024-06-19T16:06:33,ACC00002425,ATM,1116.35,-582376.2,EUR,Restaurant
TXN0000012590,2024-03-17T12:04:28,ACC00009434,Credit,1030.27,-581345.93,JPY,Starbucks
TXN0000012591,2024-07-13T02:37:42,ACC00000755,Credit,1215.1,-580130.83,EUR,Grocery
TXN0000012592,2024-12-24T13:01:14,ACC00009351,Credit,137.27,-579993.56,JPY,Walmart
TXN0000012593,2024-07-31T01:01:12,ACC00003869,Debit,1821.62,-581815.18,EUR,Target
TXN0000012594,2024-09-21T20:53:21,ACC00008971,Credit,1382.49,-580432.69,JPY,Restaurant
TXN0000012595,2024-04-06T02:28:34,ACC00003196,Debit,1837.03,-582269.72,USD,Walmart
TXN0000012596,2024-07-16T21:42:21,ACC00000849,Credit,216.79,-582052.93,USD,Amazon
TXN0000012597,2024-09-29T02:13:30,ACC00002445,ATM,1102.34,-583155.27,JPY,Starbucks
TXN0000012598,2024-11-04T00:35:04,ACC00005630,Credit,364.04,-582791.23,EUR,Amazon
TXN0000012599,2024-06-17T08:27:13,ACC00007976,Credit,1736.07,-581055.16,USD,Restaurant
TXN0000012600,2024-08-10T18:13:37,ACC00002780,Transfer,717.88,-580337.28,GBP,Amazon
TXN0000012601,2024-04-19T01:40:33,ACC00003679,Debit,1621.91,-581959.19,USD,Target
TXN0000012602,2024-08-04T12:50:52,ACC00003648,Transfer,358.77,-581600.42,GBP,Grocery
TXN0000012603,2024-03-20T05:48:53,ACC00003494,Payment,961.19,-582561.61,USD,Grocery
TXN0000012604,2024-05-15T20:01:47,ACC00006722,Transfer,1779.78,-580781.83,EUR,Target
TXN0000012605,2024-09-09T10:15:30,ACC00000567,Credit,569.71,-580212.12,USD,Target
TXN0000012606,2024-10-04T23:10:19,ACC00007433,Credit,1016.7,-579195.42,USD,Grocery
TXN0000012607,2024-08-13T13:50:27,ACC00003653,ATM,515.2,-579710.62,USD,Starbucks
TXN0000012608,2024-10-09T23:43:05,ACC00005715,Debit,220.99,-579931.61,USD,Restaurant
TXN0000012609,2024-01-12T22:09:35,ACC00006791,ATM,1243.49,-581175.1,USD,Starbucks
TXN0000012610,2024-03-16T08:56:02,ACC00003355,Debit,1928.12,-583103.22,JPY,Starbucks
TXN0000012611,2024-06-15T02:56:11,ACC00003119,ATM,1456.68,-584559.9,USD,Starbucks
TXN0000012612,2024-08-22T14:29:12,ACC00002568,Transfer,1381.34,-583178.56,GBP,Grocery
TXN0000012613,2024-04-02T06:52:26,ACC00006971,Credit,1797.28,-581381.28,GBP,Grocery
TXN0000012614,2024-05-28T00:16:04,ACC00004785,Credit,1020.88,-580360.4,GBP,Target
TXN0000012615,2024-04-30T10:08:31,ACC00004967,Payment,1226.68,-581587.08,EUR,Walmart
TXN0000012616,2024-11-02T07:35:59,ACC00001997,Payment,940.39,-582527.47,GBP,Amazon
TXN0000012617,2024-09-10T02:11:09,ACC00002389,Payment,279.36,-582806.83,JPY,Target
TXN0000012618,2024-12-13T15:17:28,ACC00005283,Credit,513.86,-582292.97,USD,Starbucks
TXN0000012619,2024-09-16T17:22:02,ACC00005260,Payment,559.5,-582852.47,GBP,Shell
TXN0000012620,2024-09-05T00:26:42,ACC00003077,Transfer,1801.97,-581050.5,EUR,Amazon
TXN0000012621,2024-05-04T13:13:45,ACC00008543,ATM,442.57,-581493.07,USD,Restaurant
TXN0000012622,2024-05-21T04:34:44,ACC00005994,ATM,1323.01,-582816.08,GBP,Amazon
TXN0000012623,2024-01-11T06:34:45,ACC00008868,Credit,1805.53,-581010.55,JPY,Starbucks
TXN0000012624,2024-08-03T23:33:54,ACC00003009,Debit,217.47,-581228.02,EUR,Online Store
TXN0000012625,2024-08-10T01:41:26,ACC00008921,Payment,451.9,-581679.92,JPY,Amazon
TXN0000012626,2024-01-10T22:40:10,ACC00007855,Payment,95.03,-581774.95,JPY,Walmart
TXN0000012627,2024-05-05T22:00:11,ACC00000682,ATM,181.43,-581956.38,GBP,Target
TXN0000012628,2024-10-13T22:48:26,ACC00009029,Transfer,226.34,-581730.04,EUR,Shell
TXN0000012629,2024-06-05T20:09:44,ACC00002920,Credit,1489.17,-580240.87,GBP,Shell
TXN0000012630,2024-04-17T22:46:05,ACC00002531,Transfer,1751.67,-578489.2,EUR,Target
TXN0000012631,2024-06-26T17:50:11,ACC00005564,Credit,447.26,-578041.94,USD,Amazon
TXN0000012632,2024-12-02T01:55:32,ACC00007868,Payment,1707.66,-579749.6,JPY,Online Store
TXN0000012633,2024-10-14T07:31:51,ACC00006523,Credit,1521.01,-578228.59,JPY,Grocery
TXN0000012634,2024-06-11T04:04:48,ACC00004751,Transfer,298.09,-577930.5,USD,Grocery
TXN0000012635,2024-07-05T20:46:30,ACC00002567,ATM,1766.81,-579697.31,GBP,Amazon
TXN0000012636,2024-11-01T00:55:56,ACC00002663,Transfer,172.34,-579524.97,EUR,Amazon
TXN0000012637,2024-08-19T19:39:24,ACC00003465,Payment,1542.9,-581067.87,GBP,Online Store
TXN0000012638,2024-09-02T01:31:58,ACC00007474,Payment,35.58,-581103.45,EUR,Starbucks
TXN0000012639,2024-07-12T08:51:44,ACC00009837,Payment,1585.94,-582689.39,EUR,Amazon
TXN0000012640,2024-03-17T05:27:55,ACC00006579,Transfer,358.38,-582331.01,GBP,Grocery
TXN0000012641,2024-10-11T17:41:15,ACC00009420,Credit,617.05,-581713.96,USD,Shell
TXN0000012642,2024-07-21T16:11:34,ACC00009571,Transfer,357.0,-581356.96,GBP,Shell
TXN0000012643,2024-08-27T20:37:22,ACC00004483,Debit,339.8,-581696.76,GBP,Shell
TXN0000012644,2024-08-04T17:54:39,ACC00004751,Credit,1567.18,-580129.58,EUR,Starbucks
TXN0000012645,2024-04-18T19:20:41,ACC00004177,Payment,1447.8,-581577.38,EUR,Target
TXN0000012646,2024-09-29T02:56:53,ACC00001262,Credit,548.58,-581028.8,EUR,Shell
TXN0000012647,2024-08-21T22:15:07,ACC00001447,Debit,99.32,-581128.12,USD,Restaurant
TXN0000012648,2024-06-03T02:29:17,ACC00007716,Payment,1552.0,-582680.12,GBP,Walmart
TXN0000012649,2024-02-27T18:31:45,ACC00001556,Transfer,1548.33,-581131.79,EUR,Amazon
TXN0000012650,2024-11-18T01:17:17,ACC00009201,ATM,1122.37,-582254.16,USD,Shell
TXN0000012651,2024-08-28T21:12:11,ACC00007211,Payment,335.13,-582589.29,GBP,Shell
TXN0000012652,2024-03-08T04:20:15,ACC00005136,Credit,1438.93,-581150.36,GBP,Shell
TXN0000012653,2024-04-30T01:38:13,ACC00007713,Transfer,1142.72,-580007.64,GBP,Restaurant
TXN0000012654,2024-07-10T16:41:54,ACC00008054,Transfer,1461.44,-578546.2,USD,Shell
TXN0000012655,2024-02-03T05:18:33,ACC00000348,Debit,947.12,-579493.32,EUR,Target
TXN0000012656,2024-01-09T01:27:26,ACC00003734,Transfer,326.11,-579167.21,GBP,Grocery
TXN0000012657,2024-01-07T22:51:35,ACC00009367,Credit,104.1,-579063.11,USD,Shell
TXN0000012658,2024-09-02T09:05:31,ACC00007195,ATM,1923.86,-580986.97,USD,Grocery
TXN0000012659,2024-08-18T22:46:26,ACC00007247,Payment,633.17,-581620.14,EUR,Shell
TXN0000012660,2024-10-24T17:58:17,ACC00003976,Transfer,987.02,-580633.12,EUR,Restaurant
TXN0000012661,2024-07-28T17:13:29,ACC00002283,Credit,149.71,-580483.41,USD,Walmart
TXN0000012662,2024-01-17T03:08:19,ACC00001820,Debit,1721.38,-582204.79,EUR,Target
TXN0000012663,2024-08-30T01:05:34,ACC00001776,Credit,1091.87,-581112.92,EUR,Online Store
TXN0000012664,2024-02-16T18:58:18,ACC00005277,Debit,1852.07,-582964.99,JPY,Walmart
TXN0000012665,2024-02-13T16:12:32,ACC00004811,Payment,487.45,-583452.44,GBP,Amazon
TXN0000012666,2024-02-22T14:40:05,ACC00009063,Transfer,793.53,-582658.91,JPY,Online Store
TXN0000012667,2024-04-18T19:38:51,ACC00006376,Debit,988.74,-583647.65,USD,Walmart
TXN0000012668,2024-12-17T13:01:58,ACC00004971,Credit,506.39,-583141.26,EUR,Restaurant
TXN0000012669,2024-01-08T13:43:29,ACC00001263,ATM,1007.8,-584149.06,EUR,Starbucks
TXN0000012670,2024-01-31T09:12:26,ACC00007900,ATM,1105.7,-585254.76,EUR,Target
TXN0000012671,2024-03-18T16:10:56,ACC00009881,ATM,1308.98,-586563.74,USD,Shell
TXN0000012672,2024-09-01T17:48:58,ACC00004619,Transfer,1087.44,-585476.3,USD,Starbucks
TXN0000012673,2024-06-21T10:29:58,ACC00001061,Payment,1896.52,-587372.82,USD,Starbucks
TXN0000012674,2024-08-06T00:53:01,ACC00001990,ATM,1230.06,-588602.88,USD,Online Store
TXN0000012675,2024-09-27T11:30:25,ACC00001775,ATM,250.17,-588853.05,EUR,Amazon
TXN0000012676,2024-06-30T01:09:51,ACC00006555,ATM,607.58,-589460.63,EUR,Online Store
TXN0000012677,2024-02-20T06:10:50,ACC00008901,Credit,468.38,-588992.25,JPY,Shell
TXN0000012678,2024-10-15T01:44:52,ACC00004174,Payment,1984.92,-590977.17,GBP,Shell
TXN0000012679,2024-10-08T13:31:19,ACC00003601,Debit,433.59,-591410.76,USD,Target
TXN0000012680,2024-11-28T14:19:48,ACC00004188,ATM,191.86,-591602.62,JPY,Shell
TXN0000012681,2024-12-06T00:43:20,ACC00004656,Credit,193.78,-591408.84,USD,Grocery
TXN0000012682,2024-08-17T09:27:58,ACC00005788,ATM,244.71,-591653.55,USD,Starbucks
TXN0000012683,2024-11-21T01:05:17,ACC00003489,ATM,634.44,-592287.99,USD,Target
TXN0000012684,2024-04-11T01:12:31,ACC00000895,Payment,1625.23,-593913.22,GBP,Walmart
TXN0000012685,2024-03-25T12:44:50,ACC00003768,Credit,699.86,-593213.36,USD,Amazon
TXN0000012686,2024-11-10T02:03:16,ACC00003369,Transfer,768.51,-592444.85,EUR,Target
TXN0000012687,2024-11-11T01:37:06,ACC00009317,Credit,1252.9,-591191.95,USD,Restaurant
TXN0000012688,2024-09-23T04:05:46,ACC00002158,Credit,1647.21,-589544.74,USD,Restaurant
TXN0000012689,2024-07-16T03:17:40,ACC00001914,ATM,210.01,-589754.75,EUR,Target
TXN0000012690,2024-12-06T16:47:16,ACC00004497,Transfer,79.89,-589674.86,USD,Grocery
TXN0000012691,2024-02-20T02:54:30,ACC00003259,Debit,1194.59,-590869.45,JPY,Shell
TXN0000012692,2024-11-25T15:37:12,ACC00005545,Debit,1580.56,-592450.01,USD,Walmart
TXN0000012693,2024-05-31T20:49:33,ACC00009448,ATM,379.31,-592829.32,GBP,Restaurant
TXN0000012694,2024-11-07T11:16:08,ACC00009348,Transfer,1933.43,-590895.89,GBP,Restaurant
TXN0000012695,2024-06-05T18:54:50,ACC00004362,ATM,1232.12,-592128.01,GBP,Shell
TXN0000012696,2024-07-01T23:26:36,ACC00009598,Debit,1950.58,-594078.59,JPY,Starbucks
TXN0000012697,2024-10-16T10:32:13,ACC00003966,ATM,657.91,-594736.5,GBP,Target
TXN0000012698,2024-06-15T13:03:49,ACC00000838,Transfer,1701.62,-593034.88,USD,Amazon
TXN0000012699,2024-04-12T11:16:18,ACC00002415,Transfer,1409.67,-591625.21,EUR,Online Store
TXN0000012700,2024-01-05T05:31:49,ACC00003355,ATM,918.05,-592543.26,JPY,Restaurant
TXN0000012701,2024-12-30T11:29:31,ACC00003713,Debit,1143.47,-593686.73,EUR,Starbucks
TXN0000012702,2024-05-18T08:25:25,ACC00000097,Payment,533.72,-594220.45,USD,Starbucks
TXN0000012703,2024-12-08T02:23:47,ACC00003699,Transfer,1075.29,-593145.16,USD,Restaurant
TXN0000012704,2024-04-17T16:08:46,ACC00002039,Transfer,1484.61,-591660.55,GBP,Online Store
TXN0000012705,2024-07-12T10:30:00,ACC00001699,Transfer,1145.91,-590514.64,USD,Walmart
TXN0000012706,2024-05-22T04:48:00,ACC00007833,Credit,1821.53,-588693.11,GBP,Grocery
TXN0000012707,2024-11-08T11:31:29,ACC00007980,Debit,1640.1,-590333.21,GBP,Starbucks
TXN0000012708,2024-01-10T15:31:47,ACC00007295,Payment,1667.5,-592000.71,GBP,Target
TXN0000012709,2024-07-13T17:03:58,ACC00007836,Debit,1410.77,-593411.48,GBP,Restaurant
TXN0000012710,2024-01-22T12:31:32,ACC00000408,Debit,43.38,-593454.86,GBP,Shell
TXN0000012711,2024-09-28T13:10:15,ACC00007708,Transfer,1724.97,-591729.89,GBP,Grocery
TXN0000012712,2024-12-08T04:54:23,ACC00007543,Payment,1018.26,-592748.15,EUR,Amazon
TXN0000012713,2024-10-10T06:50:08,ACC00001735,ATM,1973.7,-594721.85,EUR,Online Store
TXN0000012714,2024-07-25T17:34:47,ACC00001086,Transfer,440.71,-594281.14,GBP,Target
TXN0000012715,2024-04-16T20:49:06,ACC00008327,Transfer,1032.05,-593249.09,EUR,Shell
TXN0000012716,2024-12-10T21:47:47,ACC00009056,Transfer,1598.08,-591651.01,GBP,Grocery
TXN0000012717,2024-02-28T10:37:31,ACC00004722,Credit,1894.0,-589757.01,EUR,Target
TXN0000012718,2024-07-15T00:18:45,ACC00008460,ATM,314.73,-590071.74,JPY,Walmart
TXN0000012719,2024-09-23T16:17:59,ACC00000340,Debit,186.18,-590257.92,GBP,Online Store
TXN0000012720,2024-08-02T11:59:53,ACC00003431,Payment,855.88,-591113.8,GBP,Shell
TXN0000012721,2024-05-01T20:20:32,ACC00007299,Payment,325.99,-591439.79,USD,Walmart
TXN0000012722,2024-11-01T13:29:17,ACC00006080,ATM,1008.7,-592448.49,EUR,Shell
TXN0000012723,2024-05-20T19:11:16,ACC00002867,Debit,1667.17,-594115.66,GBP,Online Store
TXN0000012724,2024-05-30T00:07:12,ACC00000320,Credit,724.94,-593390.72,EUR,Walmart
TXN0000012725,2024-01-12T10:51:09,ACC00003942,Debit,878.45,-594269.17,USD,Starbucks
TXN0000012726,2024-12-21T01:16:54,ACC00002105,Credit,918.7,-593350.47,GBP,Restaurant
TXN0000012727,2024-04-02T20:30:21,ACC00009561,ATM,1287.62,-594638.09,GBP,Starbucks
TXN0000012728,2024-05-25T09:15:07,ACC00001776,Credit,341.35,-594296.74,JPY,Shell
TXN0000012729,2024-02-06T19:20:18,ACC00002589,Transfer,1034.8,-593261.94,EUR,Online Store
TXN0000012730,2024-05-31T17:49:09,ACC00004192,ATM,78.46,-593340.4,EUR,Online Store
TXN0000012731,2024-10-28T06:57:25,ACC00008465,Transfer,1413.7,-591926.7,EUR,Grocery
TXN0000012732,2024-06-22T01:06:08,ACC00002292,Debit,1125.64,-593052.34,USD,Walmart
TXN0000012733,2024-10-12T11:17:46,ACC00005886,Payment,959.47,-594011.81,JPY,Amazon
TXN0000012734,2024-11-29T07:40:37,ACC00008596,Debit,739.7,-594751.51,GBP,Shell
TXN0000012735,2024-08-16T14:05:40,ACC00007317,Debit,1370.97,-596122.48,JPY,Walmart
TXN0000012736,2024-12-17T09:28:18,ACC00002736,Transfer,1423.21,-594699.27,USD,Shell
TXN0000012737,2024-06-06T16:52:55,ACC00003215,Transfer,1892.92,-592806.35,USD,Shell
TXN0000012738,2024-09-03T17:09:56,ACC00005374,ATM,664.8,-593471.15,USD,Starbucks
TXN0000012739,2024-12-30T03:57:22,ACC00009436,Transfer,1737.85,-591733.3,EUR,Shell
TXN0000012740,2024-11-15T15:02:54,ACC00000128,Credit,1340.51,-590392.79,GBP,Target
TXN0000012741,2024-02-02T09:20:15,ACC00001322,Debit,630.69,-591023.48,EUR,Target
TXN0000012742,2024-09-11T08:03:17,ACC00008369,Debit,21.03,-591044.51,GBP,Amazon
TXN0000012743,2024-04-12T12:16:39,ACC00007396,Debit,1870.6,-592915.11,JPY,Online Store
TXN0000012744,2024-08-20T20:22:06,ACC00002327,Transfer,1344.89,-591570.22,USD,Online Store
TXN0000012745,2024-01-25T13:14:28,ACC00001531,ATM,500.99,-592071.21,USD,Shell
TXN0000012746,2024-01-13T19:23:27,ACC00001706,Credit,1360.49,-590710.72,USD,Shell
TXN0000012747,2024-02-05T00:23:43,ACC00003545,Debit,711.49,-591422.21,EUR,Grocery
TXN0000012748,2024-07-21T14:01:33,ACC00008674,Transfer,473.65,-590948.56,GBP,Grocery
TXN0000012749,2024-06-16T22:14:22,ACC00003297,ATM,1516.28,-592464.84,JPY,Grocery
TXN0000012750,2024-09-13T04:21:06,ACC00003609,Credit,1342.62,-591122.22,JPY,Target
TXN0000012751,2024-07-23T20:15:37,ACC00002048,Credit,1955.61,-589166.61,USD,Amazon
TXN0000012752,2024-04-11T08:06:36,ACC00009768,Credit,1083.03,-588083.58,EUR,Starbucks
TXN0000012753,2024-05-26T03:05:29,ACC00000008,Debit,1535.6,-589619.18,JPY,Starbucks
TXN0000012754,2024-02-26T22:02:46,ACC00001779,ATM,1062.5,-590681.68,EUR,Walmart
TXN0000012755,2024-08-23T09:59:00,ACC00001214,Payment,314.45,-590996.13,GBP,Amazon
TXN0000012756,2024-07-08T19:38:44,ACC00002724,Transfer,1117.35,-589878.78,GBP,Starbucks
TXN0000012757,2024-12-17T15:14:47,ACC00007290,Debit,1839.75,-591718.53,JPY,Starbucks
TXN0000012758,2024-10-27T10:36:23,ACC00007161,Debit,1745.56,-593464.09,EUR,Amazon
TXN0000012759,2024-03-15T05:28:50,ACC00006091,Debit,1863.63,-595327.72,USD,Target
TXN0000012760,2024-12-07T19:17:55,ACC00003685,Transfer,11.62,-595316.1,EUR,Online Store
TXN0000012761,2024-08-19T22:30:28,ACC00006722,Payment,1790.3,-597106.4,JPY,Online Store
TXN0000012762,2024-08-14T03:30:56,ACC00009965,Payment,361.37,-597467.77,USD,Starbucks
TXN0000012763,2024-03-15T05:07:34,ACC00009679,Debit,95.34,-597563.11,JPY,Walmart
TXN0000012764,2024-06-04T16:32:48,ACC00007455,ATM,41.81,-597604.92,EUR,Shell
TXN0000012765,2024-11-01T04:25:46,ACC00005323,Payment,149.51,-597754.43,EUR,Restaurant
TXN0000012766,2024-12-08T22:53:51,ACC00008706,Debit,548.01,-598302.44,JPY,Target
TXN0000012767,2024-03-13T01:10:33,ACC00004206,Payment,773.22,-599075.66,USD,Restaurant
TXN0000012768,2024-05-06T23:25:17,ACC00009657,ATM,1767.35,-600843.01,JPY,Shell
TXN0000012769,2024-02-13T15:28:38,ACC00005715,Credit,1871.41,-598971.6,GBP,Walmart
TXN0000012770,2024-11-05T02:32:35,ACC00006525,Payment,130.38,-599101.98,USD,Online Store
TXN0000012771,2024-01-14T13:41:19,ACC00001333,ATM,347.91,-599449.89,GBP,Amazon
TXN0000012772,2024-11-26T20:56:14,ACC00005380,Payment,1129.19,-600579.08,USD,Grocery
TXN0000012773,2024-10-21T20:40:13,ACC00001785,Debit,255.67,-600834.75,GBP,Amazon
TXN0000012774,2024-01-27T11:20:30,ACC00005470,Credit,1749.37,-599085.38,USD,Grocery
TXN0000012775,2024-01-03T04:27:16,ACC00001822,Transfer,1183.14,-597902.24,GBP,Target
TXN0000012776,2024-12-09T05:23:43,ACC00001871,Payment,1115.49,-599017.73,GBP,Online Store
TXN0000012777,2024-02-28T17:29:13,ACC00003347,Credit,1716.03,-597301.7,EUR,Online Store
TXN0000012778,2024-08-30T07:31:42,ACC00001619,Debit,1346.98,-598648.68,JPY,Restaurant
TXN0000012779,2024-06-20T22:56:08,ACC00005890,Payment,1062.99,-599711.67,GBP,Grocery
TXN0000012780,2024-07-29T14:07:24,ACC00006250,Debit,1908.13,-601619.8,USD,Shell
TXN0000012781,2024-08-17T05:29:19,ACC00000702,ATM,1552.93,-603172.73,JPY,Grocery
TXN0000012782,2024-12-05T16:38:46,ACC00005404,Debit,1513.67,-604686.4,USD,Walmart
TXN0000012783,2024-01-20T18:44:00,ACC00005894,Payment,258.1,-604944.5,EUR,Target
TXN0000012784,2024-01-02T23:49:49,ACC00004885,Payment,801.45,-605745.95,JPY,Online Store
TXN0000012785,2024-06-05T05:31:13,ACC00003341,ATM,1174.74,-606920.69,GBP,Walmart
TXN0000012786,2024-06-30T04:26:10,ACC00005375,Transfer,684.86,-606235.83,USD,Grocery
TXN0000012787,2024-04-23T21:33:21,ACC00009496,Credit,381.73,-605854.1,GBP,Restaurant
TXN0000012788,2024-10-15T13:49:28,ACC00001472,Credit,1586.38,-604267.72,EUR,Target
TXN0000012789,2024-07-16T23:46:07,ACC00006362,Credit,1014.25,-603253.47,EUR,Amazon
TXN0000012790,2024-09-08T09:28:01,ACC00008260,ATM,870.83,-604124.3,JPY,Shell
TXN0000012791,2024-10-04T11:45:47,ACC00006389,Transfer,278.65,-603845.65,JPY,Starbucks
TXN0000012792,2024-01-15T22:08:41,ACC00006568,Payment,590.5,-604436.15,EUR,Target
TXN0000012793,2024-07-05T12:53:08,ACC00007907,Payment,415.88,-604852.03,USD,Restaurant
TXN0000012794,2024-09-28T18:55:24,ACC00001376,ATM,419.8,-605271.83,EUR,Starbucks
TXN0000012795,2024-03-19T13:36:25,ACC00009609,Debit,1327.71,-606599.54,EUR,Restaurant
TXN0000012796,2024-08-09T04:26:43,ACC00008359,Transfer,1134.74,-605464.8,JPY,Starbucks
TXN0000012797,2024-06-27T11:41:40,ACC00008789,Credit,525.82,-604938.98,GBP,Amazon
TXN0000012798,2024-01-13T00:26:51,ACC00002108,Payment,1694.37,-606633.35,EUR,Grocery
TXN0000012799,2024-01-09T01:22:43,ACC00007260,Credit,1032.13,-605601.22,JPY,Amazon
TXN0000012800,2024-05-20T09:00:28,ACC00005356,Payment,1125.53,-606726.75,EUR,Online Store
TXN0000012801,2024-05-05T04:19:03,ACC00009719,Debit,1267.11,-607993.86,GBP,Target
TXN0000012802,2024-10-14T07:55:08,ACC00005376,Transfer,825.05,-607168.81,EUR,Target
TXN0000012803,2024-04-16T07:35:30,ACC00002383,Debit,1520.83,-608689.64,USD,Grocery
TXN0000012804,2024-09-26T08:40:14,ACC00000871,Debit,1194.83,-609884.47,USD,Grocery
TXN0000012805,2024-12-18T08:49:01,ACC00009179,Transfer,1421.01,-608463.46,USD,Target
TXN0000012806,2024-05-03T05:30:17,ACC00002618,Transfer,1146.27,-607317.19,JPY,Restaurant
TXN0000012807,2024-08-02T10:04:48,ACC00007647,Payment,578.26,-607895.45,GBP,Restaurant
TXN0000012808,2024-10-30T01:22:50,ACC00006520,ATM,180.94,-608076.39,GBP,Grocery
TXN0000012809,2024-10-17T12:04:46,ACC00000767,Credit,804.08,-607272.31,EUR,Target
TXN0000012810,2024-03-07T17:30:01,ACC00007927,ATM,1493.96,-608766.27,USD,Starbucks
TXN0000012811,2024-05-08T06:51:04,ACC00005735,Credit,1948.06,-606818.21,GBP,Restaurant
TXN0000012812,2024-06-12T21:41:00,ACC00004071,Transfer,439.39,-606378.82,USD,Restaurant
TXN0000012813,2024-09-02T09:01:10,ACC00005304,Debit,350.28,-606729.1,USD,Walmart
TXN0000012814,2024-08-04T20:11:40,ACC00003093,ATM,595.39,-607324.49,EUR,Amazon
TXN0000012815,2024-09-22T14:51:12,ACC00003060,Credit,743.04,-606581.45,EUR,Grocery
TXN0000012816,2024-06-06T14:37:06,ACC00001519,Debit,302.92,-606884.37,EUR,Restaurant
TXN0000012817,2024-08-23T23:14:34,ACC00008882,Transfer,484.97,-606399.4,EUR,Target
TXN0000012818,2024-05-13T09:24:10,ACC00002097,Payment,50.96,-606450.36,EUR,Walmart
TXN0000012819,2024-05-25T06:14:02,ACC00008425,Payment,1272.44,-607722.8,EUR,Target
TXN0000012820,2024-01-02T11:18:45,ACC00009360,Payment,1212.84,-608935.64,GBP,Shell
TXN0000012821,2024-05-26T17:55:30,ACC00000564,Debit,895.73,-609831.37,EUR,Restaurant
TXN0000012822,2024-02-14T12:48:01,ACC00002873,Credit,1726.16,-608105.21,EUR,Grocery
TXN0000012823,2024-11-27T19:38:38,ACC00003910,Payment,951.1,-609056.31,EUR,Shell
TXN0000012824,2024-06-29T09:08:07,ACC00004912,ATM,914.45,-609970.76,JPY,Online Store
TXN0000012825,2024-08-20T02:19:33,ACC00005508,Transfer,928.97,-609041.79,GBP,Target
TXN0000012826,2024-04-12T23:22:08,ACC00005878,ATM,1293.52,-610335.31,USD,Amazon
TXN0000012827,2024-12-07T06:26:24,ACC00002437,Debit,240.66,-610575.97,JPY,Target
TXN0000012828,2024-07-13T07:36:57,ACC00003014,Credit,842.6,-609733.37,USD,Amazon
TXN0000012829,2024-08-12T03:31:42,ACC00003817,ATM,538.52,-610271.89,EUR,Amazon
TXN0000012830,2024-08-20T07:35:18,ACC00008191,Payment,267.13,-610539.02,JPY,Target
TXN0000012831,2024-02-09T10:32:01,ACC00005083,ATM,1787.77,-612326.79,JPY,Starbucks
TXN0000012832,2024-01-04T00:03:37,ACC00008235,Credit,170.68,-612156.11,USD,Grocery
TXN0000012833,2024-05-13T23:59:08,ACC00003322,Payment,408.26,-612564.37,GBP,Walmart
TXN0000012834,2024-08-06T13:17:32,ACC00004316,Transfer,73.8,-612490.57,USD,Restaurant
TXN0000012835,2024-11-19T11:59:47,ACC00002969,Transfer,407.91,-612082.66,EUR,Walmart
TXN0000012836,2024-11-14T16:46:18,ACC00003862,Transfer,879.45,-611203.21,EUR,Walmart
TXN0000012837,2024-04-12T00:46:16,ACC00006796,Credit,1837.57,-609365.64,JPY,Restaurant
TXN0000012838,2024-04-24T03:02:02,ACC00001889,Payment,724.8,-610090.44,GBP,Restaurant
TXN0000012839,2024-05-31T00:28:47,ACC00008100,Transfer,1809.18,-608281.26,JPY,Starbucks
TXN0000012840,2024-05-31T18:48:40,ACC00003854,Payment,1609.26,-609890.52,JPY,Walmart
TXN0000012841,2024-01-01T04:59:03,ACC00002757,Credit,1678.38,-608212.14,EUR,Shell
TXN0000012842,2024-01-04T09:16:36,ACC00009029,Debit,1439.75,-609651.89,EUR,Starbucks
TXN0000012843,2024-01-06T18:44:00,ACC00003889,Transfer,1991.08,-607660.81,EUR,Amazon
TXN0000012844,2024-08-13T04:20:49,ACC00007409,Credit,1167.37,-606493.44,EUR,Online Store
TXN0000012845,2024-01-22T19:42:13,ACC00006511,Payment,1318.58,-607812.02,EUR,Starbucks
TXN0000012846,2024-01-22T20:52:38,ACC00002042,ATM,1631.21,-609443.23,GBP,Restaurant
TXN0000012847,2024-07-31T09:57:04,ACC00006062,Debit,1531.4,-610974.63,JPY,Starbucks
TXN0000012848,2024-03-01T08:39:18,ACC00006540,ATM,1368.64,-612343.27,JPY,Online Store
TXN0000012849,2024-10-14T16:26:21,ACC00005441,Transfer,1291.47,-611051.8,USD,Grocery
TXN0000012850,2024-04-06T23:03:20,ACC00000806,Credit,1126.41,-609925.39,JPY,Starbucks
TXN0000012851,2024-07-15T22:57:38,ACC00009365,ATM,1657.87,-611583.26,EUR,Grocery
TXN0000012852,2024-12-07T05:05:38,ACC00009257,Transfer,489.9,-611093.36,GBP,Online Store
TXN0000012853,2024-11-18T19:40:04,ACC00000881,Debit,777.02,-611870.38,GBP,Walmart
TXN0000012854,2024-01-02T11:59:34,ACC00009724,Credit,1810.92,-610059.46,JPY,Walmart
TXN0000012855,2024-11-05T20:18:40,ACC00009606,Payment,104.03,-610163.49,JPY,Grocery
TXN0000012856,2024-10-19T04:12:02,ACC00005449,Payment,1750.62,-611914.11,EUR,Grocery
TXN0000012857,2024-02-11T01:33:26,ACC00006491,Payment,1109.58,-613023.69,JPY,Grocery
TXN0000012858,2024-08-26T08:20:35,ACC00002406,Transfer,594.66,-612429.03,USD,Restaurant
TXN0000012859,2024-01-16T20:41:32,ACC00004811,Payment,278.85,-612707.88,USD,Amazon
TXN0000012860,2024-07-21T02:10:14,ACC00004294,Credit,396.51,-612311.37,JPY,Grocery
TXN0000012861,2024-10-18T23:28:57,ACC00001499,Payment,1340.07,-613651.44,JPY,Amazon
TXN0000012862,2024-06-25T06:12:26,ACC00000476,Transfer,50.26,-613601.18,USD,Target
TXN0000012863,2024-04-18T11:45:35,ACC00005444,Debit,1198.57,-614799.75,USD,Shell
TXN0000012864,2024-08-13T16:16:35,ACC00001971,Transfer,1704.98,-613094.77,GBP,Restaurant
TXN0000012865,2024-04-04T15:40:49,ACC00008010,ATM,377.51,-613472.28,JPY,Target
TXN0000012866,2024-12-08T23:29:38,ACC00003078,Credit,72.98,-613399.3,GBP,Walmart
TXN0000012867,2024-11-15T10:57:04,ACC00002548,Credit,1979.61,-611419.69,GBP,Online Store
TXN0000012868,2024-10-22T10:58:04,ACC00002086,Credit,724.81,-610694.88,EUR,Online Store
TXN0000012869,2024-12-29T15:06:45,ACC00006220,ATM,1858.58,-612553.46,USD,Target
TXN0000012870,2024-01-16T23:37:06,ACC00003728,Debit,388.23,-612941.69,JPY,Shell
TXN0000012871,2024-06-29T17:57:17,ACC00005689,Credit,1381.86,-611559.83,EUR,Target
TXN0000012872,2024-04-01T11:47:02,ACC00006549,Payment,781.46,-612341.29,EUR,Shell
TXN0000012873,2024-02-20T23:41:39,ACC00007824,ATM,1813.65,-614154.94,JPY,Walmart
TXN0000012874,2024-12-26T22:51:07,ACC00000354,Transfer,1949.15,-612205.79,GBP,Starbucks
TXN0000012875,2024-06-16T07:33:31,ACC00008357,Payment,1138.86,-613344.65,JPY,Online Store
TXN0000012876,2024-11-12T20:21:24,ACC00001120,Transfer,1549.86,-611794.79,USD,Online Store
TXN0000012877,2024-09-08T06:17:48,ACC00001628,Credit,1972.95,-609821.84,GBP,Shell
TXN0000012878,2024-10-02T11:24:51,ACC00001287,Credit,138.98,-609682.86,JPY,Shell
TXN0000012879,2024-01-06T21:57:44,ACC00000509,ATM,1909.67,-611592.53,GBP,Restaurant
TXN0000012880,2024-10-04T05:23:08,ACC00004756,Transfer,1023.71,-610568.82,JPY,Online Store
TXN0000012881,2024-10-27T04:06:11,ACC00008138,Transfer,252.37,-610316.45,JPY,Target
TXN0000012882,2024-02-02T16:14:04,ACC00001060,Payment,1668.29,-611984.74,JPY,Target
TXN0000012883,2024-05-22T14:50:22,ACC00002143,ATM,697.36,-612682.1,USD,Grocery
TXN0000012884,2024-08-14T16:18:33,ACC00002187,Payment,887.07,-613569.17,USD,Amazon
TXN0000012885,2024-10-14T13:48:25,ACC00000310,Transfer,1907.59,-611661.58,JPY,Walmart
TXN0000012886,2024-05-01T21:49:47,ACC00002885,Debit,51.82,-611713.4,USD,Grocery
TXN0000012887,2024-07-23T05:31:09,ACC00003152,Debit,567.31,-612280.71,JPY,Starbucks
TXN0000012888,2024-02-16T07:22:32,ACC00008837,Debit,1023.32,-613304.03,JPY,Walmart
TXN0000012889,2024-10-30T02:24:31,ACC00006784,Debit,973.49,-614277.52,EUR,Shell
TXN0000012890,2024-08-25T23:40:41,ACC00003038,Credit,71.44,-614206.08,EUR,Online Store
TXN0000012891,2024-10-25T17:11:02,ACC00001192,Credit,1163.71,-613042.37,USD,Amazon
TXN0000012892,2024-06-11T08:47:13,ACC00001218,ATM,1056.65,-614099.02,EUR,Starbucks
TXN0000012893,2024-08-05T21:42:17,ACC00001950,Transfer,1895.42,-612203.6,EUR,Starbucks
TXN0000012894,2024-06-06T11:27:27,ACC00002203,Credit,615.09,-611588.51,JPY,Shell
TXN0000012895,2024-10-18T12:31:37,ACC00005342,Credit,534.16,-611054.35,JPY,Grocery
TXN0000012896,2024-07-09T01:28:49,ACC00004285,Transfer,1473.12,-609581.23,JPY,Restaurant
TXN0000012897,2024-11-04T19:23:52,ACC00003994,Transfer,412.79,-609168.44,GBP,Starbucks
TXN0000012898,2024-09-28T23:32:59,ACC00000978,Transfer,649.82,-608518.62,JPY,Starbucks
TXN0000012899,2024-11-21T09:28:28,ACC00007556,ATM,449.16,-608967.78,EUR,Restaurant
TXN0000012900,2024-03-24T06:44:11,ACC00005710,Credit,1905.88,-607061.9,USD,Target
TXN0000012901,2024-01-09T22:14:17,ACC00008616,Debit,749.04,-607810.94,USD,Starbucks
TXN0000012902,2024-12-27T04:24:55,ACC00000995,Debit,589.51,-608400.45,GBP,Restaurant
TXN0000012903,2024-03-01T18:40:59,ACC00008612,ATM,483.06,-608883.51,JPY,Shell
TXN0000012904,2024-11-11T16:12:54,ACC00001604,Credit,869.09,-608014.42,EUR,Starbucks
TXN0000012905,2024-05-24T11:02:11,ACC00007473,ATM,151.89,-608166.31,EUR,Online Store
TXN0000012906,2024-01-12T01:35:17,ACC00001122,Credit,29.99,-608136.32,EUR,Restaurant
TXN0000012907,2024-02-07T04:41:40,ACC00008126,Credit,1808.01,-606328.31,GBP,Target
TXN0000012908,2024-10-17T02:52:19,ACC00002543,ATM,675.44,-607003.75,GBP,Shell
TXN0000012909,2024-03-30T10:02:28,ACC00004057,Debit,1890.39,-608894.14,JPY,Target
TXN0000012910,2024-09-06T07:49:33,ACC00005277,ATM,915.51,-609809.65,EUR,Walmart
TXN0000012911,2024-01-04T00:29:07,ACC00007518,Debit,909.83,-610719.48,GBP,Shell
TXN0000012912,2024-07-04T05:54:00,ACC00003705,Payment,546.56,-611266.04,EUR,Target
TXN0000012913,2024-09-30T18:32:58,ACC00003262,ATM,1375.84,-612641.88,JPY,Amazon
TXN0000012914,2024-05-02T12:16:15,ACC00009490,Credit,911.82,-611730.06,GBP,Walmart
TXN0000012915,2024-07-22T18:07:24,ACC00003195,Transfer,446.83,-611283.23,EUR,Restaurant
TXN0000012916,2024-03-14T00:26:21,ACC00007836,Credit,1988.82,-609294.41,USD,Walmart
TXN0000012917,2024-05-25T14:15:40,ACC00009730,Credit,416.71,-608877.7,GBP,Shell
TXN0000012918,2024-10-25T19:17:41,ACC00002687,Debit,222.59,-609100.29,EUR,Walmart
TXN0000012919,2024-06-08T15:11:46,ACC00001016,Debit,1302.36,-610402.65,USD,Restaurant
TXN0000012920,2024-07-09T03:27:47,ACC00004202,Transfer,408.79,-609993.86,JPY,Amazon
TXN0000012921,2024-12-14T16:00:07,ACC00008576,ATM,20.99,-610014.85,USD,Grocery
TXN0000012922,2024-12-18T15:44:33,ACC00002798,Credit,1512.33,-608502.52,EUR,Restaurant
TXN0000012923,2024-06-17T16:21:46,ACC00001339,ATM,865.18,-609367.7,JPY,Target
TXN0000012924,2024-01-13T08:03:54,ACC00007400,ATM,530.88,-609898.58,JPY,Target
TXN0000012925,2024-12-12T08:16:03,ACC00008751,Debit,646.04,-610544.62,GBP,Restaurant
TXN0000012926,2024-01-22T08:20:03,ACC00002626,Credit,878.26,-609666.36,EUR,Amazon
TXN0000012927,2024-01-28T12:38:23,ACC00008561,ATM,1734.74,-611401.1,JPY,Amazon
TXN0000012928,2024-01-03T09:43:49,ACC00002361,Debit,1914.52,-613315.62,GBP,Shell
TXN0000012929,2024-03-22T10:25:41,ACC00006693,ATM,1284.74,-614600.36,JPY,Starbucks
TXN0000012930,2024-09-03T09:15:59,ACC00006802,Debit,586.78,-615187.14,USD,Online Store
TXN0000012931,2024-08-27T14:53:02,ACC00002132,Credit,69.66,-615117.48,USD,Amazon
TXN0000012932,2024-07-29T12:24:57,ACC00009852,Payment,1810.26,-616927.74,GBP,Online Store
TXN0000012933,2024-02-03T10:02:32,ACC00007433,Payment,1872.87,-618800.61,GBP,Amazon
TXN0000012934,2024-04-16T15:51:25,ACC00005394,Transfer,275.6,-618525.01,GBP,Walmart
TXN0000012935,2024-08-26T22:54:46,ACC00000253,ATM,345.98,-618870.99,GBP,Target
TXN0000012936,2024-06-04T11:18:18,ACC00009969,Credit,308.23,-618562.76,JPY,Shell
TXN0000012937,2024-04-02T03:44:52,ACC00000525,Transfer,1606.19,-616956.57,GBP,Shell
TXN0000012938,2024-11-20T21:01:02,ACC00000291,Debit,963.94,-617920.51,USD,Grocery
TXN0000012939,2024-06-03T06:31:19,ACC00003852,Credit,618.4,-617302.11,EUR,Starbucks
TXN0000012940,2024-12-05T00:48:08,ACC00000660,Payment,1608.82,-618910.93,GBP,Starbucks
TXN0000012941,2024-05-29T20:00:30,ACC00005375,Credit,415.99,-618494.94,JPY,Restaurant
TXN0000012942,2024-08-23T09:47:44,ACC00003827,ATM,773.86,-619268.8,USD,Restaurant
TXN0000012943,2024-04-11T21:15:13,ACC00008647,ATM,203.83,-619472.63,EUR,Starbucks
TXN0000012944,2024-09-06T15:20:37,ACC00009620,ATM,596.13,-620068.76,GBP,Grocery
TXN0000012945,2024-09-03T11:35:07,ACC00002213,Credit,22.69,-620046.07,USD,Amazon
TXN0000012946,2024-04-04T05:49:18,ACC00000571,Payment,1302.74,-621348.81,USD,Starbucks
TXN0000012947,2024-12-19T00:39:37,ACC00006233,Transfer,732.52,-620616.29,JPY,Grocery
TXN0000012948,2024-03-30T06:15:49,ACC00005444,Credit,1434.37,-619181.92,JPY,Grocery
TXN0000012949,2024-11-29T07:47:18,ACC00008474,Debit,520.43,-619702.35,JPY,Online Store
TXN0000012950,2024-12-10T14:45:46,ACC00006548,Transfer,39.16,-619663.19,JPY,Online Store
TXN0000012951,2024-06-01T04:12:18,ACC00008450,Debit,330.46,-619993.65,EUR,Grocery
TXN0000012952,2024-05-14T12:30:10,ACC00003384,ATM,1771.48,-621765.13,EUR,Restaurant
TXN0000012953,2024-10-19T08:39:43,ACC00007261,Credit,1727.51,-620037.62,JPY,Grocery
TXN0000012954,2024-01-14T03:07:09,ACC00005335,Payment,601.64,-620639.26,EUR,Target
TXN0000012955,2024-02-07T23:58:12,ACC00008074,Payment,1218.75,-621858.01,GBP,Amazon
TXN0000012956,2024-09-24T06:08:20,ACC00003393,Transfer,1017.64,-620840.37,GBP,Restaurant
TXN0000012957,2024-05-17T23:56:38,ACC00003624,Credit,1047.25,-619793.12,GBP,Amazon
TXN0000012958,2024-01-26T08:48:22,ACC00009322,Payment,1952.38,-621745.5,EUR,Starbucks
TXN0000012959,2024-03-16T12:21:26,ACC00004176,Transfer,1044.27,-620701.23,GBP,Starbucks
TXN0000012960,2024-01-29T23:10:36,ACC00009802,Credit,317.15,-620384.08,JPY,Online Store
TXN0000012961,2024-01-22T12:30:19,ACC00002225,Transfer,1149.11,-619234.97,GBP,Starbucks
TXN0000012962,2024-01-27T23:14:31,ACC00007006,Debit,1797.81,-621032.78,GBP,Restaurant
TXN0000012963,2024-07-11T06:12:58,ACC00008414,Transfer,1686.93,-619345.85,USD,Starbucks
TXN0000012964,2024-11-30T19:38:17,ACC00006050,Payment,1047.48,-620393.33,JPY,Walmart
TXN0000012965,2024-02-18T02:29:01,ACC00007385,Debit,1139.37,-621532.7,GBP,Shell
TXN0000012966,2024-06-28T02:06:06,ACC00006832,Transfer,640.97,-620891.73,USD,Walmart
TXN0000012967,2024-12-17T02:50:37,ACC00001152,Debit,750.95,-621642.68,USD,Amazon
TXN0000012968,2024-09-07T23:48:05,ACC00000065,Transfer,410.76,-621231.92,GBP,Starbucks
TXN0000012969,2024-07-07T13:23:07,ACC00007061,ATM,1252.84,-622484.76,EUR,Amazon
TXN0000012970,2024-08-10T07:58:31,ACC00009336,Debit,1643.96,-624128.72,USD,Walmart
TXN0000012971,2024-06-16T22:22:15,ACC00005399,Payment,151.55,-624280.27,EUR,Online Store
TXN0000012972,2024-09-09T00:35:13,ACC00008325,ATM,185.29,-624465.56,USD,Restaurant
TXN0000012973,2024-07-22T07:27:09,ACC00000213,Payment,701.93,-625167.49,JPY,Grocery
TXN0000012974,2024-08-26T22:20:09,ACC00000462,Debit,1438.38,-626605.87,EUR,Grocery
TXN0000012975,2024-12-23T15:10:50,ACC00007048,Payment,38.51,-626644.38,GBP,Restaurant
TXN0000012976,2024-07-19T22:08:57,ACC00000898,Credit,752.31,-625892.07,EUR,Walmart
TXN0000012977,2024-09-22T08:47:13,ACC00007459,Transfer,1559.88,-624332.19,EUR,Target
TXN0000012978,2024-03-27T02:44:35,ACC00000101,Debit,424.91,-624757.1,GBP,Target
TXN0000012979,2024-04-16T23:54:32,ACC00006410,ATM,1883.14,-626640.24,JPY,Amazon
TXN0000012980,2024-12-20T13:57:21,ACC00002067,ATM,680.93,-627321.17,GBP,Grocery
TXN0000012981,2024-04-02T12:21:07,ACC00006204,Payment,1187.58,-628508.75,USD,Target
TXN0000012982,2024-04-09T14:24:25,ACC00003326,Transfer,1254.77,-627253.98,EUR,Online Store
TXN0000012983,2024-04-21T23:51:17,ACC00005963,Transfer,1456.08,-625797.9,USD,Starbucks
TXN0000012984,2024-01-26T08:53:02,ACC00008230,Transfer,1930.41,-623867.49,USD,Target
TXN0000012985,2024-08-21T23:21:51,ACC00007068,ATM,41.97,-623909.46,EUR,Grocery
TXN0000012986,2024-02-18T14:09:00,ACC00004338,Credit,1469.67,-622439.79,JPY,Target
TXN0000012987,2024-08-09T20:41:17,ACC00001157,Payment,942.89,-623382.68,JPY,Starbucks
TXN0000012988,2024-06-20T16:06:09,ACC00006268,Payment,120.21,-623502.89,USD,Online Store
TXN0000012989,2024-05-17T11:43:59,ACC00008499,Debit,408.32,-623911.21,USD,Grocery
TXN0000012990,2024-05-28T12:38:52,ACC00003961,Credit,190.78,-623720.43,JPY,Restaurant
TXN0000012991,2024-11-10T13:56:15,ACC00005436,ATM,569.33,-624289.76,EUR,Starbucks
TXN0000012992,2024-06-05T23:57:48,ACC00007223,Credit,1354.64,-622935.12,GBP,Online Store
TXN0000012993,2024-11-27T08:03:41,ACC00009406,Credit,536.1,-622399.02,GBP,Amazon
TXN0000012994,2024-12-17T20:40:57,ACC00008348,Debit,1015.99,-623415.01,USD,Online Store
TXN0000012995,2024-06-16T16:18:25,ACC00001863,Credit,1630.08,-621784.93,GBP,Amazon
TXN0000012996,2024-01-02T06:43:47,ACC00008003,Transfer,1288.89,-620496.04,GBP,Amazon
TXN0000012997,2024-11-28T16:36:39,ACC00007697,Payment,1535.93,-622031.97,JPY,Amazon
TXN0000012998,2024-12-23T07:23:58,ACC00006644,ATM,1553.72,-623585.69,USD,Restaurant
TXN0000012999,2024-12-13T13:18:37,ACC00002249,Payment,1944.62,-625530.31,USD,Online Store
TXN0000013000,2024-10-14T15:29:07,ACC00007052,Payment,1437.28,-626967.59,USD,Online Store
TXN0000013001,2024-10-25T20:37:10,ACC00006645,ATM,1732.1,-628699.69,USD,Starbucks
TXN0000013002,2024-06-26T15:44:01,ACC00002829,ATM,271.1,-628970.79,JPY,Amazon
TXN0000013003,2024-07-02T00:41:58,ACC00004408,Debit,1000.89,-629971.68,GBP,Starbucks
TXN0000013004,2024-04-03T18:11:41,ACC00007313,Credit,300.17,-629671.51,EUR,Amazon
TXN0000013005,2024-11-15T12:18:14,ACC00003517,Debit,266.6,-629938.11,GBP,Amazon
TXN0000013006,2024-07-18T18:42:46,ACC00007145,Payment,457.18,-630395.29,JPY,Online Store
TXN0000013007,2024-07-27T09:07:09,ACC00008837,Payment,61.98,-630457.27,GBP,Online Store
TXN0000013008,2024-10-08T06:24:16,ACC00006860,Transfer,1146.47,-629310.8,USD,Target
TXN0000013009,2024-01-07T06:57:13,ACC00005534,Payment,149.7,-629460.5,EUR,Grocery
TXN0000013010,2024-05-29T02:01:25,ACC00008553,Credit,58.09,-629402.41,USD,Target
TXN0000013011,2024-01-19T05:37:41,ACC00002221,Credit,1761.45,-627640.96,JPY,Walmart
TXN0000013012,2024-01-16T23:03:54,ACC00007644,Debit,168.5,-627809.46,EUR,Starbucks
TXN0000013013,2024-04-10T01:53:41,ACC00003631,Transfer,73.09,-627736.37,GBP,Walmart
TXN0000013014,2024-07-06T07:49:52,ACC00008233,Transfer,1738.17,-625998.2,USD,Grocery
TXN0000013015,2024-01-13T05:43:35,ACC00001932,Credit,1235.35,-624762.85,GBP,Amazon
TXN0000013016,2024-09-24T03:14:07,ACC00003895,ATM,1999.58,-626762.43,JPY,Amazon
TXN0000013017,2024-04-08T13:23:02,ACC00003370,Payment,1367.99,-628130.42,EUR,Walmart
TXN0000013018,2024-06-07T00:55:21,ACC00001853,Transfer,330.74,-627799.68,EUR,Amazon
TXN0000013019,2024-06-29T13:46:40,ACC00009137,ATM,898.41,-628698.09,USD,Grocery
TXN0000013020,2024-06-09T21:50:08,ACC00008539,Credit,1674.27,-627023.82,JPY,Grocery
TXN0000013021,2024-03-04T23:36:17,ACC00008569,Debit,1754.39,-628778.21,GBP,Online Store
TXN0000013022,2024-07-09T13:19:53,ACC00004320,Debit,1869.54,-630647.75,USD,Starbucks
TXN0000013023,2024-11-26T05:17:09,ACC00003252,ATM,1203.05,-631850.8,JPY,Starbucks
TXN0000013024,2024-07-04T17:06:28,ACC00009774,Debit,129.71,-631980.51,JPY,Online Store
TXN0000013025,2024-06-30T08:17:30,ACC00006647,Debit,711.36,-632691.87,EUR,Starbucks
TXN0000013026,2024-02-01T14:01:36,ACC00000267,Transfer,82.95,-632608.92,EUR,Online Store
TXN0000013027,2024-11-01T22:55:48,ACC00007551,Debit,460.31,-633069.23,JPY,Amazon
TXN0000013028,2024-10-23T06:30:13,ACC00001817,Debit,1624.26,-634693.49,EUR,Shell
TXN0000013029,2024-06-23T09:06:41,ACC00007125,Debit,266.35,-634959.84,USD,Walmart
TXN0000013030,2024-03-21T06:42:19,ACC00006505,Transfer,1961.08,-632998.76,GBP,Walmart
TXN0000013031,2024-01-16T20:31:09,ACC00001386,ATM,137.59,-633136.35,EUR,Shell
TXN0000013032,2024-07-30T03:42:42,ACC00004274,ATM,1567.9,-634704.25,GBP,Starbucks
TXN0000013033,2024-11-06T20:09:58,ACC00002754,Debit,1874.24,-636578.49,GBP,Target
TXN0000013034,2024-07-01T22:59:43,ACC00005565,Credit,790.67,-635787.82,EUR,Shell
TXN0000013035,2024-11-23T00:27:31,ACC00004248,Credit,1680.52,-634107.3,USD,Shell
TXN0000013036,2024-12-03T19:51:21,ACC00007542,Debit,52.71,-634160.01,EUR,Restaurant
TXN0000013037,2024-10-30T20:47:15,ACC00003921,Debit,331.08,-634491.09,USD,Amazon
TXN0000013038,2024-08-21T15:39:49,ACC00007432,Payment,1737.05,-636228.14,JPY,Starbucks
TXN0000013039,2024-09-10T23:35:00,ACC00006517,Debit,1857.47,-638085.61,EUR,Target
TXN0000013040,2024-11-15T18:48:40,ACC00006063,Payment,1359.01,-639444.62,JPY,Online Store
TXN0000013041,2024-01-25T12:29:32,ACC00000941,Transfer,1940.85,-637503.77,EUR,Amazon
TXN0000013042,2024-08-01T16:58:03,ACC00000434,Credit,1810.84,-635692.93,JPY,Starbucks
TXN0000013043,2024-12-14T11:26:34,ACC00008278,Payment,724.73,-636417.66,USD,Walmart
TXN0000013044,2024-04-20T12:38:28,ACC00000986,Transfer,1451.95,-634965.71,GBP,Walmart
TXN0000013045,2024-01-26T18:35:46,ACC00004995,Transfer,225.86,-634739.85,EUR,Restaurant
TXN0000013046,2024-01-28T14:56:16,ACC00003265,Debit,415.92,-635155.77,USD,Amazon
TXN0000013047,2024-03-19T03:01:12,ACC00000878,Payment,332.97,-635488.74,USD,Grocery
TXN0000013048,2024-09-02T11:21:59,ACC00006113,ATM,161.35,-635650.09,JPY,Amazon
TXN0000013049,2024-12-07T18:39:16,ACC00002439,Debit,507.71,-636157.8,EUR,Target
TXN0000013050,2024-11-20T05:34:07,ACC00006111,Payment,481.03,-636638.83,EUR,Restaurant
TXN0000013051,2024-11-10T06:59:38,ACC00009155,Credit,895.93,-635742.9,JPY,Amazon
TXN0000013052,2024-09-18T03:19:01,ACC00002412,ATM,1569.31,-637312.21,JPY,Grocery
TXN0000013053,2024-09-05T18:19:29,ACC00003147,Debit,424.31,-637736.52,GBP,Grocery
TXN0000013054,2024-09-11T03:26:31,ACC00006112,Payment,419.01,-638155.53,EUR,Grocery
TXN0000013055,2024-05-29T04:38:50,ACC00000888,Transfer,360.37,-637795.16,USD,Shell
TXN0000013056,2024-10-07T03:56:26,ACC00005503,Debit,325.12,-638120.28,USD,Walmart
TXN0000013057,2024-02-07T06:41:48,ACC00004330,Credit,18.41,-638101.87,JPY,Grocery
TXN0000013058,2024-03-29T03:08:42,ACC00002256,Payment,1980.89,-640082.76,JPY,Restaurant
TXN0000013059,2024-10-14T11:35:23,ACC00004661,Debit,1090.98,-641173.74,JPY,Grocery
TXN0000013060,2024-05-23T08:37:14,ACC00006263,Debit,1043.61,-642217.35,GBP,Amazon
TXN0000013061,2024-02-29T20:14:36,ACC00001584,ATM,791.51,-643008.86,JPY,Restaurant
TXN0000013062,2024-09-17T05:53:49,ACC00003123,Debit,1427.77,-644436.63,GBP,Shell
TXN0000013063,2024-01-16T19:00:34,ACC00002186,Transfer,1632.13,-642804.5,EUR,Online Store
TXN0000013064,2024-11-08T07:22:44,ACC00006220,Payment,1078.24,-643882.74,EUR,Starbucks
TXN0000013065,2024-02-18T09:43:08,ACC00002882,Transfer,1908.45,-641974.29,GBP,Walmart
TXN0000013066,2024-05-16T12:33:28,ACC00001906,ATM,1680.3,-643654.59,EUR,Shell
TXN0000013067,2024-10-27T09:49:13,ACC00003114,Payment,1328.4,-644982.99,GBP,Target
TXN0000013068,2024-06-18T00:40:37,ACC00001427,Debit,419.09,-645402.08,JPY,Grocery
TXN0000013069,2024-02-10T20:02:12,ACC00001648,Credit,318.1,-645083.98,JPY,Shell
TXN0000013070,2024-08-01T12:03:54,ACC00001010,ATM,664.95,-645748.93,EUR,Target
TXN0000013071,2024-05-27T14:11:17,ACC00002323,Debit,1652.88,-647401.81,JPY,Target
TXN0000013072,2024-01-26T05:47:24,ACC00001933,Credit,1687.12,-645714.69,JPY,Grocery
TXN0000013073,2024-06-25T05:28:28,ACC00002581,Payment,875.01,-646589.7,EUR,Shell
TXN0000013074,2024-01-01T05:14:51,ACC00001035,Transfer,121.29,-646468.41,GBP,Grocery
TXN0000013075,2024-10-15T00:34:31,ACC00002448,Credit,817.61,-645650.8,GBP,Shell
TXN0000013076,2024-07-05T23:46:44,ACC00007085,Credit,992.96,-644657.84,GBP,Walmart
TXN0000013077,2024-06-24T05:18:04,ACC00004227,Payment,1064.06,-645721.9,GBP,Shell
TXN0000013078,2024-06-03T20:59:23,ACC00003377,Debit,487.99,-646209.89,EUR,Online Store
TXN0000013079,2024-03-20T15:36:10,ACC00004407,Transfer,251.6,-645958.29,USD,Grocery
TXN0000013080,2024-04-30T12:15:08,ACC00007487,Payment,261.2,-646219.49,GBP,Amazon
TXN0000013081,2024-11-10T20:45:07,ACC00001305,Payment,467.16,-646686.65,JPY,Target
TXN0000013082,2024-05-29T05:00:52,ACC00003736,Credit,115.04,-646571.61,EUR,Amazon
TXN0000013083,2024-12-20T21:46:59,ACC00005023,Credit,1778.97,-644792.64,USD,Online Store
TXN0000013084,2024-11-01T17:25:01,ACC00002494,Debit,700.34,-645492.98,EUR,Restaurant
TXN0000013085,2024-12-03T11:03:15,ACC00000409,Transfer,895.09,-644597.89,EUR,Restaurant
TXN0000013086,2024-11-27T03:34:57,ACC00000915,ATM,116.96,-644714.85,USD,Online Store
TXN0000013087,2024-03-26T04:37:36,ACC00004572,Credit,33.72,-644681.13,GBP,Walmart
TXN0000013088,2024-09-23T05:06:57,ACC00006257,Credit,1360.3,-643320.83,GBP,Amazon
TXN0000013089,2024-04-10T18:04:45,ACC00002890,Credit,249.81,-643071.02,GBP,Walmart
TXN0000013090,2024-03-24T16:20:45,ACC00008209,Payment,801.41,-643872.43,EUR,Target
TXN0000013091,2024-10-21T11:06:53,ACC00004734,Credit,1442.22,-642430.21,GBP,Amazon
TXN0000013092,2024-04-22T04:21:38,ACC00008877,Debit,240.41,-642670.62,EUR,Online Store
TXN0000013093,2024-03-07T17:47:08,ACC00008244,Transfer,1684.1,-640986.52,JPY,Shell
TXN0000013094,2024-01-16T16:00:24,ACC00006860,Payment,634.27,-641620.79,JPY,Shell
TXN0000013095,2024-11-14T08:05:20,ACC00009591,ATM,738.86,-642359.65,USD,Grocery
TXN0000013096,2024-10-17T14:06:13,ACC00005196,ATM,527.38,-642887.03,JPY,Target
TXN0000013097,2024-08-16T23:49:44,ACC00009701,Debit,1375.85,-644262.88,GBP,Starbucks
TXN0000013098,2024-05-29T00:46:11,ACC00000383,ATM,1993.04,-646255.92,USD,Target
TXN0000013099,2024-07-16T16:22:04,ACC00000693,Debit,1887.0,-648142.92,USD,Online Store
TXN0000013100,2024-07-16T03:07:49,ACC00006735,Transfer,1470.5,-646672.42,JPY,Starbucks
TXN0000013101,2024-02-19T00:47:19,ACC00004965,Credit,723.93,-645948.49,USD,Amazon
TXN0000013102,2024-05-06T18:41:38,ACC00007546,ATM,1105.4,-647053.89,JPY,Amazon
TXN0000013103,2024-05-20T21:58:10,ACC00009525,Transfer,1116.4,-645937.49,GBP,Restaurant
TXN0000013104,2024-11-19T23:23:47,ACC00006749,Payment,520.73,-646458.22,USD,Online Store
TXN0000013105,2024-01-20T17:37:41,ACC00009527,Transfer,1091.34,-645366.88,EUR,Restaurant
TXN0000013106,2024-01-12T13:10:06,ACC00002327,Transfer,55.92,-645310.96,JPY,Amazon
TXN0000013107,2024-11-15T13:43:32,ACC00002523,Debit,1143.95,-646454.91,EUR,Starbucks
TXN0000013108,2024-06-01T09:13:38,ACC00000640,Credit,1464.28,-644990.63,USD,Amazon
TXN0000013109,2024-02-26T03:12:43,ACC00003339,Credit,984.2,-644006.43,EUR,Online Store
TXN0000013110,2024-11-21T22:04:56,ACC00001186,Debit,1098.8,-645105.23,EUR,Walmart
TXN0000013111,2024-03-06T09:17:56,ACC00000117,Transfer,733.49,-644371.74,USD,Grocery
TXN0000013112,2024-07-23T00:52:36,ACC00002310,Transfer,293.98,-644077.76,JPY,Grocery
TXN0000013113,2024-06-25T09:41:08,ACC00002756,Credit,1759.23,-642318.53,USD,Online Store
TXN0000013114,2024-05-01T23:53:17,ACC00002624,Credit,783.86,-641534.67,USD,Starbucks
TXN0000013115,2024-10-08T23:35:09,ACC00004627,Credit,1687.01,-639847.66,GBP,Online Store
TXN0000013116,2024-09-10T08:34:02,ACC00004384,Payment,794.87,-640642.53,EUR,Shell
TXN0000013117,2024-01-24T16:04:14,ACC00001311,ATM,243.94,-640886.47,JPY,Walmart
TXN0000013118,2024-09-04T00:01:28,ACC00008803,Transfer,742.87,-640143.6,JPY,Grocery
TXN0000013119,2024-11-01T23:09:08,ACC00003489,ATM,603.98,-640747.58,JPY,Shell
TXN0000013120,2024-04-11T13:38:14,ACC00005577,Credit,1661.06,-639086.52,USD,Starbucks
TXN0000013121,2024-04-04T07:19:03,ACC00007455,Credit,175.28,-638911.24,USD,Target
TXN0000013122,2024-05-12T19:46:57,ACC00002916,Debit,192.68,-639103.92,EUR,Amazon
TXN0000013123,2024-10-22T21:11:42,ACC00005637,Debit,1115.64,-640219.56,JPY,Starbucks
TXN0000013124,2024-08-03T09:32:43,ACC00002232,Transfer,638.54,-639581.02,EUR,Walmart
TXN0000013125,2024-07-14T14:05:55,ACC00008051,ATM,203.74,-639784.76,GBP,Amazon
TXN0000013126,2024-04-27T04:21:09,ACC00003393,Payment,511.53,-640296.29,USD,Starbucks
TXN0000013127,2024-05-13T05:01:02,ACC00005584,Transfer,73.94,-640222.35,USD,Grocery
TXN0000013128,2024-08-27T20:08:04,ACC00005306,ATM,1788.0,-642010.35,JPY,Target
TXN0000013129,2024-11-03T12:44:50,ACC00000773,Transfer,881.57,-641128.78,EUR,Amazon
TXN0000013130,2024-09-15T18:34:05,ACC00000889,Credit,205.34,-640923.44,JPY,Starbucks
TXN0000013131,2024-05-07T10:40:24,ACC00004002,Transfer,872.25,-640051.19,GBP,Restaurant
TXN0000013132,2024-03-21T04:57:39,ACC00009589,Transfer,1011.58,-639039.61,GBP,Amazon
TXN0000013133,2024-01-19T09:43:02,ACC00008216,Transfer,505.43,-638534.18,EUR,Shell
TXN0000013134,2024-07-31T13:09:13,ACC00000719,Payment,1351.55,-639885.73,USD,Grocery
TXN0000013135,2024-10-29T15:40:08,ACC00008678,ATM,1924.97,-641810.7,GBP,Target
TXN0000013136,2024-09-24T21:26:10,ACC00009855,ATM,652.94,-642463.64,GBP,Grocery
TXN0000013137,2024-04-26T05:54:31,ACC00004634,Transfer,569.83,-641893.81,JPY,Walmart
TXN0000013138,2024-04-29T04:27:39,ACC00001682,Debit,1615.97,-643509.78,JPY,Restaurant
TXN0000013139,2024-09-18T21:56:22,ACC00007163,Credit,1759.67,-641750.11,JPY,Amazon
TXN0000013140,2024-01-28T15:32:35,ACC00001808,Debit,1331.59,-643081.7,EUR,Shell
TXN0000013141,2024-12-16T02:32:34,ACC00003594,ATM,1231.98,-644313.68,EUR,Target
TXN0000013142,2024-05-09T08:27:11,ACC00005103,ATM,852.44,-645166.12,JPY,Walmart
TXN0000013143,2024-08-04T16:55:40,ACC00005729,Debit,980.14,-646146.26,GBP,Walmart
TXN0000013144,2024-08-02T07:00:18,ACC00003867,ATM,708.55,-646854.81,GBP,Restaurant
TXN0000013145,2024-01-10T14:12:45,ACC00002071,Transfer,494.96,-646359.85,EUR,Walmart
TXN0000013146,2024-04-04T02:20:55,ACC00009236,Transfer,1458.52,-644901.33,JPY,Restaurant
TXN0000013147,2024-08-10T14:07:03,ACC00006652,Debit,1658.93,-646560.26,EUR,Restaurant
TXN0000013148,2024-05-27T06:07:27,ACC00001377,Payment,1805.96,-648366.22,EUR,Shell
TXN0000013149,2024-05-08T06:57:41,ACC00009021,Debit,1987.76,-650353.98,GBP,Amazon
TXN0000013150,2024-04-20T19:56:46,ACC00006765,Payment,38.96,-650392.94,GBP,Restaurant
TXN0000013151,2024-08-11T04:46:45,ACC00008591,Debit,679.49,-651072.43,GBP,Grocery
TXN0000013152,2024-11-01T05:19:07,ACC00008405,ATM,686.35,-651758.78,GBP,Online Store
TXN0000013153,2024-10-18T03:44:47,ACC00005311,Payment,858.27,-652617.05,USD,Grocery
TXN0000013154,2024-02-05T22:50:52,ACC00003670,Transfer,1861.08,-650755.97,GBP,Amazon
TXN0000013155,2024-09-10T06:03:56,ACC00001449,Payment,1304.75,-652060.72,JPY,Shell
TXN0000013156,2024-08-13T06:16:15,ACC00001183,ATM,1452.9,-653513.62,USD,Online Store
TXN0000013157,2024-09-30T09:33:54,ACC00009705,ATM,1606.31,-655119.93,GBP,Grocery
TXN0000013158,2024-08-06T12:10:14,ACC00006580,Debit,1768.73,-656888.66,GBP,Amazon
TXN0000013159,2024-08-16T03:55:46,ACC00002565,Transfer,825.74,-656062.92,GBP,Starbucks
TXN0000013160,2024-06-03T20:44:19,ACC00000331,Credit,1650.89,-654412.03,GBP,Amazon
TXN0000013161,2024-01-31T13:29:32,ACC00005254,Payment,271.21,-654683.24,GBP,Target
TXN0000013162,2024-02-01T08:29:06,ACC00008845,Credit,1121.41,-653561.83,JPY,Online Store
TXN0000013163,2024-07-30T23:30:13,ACC00009795,Payment,641.63,-654203.46,GBP,Amazon
TXN0000013164,2024-08-12T15:33:20,ACC00004228,Debit,1652.11,-655855.57,EUR,Restaurant
TXN0000013165,2024-11-18T09:07:14,ACC00002163,Debit,1926.14,-657781.71,JPY,Starbucks
TXN0000013166,2024-08-29T10:53:03,ACC00002041,Debit,562.91,-658344.62,EUR,Starbucks
TXN0000013167,2024-08-04T13:17:36,ACC00006203,ATM,346.94,-658691.56,JPY,Target
TXN0000013168,2024-11-17T17:03:17,ACC00002861,Transfer,1307.69,-657383.87,EUR,Amazon
TXN0000013169,2024-11-02T16:16:10,ACC00008087,ATM,319.94,-657703.81,EUR,Online Store
TXN0000013170,2024-08-22T07:58:23,ACC00007939,ATM,395.17,-658098.98,USD,Restaurant
TXN0000013171,2024-07-21T08:49:19,ACC00009613,Payment,472.55,-658571.53,EUR,Amazon
TXN0000013172,2024-02-04T16:40:27,ACC00003286,Payment,526.28,-659097.81,USD,Target
TXN0000013173,2024-02-12T00:31:29,ACC00008574,ATM,1317.49,-660415.3,USD,Online Store
TXN0000013174,2024-12-11T09:03:11,ACC00003419,Credit,1641.75,-658773.55,EUR,Starbucks
TXN0000013175,2024-07-03T15:39:31,ACC00007190,Transfer,263.33,-658510.22,JPY,Grocery
TXN0000013176,2024-06-22T08:11:06,ACC00008232,Credit,581.12,-657929.1,GBP,Starbucks
TXN0000013177,2024-01-31T05:44:58,ACC00002226,Transfer,602.58,-657326.52,USD,Grocery
TXN0000013178,2024-05-21T16:55:08,ACC00005457,Payment,1923.43,-659249.95,EUR,Restaurant
TXN0000013179,2024-11-27T07:07:55,ACC00003178,Payment,495.34,-659745.29,GBP,Amazon
TXN0000013180,2024-01-09T16:32:31,ACC00003503,Credit,1168.02,-658577.27,GBP,Restaurant
TXN0000013181,2024-01-21T03:34:47,ACC00004917,Payment,1459.49,-660036.76,EUR,Shell
TXN0000013182,2024-04-24T18:32:06,ACC00008782,Credit,1279.33,-658757.43,EUR,Shell
TXN0000013183,2024-08-03T13:04:19,ACC00002669,ATM,1105.1,-659862.53,USD,Target
TXN0000013184,2024-04-25T23:37:50,ACC00002889,ATM,1183.06,-661045.59,JPY,Shell
TXN0000013185,2024-12-11T05:08:22,ACC00001870,Payment,1806.1,-662851.69,GBP,Shell
TXN0000013186,2024-03-09T07:32:17,ACC00009094,Transfer,123.8,-662727.89,JPY,Restaurant
TXN0000013187,2024-02-01T00:05:41,ACC00008764,Payment,1866.41,-664594.3,JPY,Walmart
TXN0000013188,2024-09-05T20:41:00,ACC00001520,Credit,727.02,-663867.28,EUR,Starbucks
TXN0000013189,2024-07-26T22:25:50,ACC00003574,ATM,1745.9,-665613.18,EUR,Starbucks
TXN0000013190,2024-02-21T07:49:59,ACC00007024,Payment,1252.99,-666866.17,USD,Online Store
TXN0000013191,2024-08-24T04:59:08,ACC00005807,ATM,1836.57,-668702.74,USD,Amazon
TXN0000013192,2024-04-17T05:24:49,ACC00002016,Payment,1006.69,-669709.43,JPY,Online Store
TXN0000013193,2024-09-17T14:35:26,ACC00006447,Credit,1321.71,-668387.72,JPY,Walmart
TXN0000013194,2024-04-19T11:14:56,ACC00005114,Credit,1721.64,-666666.08,JPY,Amazon
TXN0000013195,2024-10-05T06:16:18,ACC00003464,Payment,1958.59,-668624.67,USD,Online Store
TXN0000013196,2024-05-13T23:29:24,ACC00002650,Transfer,1228.31,-667396.36,GBP,Amazon
TXN0000013197,2024-01-15T08:29:26,ACC00006700,Payment,1512.18,-668908.54,GBP,Target
TXN0000013198,2024-04-09T22:14:02,ACC00000258,ATM,1027.88,-669936.42,EUR,Shell
TXN0000013199,2024-06-16T02:07:46,ACC00001078,Debit,558.5,-670494.92,GBP,Grocery
TXN0000013200,2024-05-28T12:44:48,ACC00008355,ATM,1327.58,-671822.5,GBP,Amazon
TXN0000013201,2024-04-27T08:18:32,ACC00005328,ATM,1414.87,-673237.37,JPY,Walmart
TXN0000013202,2024-01-19T08:35:41,ACC00003071,ATM,490.21,-673727.58,JPY,Starbucks
TXN0000013203,2024-05-09T12:33:38,ACC00001250,Credit,1253.44,-672474.14,EUR,Amazon
TXN0000013204,2024-12-22T03:17:23,ACC00002069,Transfer,764.06,-671710.08,JPY,Grocery
TXN0000013205,2024-04-20T08:20:26,ACC00002568,Transfer,1068.28,-670641.8,USD,Target
TXN0000013206,2024-04-14T08:49:39,ACC00002397,ATM,1253.27,-671895.07,GBP,Target
TXN0000013207,2024-09-23T07:38:16,ACC00004661,Debit,1829.44,-673724.51,GBP,Target
TXN0000013208,2024-12-10T00:42:50,ACC00004576,Credit,1986.52,-671737.99,USD,Online Store
TXN0000013209,2024-09-08T06:53:48,ACC00005011,Credit,1055.26,-670682.73,GBP,Shell
TXN0000013210,2024-04-08T10:56:10,ACC00002281,ATM,1440.01,-672122.74,JPY,Starbucks
TXN0000013211,2024-05-01T19:37:02,ACC00007060,Credit,1371.09,-670751.65,JPY,Shell
TXN0000013212,2024-10-13T09:17:22,ACC00003470,Transfer,1592.22,-669159.43,JPY,Grocery
TXN0000013213,2024-07-11T03:19:29,ACC00009698,Credit,653.57,-668505.86,USD,Starbucks
TXN0000013214,2024-10-16T21:24:04,ACC00003198,Debit,1164.44,-669670.3,GBP,Shell
TXN0000013215,2024-12-05T17:56:58,ACC00001280,Credit,1929.68,-667740.62,EUR,Amazon
TXN0000013216,2024-07-18T09:43:29,ACC00006466,Debit,1986.79,-669727.41,EUR,Amazon
TXN0000013217,2024-09-15T20:16:19,ACC00005139,Debit,1418.63,-671146.04,GBP,Target
TXN0000013218,2024-09-15T07:41:01,ACC00004879,Transfer,1365.47,-669780.57,USD,Walmart
TXN0000013219,2024-12-02T16:17:35,ACC00001930,Credit,1560.35,-668220.22,GBP,Starbucks
TXN0000013220,2024-07-10T22:40:32,ACC00005321,ATM,1432.21,-669652.43,GBP,Amazon
TXN0000013221,2024-02-14T15:40:24,ACC00004449,Payment,133.05,-669785.48,USD,Target
TXN0000013222,2024-08-24T12:01:51,ACC00005492,Credit,26.87,-669758.61,JPY,Online Store
TXN0000013223,2024-03-27T11:04:09,ACC00002417,Transfer,1108.96,-668649.65,EUR,Shell
TXN0000013224,2024-08-05T21:06:41,ACC00004785,ATM,627.34,-669276.99,JPY,Online Store
TXN0000013225,2024-05-25T07:09:40,ACC00000409,ATM,1365.02,-670642.01,JPY,Online Store
TXN0000013226,2024-02-04T03:44:00,ACC00008839,Payment,522.43,-671164.44,EUR,Online Store
TXN0000013227,2024-12-27T23:51:30,ACC00003583,Transfer,297.32,-670867.12,EUR,Shell
TXN0000013228,2024-02-09T18:00:17,ACC00002671,Debit,1271.52,-672138.64,EUR,Shell
TXN0000013229,2024-11-07T20:49:35,ACC00009895,Transfer,680.69,-671457.95,EUR,Target
TXN0000013230,2024-04-13T06:32:07,ACC00002072,Transfer,1872.33,-669585.62,USD,Starbucks
TXN0000013231,2024-01-31T11:42:14,ACC00006840,Debit,979.09,-670564.71,GBP,Starbucks
TXN0000013232,2024-11-14T07:55:54,ACC00009357,Transfer,1219.64,-669345.07,USD,Grocery
TXN0000013233,2024-08-11T21:30:52,ACC00004761,ATM,1475.14,-670820.21,USD,Shell
TXN0000013234,2024-02-23T14:17:12,ACC00003746,Debit,670.03,-671490.24,JPY,Grocery
TXN0000013235,2024-03-11T01:20:19,ACC00005397,ATM,1933.38,-673423.62,EUR,Starbucks
TXN0000013236,2024-07-14T12:44:38,ACC00000885,Debit,703.1,-674126.72,JPY,Starbucks
TXN0000013237,2024-02-09T20:25:29,ACC00000473,Payment,1847.12,-675973.84,USD,Target
TXN0000013238,2024-03-27T19:08:01,ACC00008944,Debit,1121.95,-677095.79,EUR,Target
TXN0000013239,2024-11-17T04:27:55,ACC00000051,Debit,1833.7,-678929.49,USD,Starbucks
TXN0000013240,2024-02-09T19:24:00,ACC00008692,Credit,1383.53,-677545.96,GBP,Starbucks
TXN0000013241,2024-03-02T09:16:39,ACC00003627,Payment,310.88,-677856.84,GBP,Shell
TXN0000013242,2024-06-27T11:37:22,ACC00006586,Debit,1452.63,-679309.47,EUR,Walmart
TXN0000013243,2024-06-15T07:45:17,ACC00000511,Debit,1890.2,-681199.67,GBP,Restaurant
TXN0000013244,2024-07-02T21:42:23,ACC00003937,Debit,1784.16,-682983.83,JPY,Starbucks
TXN0000013245,2024-05-24T18:38:00,ACC00009057,ATM,968.12,-683951.95,USD,Walmart
TXN0000013246,2024-11-12T10:56:07,ACC00000683,Debit,1626.4,-685578.35,USD,Target
TXN0000013247,2024-08-22T04:36:19,ACC00006276,ATM,1226.4,-686804.75,JPY,Amazon
TXN0000013248,2024-03-05T15:28:25,ACC00000307,Debit,363.8,-687168.55,JPY,Shell
TXN0000013249,2024-02-10T07:04:16,ACC00006602,Credit,1910.98,-685257.57,EUR,Target
TXN0000013250,2024-08-02T20:52:33,ACC00006315,Credit,1265.16,-683992.41,JPY,Starbucks
TXN0000013251,2024-07-25T14:35:14,ACC00006367,ATM,1149.82,-685142.23,JPY,Amazon
TXN0000013252,2024-07-25T16:15:03,ACC00008537,Credit,1371.04,-683771.19,GBP,Target
TXN0000013253,2024-08-18T17:41:24,ACC00005581,Transfer,1819.26,-681951.93,GBP,Online Store
TXN0000013254,2024-03-10T19:29:51,ACC00000958,Transfer,1379.32,-680572.61,GBP,Amazon
TXN0000013255,2024-05-09T14:27:13,ACC00004596,ATM,1448.74,-682021.35,EUR,Target
TXN0000013256,2024-11-04T12:06:35,ACC00003434,Credit,475.01,-681546.34,JPY,Restaurant
TXN0000013257,2024-05-25T21:19:29,ACC00003925,Debit,1836.86,-683383.2,JPY,Shell
TXN0000013258,2024-02-18T02:58:57,ACC00007699,Credit,1888.86,-681494.34,JPY,Starbucks
TXN0000013259,2024-02-18T20:28:51,ACC00002988,Credit,54.13,-681440.21,USD,Online Store
TXN0000013260,2024-04-30T09:48:46,ACC00003767,ATM,1333.33,-682773.54,USD,Target
TXN0000013261,2024-02-19T06:54:26,ACC00005435,Debit,1121.63,-683895.17,USD,Amazon
TXN0000013262,2024-08-14T15:41:40,ACC00009756,Payment,910.03,-684805.2,GBP,Restaurant
TXN0000013263,2024-02-16T10:36:48,ACC00008470,Debit,475.02,-685280.22,GBP,Grocery
TXN0000013264,2024-03-21T22:02:20,ACC00001148,ATM,812.32,-686092.54,GBP,Starbucks
TXN0000013265,2024-02-24T21:44:17,ACC00005199,Credit,816.23,-685276.31,JPY,Walmart
TXN0000013266,2024-03-31T09:29:34,ACC00009793,Transfer,269.21,-685007.1,GBP,Starbucks
TXN0000013267,2024-11-08T13:13:15,ACC00002241,ATM,48.74,-685055.84,JPY,Amazon
TXN0000013268,2024-06-04T21:28:45,ACC00001790,Debit,772.77,-685828.61,GBP,Walmart
TXN0000013269,2024-08-12T00:06:54,ACC00002266,Transfer,765.61,-685063.0,JPY,Restaurant
TXN0000013270,2024-01-02T06:27:33,ACC00003770,Debit,1194.87,-686257.87,JPY,Amazon
TXN0000013271,2024-09-29T06:46:03,ACC00007628,Payment,922.48,-687180.35,GBP,Target
TXN0000013272,2024-06-22T15:48:22,ACC00001048,ATM,1335.87,-688516.22,EUR,Restaurant
TXN0000013273,2024-05-27T02:46:21,ACC00003004,Transfer,767.84,-687748.38,GBP,Target
TXN0000013274,2024-08-09T03:48:26,ACC00006796,Credit,1708.43,-686039.95,USD,Walmart
TXN0000013275,2024-06-28T03:54:28,ACC00001292,Transfer,178.73,-685861.22,JPY,Restaurant
TXN0000013276,2024-12-06T20:17:15,ACC00004764,Payment,466.44,-686327.66,JPY,Online Store
TXN0000013277,2024-03-29T19:38:45,ACC00004074,Debit,1614.94,-687942.6,USD,Restaurant
TXN0000013278,2024-05-20T15:27:42,ACC00007100,ATM,1290.05,-689232.65,JPY,Amazon
TXN0000013279,2024-10-13T20:36:47,ACC00003060,Payment,978.36,-690211.01,USD,Starbucks
TXN0000013280,2024-09-21T08:04:45,ACC00005907,ATM,863.82,-691074.83,EUR,Online Store
TXN0000013281,2024-03-26T07:39:29,ACC00003136,ATM,1197.8,-692272.63,USD,Amazon
TXN0000013282,2024-07-09T21:06:29,ACC00007415,ATM,1340.28,-693612.91,GBP,Amazon
TXN0000013283,2024-03-17T04:02:25,ACC00006596,Transfer,1955.07,-691657.84,EUR,Starbucks
TXN0000013284,2024-04-13T12:19:41,ACC00007872,Payment,859.09,-692516.93,JPY,Walmart
TXN0000013285,2024-01-21T02:17:03,ACC00003203,Credit,667.24,-691849.69,USD,Shell
TXN0000013286,2024-10-25T02:51:05,ACC00002936,Payment,974.67,-692824.36,EUR,Walmart
TXN0000013287,2024-02-05T08:15:49,ACC00002464,ATM,627.12,-693451.48,EUR,Shell
TXN0000013288,2024-10-24T20:15:12,ACC00000544,Transfer,792.78,-692658.7,EUR,Grocery
TXN0000013289,2024-10-12T05:44:13,ACC00003695,ATM,272.24,-692930.94,USD,Target
TXN0000013290,2024-09-29T19:31:08,ACC00008769,Payment,1061.21,-693992.15,EUR,Grocery
TXN0000013291,2024-07-29T23:24:56,ACC00003815,Payment,169.64,-694161.79,EUR,Starbucks
TXN0000013292,2024-05-11T21:52:36,ACC00001462,Credit,1641.32,-692520.47,EUR,Restaurant
TXN0000013293,2024-07-20T14:22:06,ACC00002584,Payment,259.86,-692780.33,GBP,Starbucks
TXN0000013294,2024-04-30T19:03:11,ACC00001761,Payment,1328.02,-694108.35,GBP,Walmart
TXN0000013295,2024-04-18T10:48:20,ACC00005973,Credit,1768.46,-692339.89,JPY,Online Store
TXN0000013296,2024-04-08T17:22:51,ACC00008319,Credit,834.51,-691505.38,USD,Walmart
TXN0000013297,2024-11-13T12:00:42,ACC00004238,Credit,312.95,-691192.43,USD,Online Store
TXN0000013298,2024-01-19T02:05:54,ACC00003158,Payment,1233.17,-692425.6,GBP,Amazon
TXN0000013299,2024-06-16T05:22:53,ACC00006431,Transfer,646.85,-691778.75,JPY,Shell
TXN0000013300,2024-12-03T14:31:27,ACC00007567,Payment,821.69,-692600.44,EUR,Amazon
TXN0000013301,2024-08-14T02:48:22,ACC00002403,Credit,36.96,-692563.48,JPY,Walmart
TXN0000013302,2024-01-23T19:04:50,ACC00000532,Credit,857.6,-691705.88,JPY,Amazon
TXN0000013303,2024-10-03T08:39:58,ACC00008167,Credit,330.02,-691375.86,EUR,Grocery
TXN0000013304,2024-06-07T20:00:39,ACC00007087,ATM,868.31,-692244.17,EUR,Walmart
TXN0000013305,2024-09-10T00:25:40,ACC00001993,Transfer,633.39,-691610.78,GBP,Grocery
TXN0000013306,2024-04-18T17:41:59,ACC00009133,Payment,527.93,-692138.71,EUR,Grocery
TXN0000013307,2024-03-18T20:56:32,ACC00003885,Transfer,795.9,-691342.81,GBP,Shell
TXN0000013308,2024-05-16T13:52:55,ACC00005119,Debit,1273.42,-692616.23,USD,Online Store
TXN0000013309,2024-11-03T00:57:22,ACC00000231,Debit,550.49,-693166.72,USD,Restaurant
TXN0000013310,2024-09-27T06:57:05,ACC00006169,Debit,1550.56,-694717.28,GBP,Target
TXN0000013311,2024-09-15T21:31:49,ACC00000186,ATM,493.06,-695210.34,JPY,Restaurant
TXN0000013312,2024-07-17T21:58:40,ACC00007609,Credit,1030.23,-694180.11,JPY,Restaurant
TXN0000013313,2024-10-17T06:02:21,ACC00000556,Payment,1291.94,-695472.05,USD,Starbucks
TXN0000013314,2024-09-18T09:01:22,ACC00002618,Credit,1744.73,-693727.32,JPY,Online Store
TXN0000013315,2024-11-22T02:43:05,ACC00007482,ATM,266.67,-693993.99,GBP,Grocery
TXN0000013316,2024-09-13T19:50:17,ACC00005448,Payment,127.26,-694121.25,GBP,Target
TXN0000013317,2024-09-07T18:26:31,ACC00005676,Transfer,1933.07,-692188.18,EUR,Restaurant
TXN0000013318,2024-02-26T16:24:01,ACC00009002,ATM,1597.86,-693786.04,EUR,Amazon
TXN0000013319,2024-03-01T17:00:36,ACC00000146,Debit,1996.72,-695782.76,JPY,Grocery
TXN0000013320,2024-02-15T12:24:31,ACC00009954,Transfer,689.55,-695093.21,JPY,Amazon
TXN0000013321,2024-04-02T11:55:30,ACC00009985,Transfer,825.21,-694268.0,JPY,Starbucks
TXN0000013322,2024-12-07T00:14:06,ACC00006908,ATM,1665.58,-695933.58,JPY,Online Store
TXN0000013323,2024-06-30T05:37:58,ACC00001760,ATM,597.07,-696530.65,EUR,Shell
TXN0000013324,2024-11-26T12:27:30,ACC00007708,Debit,1059.17,-697589.82,GBP,Amazon
TXN0000013325,2024-10-09T07:38:06,ACC00002055,Transfer,1092.21,-696497.61,JPY,Amazon
TXN0000013326,2024-05-07T22:06:16,ACC00001647,ATM,1835.74,-698333.35,EUR,Walmart
TXN0000013327,2024-07-02T13:56:34,ACC00007746,Debit,1085.53,-699418.88,GBP,Online Store
TXN0000013328,2024-10-02T15:40:23,ACC00003889,Credit,1725.92,-697692.96,GBP,Restaurant
TXN0000013329,2024-04-21T16:21:56,ACC00005638,ATM,149.01,-697841.97,USD,Shell
TXN0000013330,2024-12-15T06:23:24,ACC00005493,Payment,1221.2,-699063.17,EUR,Target
TXN0000013331,2024-07-04T23:52:12,ACC00007791,Payment,484.79,-699547.96,JPY,Amazon
TXN0000013332,2024-03-29T22:15:04,ACC00009797,ATM,576.81,-700124.77,USD,Shell
TXN0000013333,2024-10-09T11:53:38,ACC00008274,Credit,102.09,-700022.68,EUR,Amazon
TXN0000013334,2024-08-04T09:58:47,ACC00000634,ATM,1926.24,-701948.92,EUR,Shell
TXN0000013335,2024-11-29T07:06:03,ACC00004917,Transfer,218.63,-701730.29,GBP,Online Store
TXN0000013336,2024-07-20T17:27:45,ACC00006567,Credit,1027.26,-700703.03,EUR,Amazon
TXN0000013337,2024-04-16T17:56:56,ACC00003303,Debit,173.07,-700876.1,EUR,Walmart
TXN0000013338,2024-12-10T00:07:45,ACC00004545,ATM,908.72,-701784.82,JPY,Restaurant
TXN0000013339,2024-08-21T20:08:29,ACC00006482,Payment,1463.3,-703248.12,GBP,Target
TXN0000013340,2024-01-05T20:04:59,ACC00000870,Debit,1157.69,-704405.81,EUR,Starbucks
TXN0000013341,2024-08-26T21:45:09,ACC00006422,ATM,1924.14,-706329.95,EUR,Shell
TXN0000013342,2024-10-08T14:58:30,ACC00002769,Transfer,125.45,-706204.5,EUR,Shell
TXN0000013343,2024-10-04T02:30:24,ACC00005606,Debit,916.81,-707121.31,USD,Shell
TXN0000013344,2024-05-26T21:03:00,ACC00006701,Debit,1094.32,-708215.63,USD,Online Store
TXN0000013345,2024-02-09T17:05:30,ACC00001960,Credit,1293.38,-706922.25,USD,Shell
TXN0000013346,2024-12-20T09:08:10,ACC00001046,ATM,1741.1,-708663.35,EUR,Shell
TXN0000013347,2024-11-18T04:37:13,ACC00003006,Debit,1455.0,-710118.35,EUR,Amazon
TXN0000013348,2024-03-15T03:29:34,ACC00002332,ATM,373.16,-710491.51,EUR,Shell
TXN0000013349,2024-03-07T11:08:30,ACC00002843,Credit,555.91,-709935.6,USD,Online Store
TXN0000013350,2024-01-24T08:40:18,ACC00000460,Debit,187.14,-710122.74,GBP,Starbucks
TXN0000013351,2024-12-17T16:03:55,ACC00007934,Credit,297.31,-709825.43,JPY,Starbucks
TXN0000013352,2024-02-25T13:21:04,ACC00003371,Transfer,36.49,-709788.94,GBP,Walmart
TXN0000013353,2024-08-29T20:14:30,ACC00002997,Debit,348.28,-710137.22,USD,Target
TXN0000013354,2024-02-23T00:49:20,ACC00002666,Transfer,413.84,-709723.38,EUR,Online Store
TXN0000013355,2024-09-27T18:17:48,ACC00009872,Payment,102.41,-709825.79,USD,Walmart
TXN0000013356,2024-10-10T00:05:04,ACC00006207,Payment,1444.01,-711269.8,EUR,Amazon
TXN0000013357,2024-05-20T09:34:12,ACC00008863,Transfer,1282.73,-709987.07,USD,Starbucks
TXN0000013358,2024-10-03T20:39:30,ACC00005025,ATM,1111.43,-711098.5,EUR,Starbucks
TXN0000013359,2024-11-02T12:26:04,ACC00003533,Debit,881.24,-711979.74,EUR,Online Store
TXN0000013360,2024-11-11T02:59:22,ACC00007062,ATM,1173.72,-713153.46,JPY,Walmart
TXN0000013361,2024-05-21T20:59:14,ACC00002564,ATM,1484.63,-714638.09,EUR,Shell
TXN0000013362,2024-04-19T16:23:27,ACC00003863,Transfer,371.83,-714266.26,JPY,Walmart
TXN0000013363,2024-03-03T15:24:57,ACC00008089,Debit,1394.7,-715660.96,USD,Target
TXN0000013364,2024-01-18T17:44:41,ACC00001283,Payment,834.1,-716495.06,USD,Online Store
TXN0000013365,2024-04-21T14:48:06,ACC00005803,ATM,546.48,-717041.54,JPY,Target
TXN0000013366,2024-01-10T15:45:24,ACC00005882,Payment,1283.55,-718325.09,GBP,Starbucks
TXN0000013367,2024-01-15T00:40:10,ACC00004547,Payment,1134.88,-719459.97,USD,Walmart
TXN0000013368,2024-07-23T08:53:15,ACC00001121,Payment,1076.42,-720536.39,GBP,Restaurant
TXN0000013369,2024-08-17T04:44:56,ACC00001571,Debit,1463.73,-722000.12,JPY,Online Store
TXN0000013370,2024-03-31T02:56:10,ACC00009008,Transfer,1543.79,-720456.33,EUR,Amazon
TXN0000013371,2024-05-06T15:51:10,ACC00006942,Credit,1308.06,-719148.27,EUR,Target
TXN0000013372,2024-10-19T08:17:50,ACC00009925,Debit,977.24,-720125.51,JPY,Online Store
TXN0000013373,2024-01-28T08:47:32,ACC00007426,Payment,47.02,-720172.53,USD,Starbucks
TXN0000013374,2024-06-26T18:42:07,ACC00003974,ATM,1892.51,-722065.04,JPY,Grocery
TXN0000013375,2024-05-12T23:59:45,ACC00003644,Debit,508.82,-722573.86,USD,Restaurant
TXN0000013376,2024-10-10T14:25:30,ACC00008753,Payment,605.87,-723179.73,USD,Target
TXN0000013377,2024-03-27T23:29:33,ACC00005145,ATM,181.72,-723361.45,EUR,Shell
TXN0000013378,2024-05-08T06:12:19,ACC00004009,Transfer,1051.79,-722309.66,JPY,Grocery
TXN0000013379,2024-06-10T14:52:26,ACC00007558,Credit,831.6,-721478.06,JPY,Starbucks
TXN0000013380,2024-05-29T17:29:31,ACC00003407,Payment,1921.17,-723399.23,JPY,Restaurant
TXN0000013381,2024-09-07T15:56:05,ACC00000062,Debit,287.43,-723686.66,EUR,Shell
TXN0000013382,2024-01-15T22:39:44,ACC00001129,Debit,224.66,-723911.32,USD,Walmart
TXN0000013383,2024-08-29T04:50:12,ACC00004371,Payment,247.24,-724158.56,JPY,Amazon
TXN0000013384,2024-03-18T17:55:10,ACC00008470,Payment,1196.68,-725355.24,JPY,Target
TXN0000013385,2024-09-19T14:51:36,ACC00006141,Payment,1754.7,-727109.94,EUR,Amazon
TXN0000013386,2024-05-16T07:28:21,ACC00000826,Transfer,915.46,-726194.48,JPY,Online Store
TXN0000013387,2024-07-29T18:12:28,ACC00000361,Payment,184.49,-726378.97,USD,Walmart
TXN0000013388,2024-12-16T17:14:53,ACC00009266,Debit,27.07,-726406.04,GBP,Target
TXN0000013389,2024-08-16T22:14:47,ACC00002555,Credit,616.11,-725789.93,EUR,Target
TXN0000013390,2024-01-23T19:27:39,ACC00007527,Credit,438.81,-725351.12,USD,Amazon
TXN0000013391,2024-03-19T13:09:46,ACC00003262,Transfer,1788.99,-723562.13,EUR,Walmart
TXN0000013392,2024-08-13T12:30:50,ACC00004780,Payment,1304.98,-724867.11,USD,Shell
TXN0000013393,2024-02-05T11:03:05,ACC00007712,ATM,1044.61,-725911.72,GBP,Grocery
TXN0000013394,2024-02-20T10:42:51,ACC00008195,Payment,576.36,-726488.08,USD,Amazon
TXN0000013395,2024-10-29T07:54:47,ACC00008279,Payment,1720.02,-728208.1,USD,Amazon
TXN0000013396,2024-10-23T21:52:10,ACC00000056,Credit,1094.94,-727113.16,EUR,Shell
TXN0000013397,2024-07-24T19:35:51,ACC00007700,ATM,988.37,-728101.53,USD,Online Store
TXN0000013398,2024-09-07T06:52:46,ACC00009416,Transfer,177.22,-727924.31,USD,Amazon
TXN0000013399,2024-06-18T12:50:40,ACC00006428,Transfer,1017.02,-726907.29,EUR,Walmart
TXN0000013400,2024-10-26T01:26:49,ACC00001906,Debit,304.21,-727211.5,USD,Amazon
TXN0000013401,2024-09-07T17:32:44,ACC00001688,Payment,1997.64,-729209.14,GBP,Amazon
TXN0000013402,2024-10-25T08:17:38,ACC00004167,Debit,1621.19,-730830.33,EUR,Starbucks
TXN0000013403,2024-08-23T19:41:17,ACC00008667,ATM,1720.24,-732550.57,USD,Starbucks
TXN0000013404,2024-01-21T15:06:30,ACC00002170,Debit,659.21,-733209.78,USD,Shell
TXN0000013405,2024-07-16T02:44:39,ACC00006663,Credit,241.03,-732968.75,EUR,Grocery
TXN0000013406,2024-11-23T13:16:09,ACC00002330,Transfer,1679.5,-731289.25,EUR,Shell
TXN0000013407,2024-03-02T02:12:12,ACC00003890,ATM,366.57,-731655.82,GBP,Amazon
TXN0000013408,2024-11-20T10:29:22,ACC00009292,Debit,521.76,-732177.58,GBP,Amazon
TXN0000013409,2024-12-29T00:37:52,ACC00004947,ATM,645.22,-732822.8,EUR,Online Store
TXN0000013410,2024-03-23T11:17:27,ACC00000936,ATM,92.41,-732915.21,EUR,Amazon
TXN0000013411,2024-04-15T20:28:41,ACC00007840,ATM,1068.81,-733984.02,GBP,Starbucks
TXN0000013412,2024-04-26T09:13:19,ACC00003043,ATM,581.84,-734565.86,USD,Starbucks
TXN0000013413,2024-08-29T13:42:48,ACC00005218,Debit,121.16,-734687.02,EUR,Shell
TXN0000013414,2024-08-30T10:00:02,ACC00002805,ATM,1453.62,-736140.64,JPY,Target
TXN0000013415,2024-11-27T19:43:34,ACC00001981,ATM,771.52,-736912.16,EUR,Online Store
TXN0000013416,2024-01-15T08:30:05,ACC00005667,Payment,640.45,-737552.61,GBP,Shell
TXN0000013417,2024-08-14T14:22:34,ACC00008505,Payment,681.64,-738234.25,JPY,Shell
TXN0000013418,2024-03-06T04:51:16,ACC00005619,Credit,917.49,-737316.76,EUR,Starbucks
TXN0000013419,2024-03-08T06:24:06,ACC00004048,Credit,582.18,-736734.58,GBP,Amazon
TXN0000013420,2024-04-05T09:25:58,ACC00004994,Payment,591.13,-737325.71,USD,Restaurant
TXN0000013421,2024-08-11T04:56:44,ACC00009168,Credit,1362.75,-735962.96,GBP,Restaurant
TXN0000013422,2024-07-04T17:56:48,ACC00004423,ATM,1912.79,-737875.75,GBP,Target
TXN0000013423,2024-05-07T10:43:12,ACC00001240,Credit,779.33,-737096.42,JPY,Target
TXN0000013424,2024-07-30T14:31:14,ACC00003712,Payment,433.57,-737529.99,GBP,Restaurant
TXN0000013425,2024-01-23T13:39:17,ACC00007443,Transfer,1253.42,-736276.57,JPY,Amazon
TXN0000013426,2024-11-26T14:06:47,ACC00005898,Transfer,1715.28,-734561.29,GBP,Shell
TXN0000013427,2024-02-21T22:18:43,ACC00001415,Credit,880.05,-733681.24,JPY,Online Store
TXN0000013428,2024-11-29T20:23:47,ACC00008039,Credit,1656.74,-732024.5,JPY,Target
TXN0000013429,2024-11-21T14:35:12,ACC00002907,Transfer,980.44,-731044.06,JPY,Restaurant
TXN0000013430,2024-05-07T13:21:13,ACC00000325,Payment,1522.67,-732566.73,EUR,Online Store
TXN0000013431,2024-11-10T08:04:20,ACC00002965,Credit,140.94,-732425.79,EUR,Starbucks
TXN0000013432,2024-01-25T02:37:43,ACC00000934,Credit,1899.11,-730526.68,EUR,Walmart
TXN0000013433,2024-10-06T23:19:37,ACC00003902,Credit,1513.37,-729013.31,USD,Target
TXN0000013434,2024-07-04T03:02:03,ACC00007579,Credit,339.91,-728673.4,JPY,Online Store
TXN0000013435,2024-11-05T21:39:25,ACC00004257,Credit,1080.56,-727592.84,GBP,Amazon
TXN0000013436,2024-10-10T20:35:00,ACC00000373,Credit,793.71,-726799.13,GBP,Walmart
TXN0000013437,2024-03-15T19:48:41,ACC00009944,Credit,1168.24,-725630.89,JPY,Shell
TXN0000013438,2024-08-03T05:40:06,ACC00007915,ATM,1253.67,-726884.56,EUR,Starbucks
TXN0000013439,2024-10-03T13:45:36,ACC00003818,ATM,594.88,-727479.44,GBP,Shell
TXN0000013440,2024-07-22T06:40:25,ACC00009798,Transfer,1299.96,-726179.48,EUR,Grocery
TXN0000013441,2024-12-15T00:05:53,ACC00003690,Debit,1827.1,-728006.58,USD,Restaurant
TXN0000013442,2024-07-09T03:37:56,ACC00005537,Payment,1299.76,-729306.34,EUR,Starbucks
TXN0000013443,2024-06-01T04:40:57,ACC00007746,Transfer,1571.64,-727734.7,EUR,Target
TXN0000013444,2024-05-14T18:07:08,ACC00007703,ATM,481.24,-728215.94,USD,Starbucks
TXN0000013445,2024-11-26T00:21:02,ACC00004801,Transfer,1087.57,-727128.37,JPY,Restaurant
TXN0000013446,2024-10-28T17:23:08,ACC00002025,ATM,108.43,-727236.8,EUR,Shell
TXN0000013447,2024-05-18T07:26:59,ACC00007140,Credit,797.63,-726439.17,USD,Online Store
TXN0000013448,2024-03-23T00:22:31,ACC00004066,ATM,1689.67,-728128.84,EUR,Target
TXN0000013449,2024-08-19T12:36:24,ACC00001488,Debit,565.4,-728694.24,USD,Target
TXN0000013450,2024-07-29T09:37:36,ACC00000677,Debit,140.13,-728834.37,USD,Amazon
TXN0000013451,2024-07-14T07:21:16,ACC00008126,Credit,254.04,-728580.33,JPY,Grocery
TXN0000013452,2024-11-01T17:58:39,ACC00002590,ATM,1854.41,-730434.74,JPY,Walmart
TXN0000013453,2024-03-31T03:38:05,ACC00003068,ATM,1990.26,-732425.0,EUR,Starbucks
TXN0000013454,2024-07-20T09:05:36,ACC00008692,Debit,255.84,-732680.84,JPY,Grocery
TXN0000013455,2024-03-23T19:52:10,ACC00005243,ATM,347.61,-733028.45,GBP,Walmart
TXN0000013456,2024-10-22T17:57:24,ACC00007332,Debit,1869.22,-734897.67,EUR,Walmart
TXN0000013457,2024-12-23T16:36:01,ACC00007035,Debit,779.11,-735676.78,EUR,Walmart
TXN0000013458,2024-07-12T01:19:48,ACC00001907,Payment,1544.65,-737221.43,GBP,Amazon
TXN0000013459,2024-03-16T19:40:16,ACC00002056,Transfer,934.67,-736286.76,JPY,Amazon
TXN0000013460,2024-07-15T10:04:16,ACC00009579,Debit,1064.4,-737351.16,EUR,Starbucks
TXN0000013461,2024-08-27T16:10:45,ACC00006853,Credit,164.17,-737186.99,JPY,Walmart
TXN0000013462,2024-12-11T10:53:54,ACC00006980,Debit,84.14,-737271.13,EUR,Amazon
TXN0000013463,2024-06-24T21:15:22,ACC00004668,ATM,476.58,-737747.71,USD,Starbucks
TXN0000013464,2024-05-02T16:20:42,ACC00001843,Transfer,231.56,-737516.15,EUR,Amazon
TXN0000013465,2024-02-28T02:39:58,ACC00003222,Transfer,454.12,-737062.03,USD,Restaurant
TXN0000013466,2024-12-17T11:22:52,ACC00006269,Credit,1442.77,-735619.26,JPY,Shell
TXN0000013467,2024-11-12T15:22:24,ACC00002504,ATM,164.08,-735783.34,JPY,Grocery
TXN0000013468,2024-06-07T18:49:45,ACC00006903,Credit,980.18,-734803.16,USD,Amazon
TXN0000013469,2024-03-30T06:02:45,ACC00008369,Debit,552.73,-735355.89,GBP,Amazon
TXN0000013470,2024-03-29T05:25:51,ACC00004941,ATM,1004.97,-736360.86,GBP,Shell
TXN0000013471,2024-10-21T09:39:24,ACC00003894,Transfer,763.73,-735597.13,EUR,Online Store
TXN0000013472,2024-09-12T22:44:44,ACC00004302,Payment,461.16,-736058.29,JPY,Amazon
TXN0000013473,2024-12-22T15:57:55,ACC00000133,Credit,1464.94,-734593.35,JPY,Walmart
TXN0000013474,2024-03-16T12:09:40,ACC00007858,Payment,1568.05,-736161.4,EUR,Walmart
TXN0000013475,2024-02-13T23:50:17,ACC00007602,Payment,84.34,-736245.74,EUR,Online Store
TXN0000013476,2024-10-13T10:03:17,ACC00002969,Transfer,402.64,-735843.1,JPY,Walmart
TXN0000013477,2024-02-26T07:11:07,ACC00009073,Payment,1641.96,-737485.06,GBP,Restaurant
TXN0000013478,2024-11-10T05:40:34,ACC00006900,Credit,977.98,-736507.08,USD,Grocery
TXN0000013479,2024-10-22T01:54:45,ACC00009412,Payment,1220.87,-737727.95,JPY,Restaurant
TXN0000013480,2024-04-20T05:42:35,ACC00000559,Debit,642.47,-738370.42,USD,Target
TXN0000013481,2024-01-20T06:54:41,ACC00005248,Transfer,1178.0,-737192.42,GBP,Starbucks
TXN0000013482,2024-04-17T00:34:39,ACC00001123,Transfer,655.77,-736536.65,JPY,Starbucks
TXN0000013483,2024-04-17T06:41:52,ACC00005954,Payment,985.01,-737521.66,EUR,Restaurant
TXN0000013484,2024-04-17T00:00:25,ACC00003391,Payment,1698.27,-739219.93,GBP,Walmart
TXN0000013485,2024-05-04T14:59:26,ACC00006870,Debit,1849.29,-741069.22,GBP,Grocery
TXN0000013486,2024-08-01T23:01:51,ACC00001852,Credit,23.77,-741045.45,JPY,Starbucks
TXN0000013487,2024-03-10T23:29:52,ACC00007707,Debit,1243.53,-742288.98,GBP,Restaurant
TXN0000013488,2024-05-28T05:48:04,ACC00007302,ATM,639.6,-742928.58,EUR,Amazon
TXN0000013489,2024-05-16T04:20:15,ACC00001705,Credit,1370.17,-741558.41,USD,Target
TXN0000013490,2024-07-27T11:19:08,ACC00003335,Credit,542.72,-741015.69,USD,Grocery
TXN0000013491,2024-02-21T03:06:34,ACC00002630,Transfer,1620.07,-739395.62,USD,Online Store
TXN0000013492,2024-04-27T10:42:52,ACC00008318,Payment,1774.97,-741170.59,JPY,Online Store
TXN0000013493,2024-07-31T06:13:16,ACC00003119,Credit,774.59,-740396.0,EUR,Amazon
TXN0000013494,2024-04-12T20:06:27,ACC00009546,Payment,1043.56,-741439.56,USD,Walmart
TXN0000013495,2024-06-15T17:25:01,ACC00007123,ATM,970.69,-742410.25,GBP,Amazon
TXN0000013496,2024-08-28T02:30:56,ACC00004454,Debit,711.07,-743121.32,EUR,Restaurant
TXN0000013497,2024-05-17T12:49:21,ACC00008750,Debit,1984.58,-745105.9,GBP,Shell
TXN0000013498,2024-11-24T15:26:54,ACC00008228,Payment,327.71,-745433.61,EUR,Target
TXN0000013499,2024-07-23T10:57:33,ACC00007133,Transfer,941.68,-744491.93,JPY,Amazon
TXN0000013500,2024-04-06T11:35:43,ACC00007607,Payment,1387.73,-745879.66,GBP,Restaurant
TXN0000013501,2024-09-16T23:57:07,ACC00006618,Payment,1018.82,-746898.48,EUR,Target
TXN0000013502,2024-08-04T21:44:57,ACC00002514,Transfer,1912.57,-744985.91,JPY,Starbucks
TXN0000013503,2024-12-25T06:40:42,ACC00005352,ATM,1791.55,-746777.46,JPY,Grocery
TXN0000013504,2024-11-13T06:48:01,ACC00004063,Transfer,269.96,-746507.5,JPY,Restaurant
TXN0000013505,2024-06-07T04:54:05,ACC00006107,Transfer,1304.49,-745203.01,GBP,Starbucks
TXN0000013506,2024-10-15T15:55:23,ACC00008045,Credit,79.4,-745123.61,USD,Shell
TXN0000013507,2024-12-19T05:40:48,ACC00005447,Payment,1231.47,-746355.08,USD,Starbucks
TXN0000013508,2024-05-02T00:41:28,ACC00009305,ATM,86.35,-746441.43,USD,Grocery
TXN0000013509,2024-12-04T10:58:58,ACC00009186,ATM,1371.55,-747812.98,GBP,Shell
TXN0000013510,2024-03-02T18:38:21,ACC00001146,Credit,1321.39,-746491.59,GBP,Amazon
TXN0000013511,2024-02-18T12:05:15,ACC00007886,Transfer,251.94,-746239.65,USD,Walmart
TXN0000013512,2024-07-21T08:26:26,ACC00004803,Debit,459.8,-746699.45,USD,Restaurant
TXN0000013513,2024-04-26T00:13:38,ACC00002917,Credit,1575.56,-745123.89,USD,Grocery
TXN0000013514,2024-06-10T13:12:51,ACC00004519,ATM,1645.91,-746769.8,USD,Restaurant
TXN0000013515,2024-08-17T02:13:19,ACC00008270,Credit,948.07,-745821.73,JPY,Restaurant
TXN0000013516,2024-10-08T11:19:50,ACC00008358,ATM,392.3,-746214.03,JPY,Shell
TXN0000013517,2024-01-07T09:26:53,ACC00005597,Payment,88.5,-746302.53,EUR,Restaurant
TXN0000013518,2024-07-23T16:16:19,ACC00004816,Transfer,1197.4,-745105.13,GBP,Amazon
TXN0000013519,2024-03-31T12:07:48,ACC00005564,Payment,500.55,-745605.68,GBP,Restaurant
TXN0000013520,2024-05-20T16:03:51,ACC00004607,Transfer,771.25,-744834.43,GBP,Target
TXN0000013521,2024-08-28T01:59:30,ACC00009675,Debit,279.36,-745113.79,JPY,Shell
TXN0000013522,2024-05-12T02:29:10,ACC00004032,ATM,616.91,-745730.7,GBP,Grocery
TXN0000013523,2024-07-10T03:58:03,ACC00003926,Transfer,1733.18,-743997.52,EUR,Starbucks
TXN0000013524,2024-06-27T23:08:52,ACC00007607,Debit,338.54,-744336.06,USD,Grocery
TXN0000013525,2024-08-02T22:16:11,ACC00004646,Debit,903.2,-745239.26,GBP,Restaurant
TXN0000013526,2024-03-16T07:25:45,ACC00002187,Credit,390.09,-744849.17,USD,Starbucks
TXN0000013527,2024-11-01T06:46:15,ACC00000631,Transfer,1169.48,-743679.69,JPY,Grocery
TXN0000013528,2024-04-15T12:57:42,ACC00004209,Transfer,1402.98,-742276.71,GBP,Walmart
TXN0000013529,2024-09-02T03:46:06,ACC00000053,Debit,1855.13,-744131.84,USD,Walmart
TXN0000013530,2024-10-16T10:03:39,ACC00003823,ATM,814.14,-744945.98,USD,Walmart
TXN0000013531,2024-07-21T02:32:06,ACC00008020,Debit,1998.72,-746944.7,GBP,Target
TXN0000013532,2024-04-16T07:39:44,ACC00002846,Debit,405.6,-747350.3,EUR,Grocery
TXN0000013533,2024-08-25T06:40:46,ACC00008484,Payment,1108.96,-748459.26,JPY,Target
TXN0000013534,2024-08-05T02:25:14,ACC00001257,Transfer,131.6,-748327.66,EUR,Target
TXN0000013535,2024-07-23T19:33:49,ACC00001607,Transfer,1930.49,-746397.17,GBP,Restaurant
TXN0000013536,2024-12-08T01:51:58,ACC00001901,Debit,1545.56,-747942.73,USD,Online Store
TXN0000013537,2024-07-02T21:28:05,ACC00003222,Transfer,1345.5,-746597.23,GBP,Walmart
TXN0000013538,2024-10-31T11:57:37,ACC00003348,Debit,216.85,-746814.08,GBP,Walmart
TXN0000013539,2024-03-27T14:11:21,ACC00001255,Debit,1280.37,-748094.45,GBP,Target
TXN0000013540,2024-02-28T00:26:54,ACC00001409,Credit,507.16,-747587.29,EUR,Walmart
TXN0000013541,2024-10-05T02:08:41,ACC00006056,ATM,768.79,-748356.08,JPY,Target
TXN0000013542,2024-01-03T16:40:11,ACC00002139,Debit,242.01,-748598.09,USD,Target
TXN0000013543,2024-09-22T09:54:12,ACC00002359,Transfer,1515.68,-747082.41,JPY,Shell
TXN0000013544,2024-05-28T14:16:20,ACC00001446,Debit,194.16,-747276.57,USD,Target
TXN0000013545,2024-10-29T11:04:15,ACC00002865,Credit,641.6,-746634.97,EUR,Grocery
TXN0000013546,2024-11-16T03:28:48,ACC00009507,ATM,469.67,-747104.64,JPY,Target
TXN0000013547,2024-09-24T01:19:08,ACC00007669,Credit,1618.28,-745486.36,JPY,Walmart
TXN0000013548,2024-11-07T13:23:24,ACC00001723,Payment,1277.62,-746763.98,GBP,Starbucks
TXN0000013549,2024-01-03T19:13:18,ACC00003800,Debit,1447.18,-748211.16,EUR,Target
TXN0000013550,2024-09-19T15:22:31,ACC00002802,Credit,1570.96,-746640.2,GBP,Walmart
TXN0000013551,2024-06-11T07:25:25,ACC00005663,Payment,1676.25,-748316.45,EUR,Target
TXN0000013552,2024-06-19T15:51:39,ACC00009507,ATM,975.69,-749292.14,USD,Starbucks
TXN0000013553,2024-03-06T02:24:41,ACC00008595,Credit,470.3,-748821.84,USD,Online Store
TXN0000013554,2024-06-11T06:42:35,ACC00007356,ATM,1848.68,-750670.52,USD,Online Store
TXN0000013555,2024-05-02T06:54:51,ACC00001252,Transfer,107.81,-750562.71,GBP,Shell
TXN0000013556,2024-12-16T14:34:07,ACC00002672,ATM,947.44,-751510.15,USD,Target
TXN0000013557,2024-06-12T02:41:34,ACC00003740,Transfer,859.98,-750650.17,EUR,Walmart
TXN0000013558,2024-10-21T23:09:25,ACC00004428,Debit,1286.42,-751936.59,USD,Target
TXN0000013559,2024-03-25T08:07:04,ACC00002126,Payment,443.44,-752380.03,USD,Restaurant
TXN0000013560,2024-07-14T22:14:13,ACC00004356,ATM,47.0,-752427.03,GBP,Walmart
TXN0000013561,2024-03-02T03:55:48,ACC00005919,Debit,1913.01,-754340.04,EUR,Restaurant
TXN0000013562,2024-10-04T03:17:58,ACC00006073,Debit,971.49,-755311.53,GBP,Amazon
TXN0000013563,2024-03-06T05:57:22,ACC00009602,Transfer,258.96,-755052.57,EUR,Amazon
TXN0000013564,2024-04-17T13:58:39,ACC00003521,Credit,1998.46,-753054.11,GBP,Walmart
TXN0000013565,2024-10-24T14:58:43,ACC00005029,ATM,1466.86,-754520.97,USD,Restaurant
TXN0000013566,2024-08-15T22:48:22,ACC00002763,ATM,66.29,-754587.26,JPY,Restaurant
TXN0000013567,2024-03-17T00:42:45,ACC00005416,Payment,1677.27,-756264.53,JPY,Shell
TXN0000013568,2024-05-24T20:53:50,ACC00007375,Credit,1261.97,-755002.56,JPY,Starbucks
TXN0000013569,2024-06-20T15:52:00,ACC00001001,Transfer,1063.88,-753938.68,USD,Grocery
TXN0000013570,2024-03-11T14:08:42,ACC00001635,Debit,937.86,-754876.54,GBP,Starbucks
TXN0000013571,2024-02-11T11:57:05,ACC00003077,Transfer,644.13,-754232.41,JPY,Restaurant
TXN0000013572,2024-07-23T18:18:37,ACC00005841,ATM,1389.52,-755621.93,JPY,Amazon
TXN0000013573,2024-05-14T09:33:50,ACC00000127,Payment,1226.9,-756848.83,JPY,Grocery
TXN0000013574,2024-02-04T14:03:50,ACC00008027,Transfer,1693.32,-755155.51,USD,Shell
TXN0000013575,2024-11-18T11:15:42,ACC00007014,Debit,680.22,-755835.73,EUR,Amazon
TXN0000013576,2024-10-01T10:16:21,ACC00002192,ATM,1682.5,-757518.23,GBP,Restaurant
TXN0000013577,2024-09-25T09:13:48,ACC00000149,Payment,160.76,-757678.99,EUR,Starbucks
TXN0000013578,2024-05-07T15:39:10,ACC00007437,Credit,1157.47,-756521.52,EUR,Walmart
TXN0000013579,2024-02-05T18:33:33,ACC00001849,Credit,1216.73,-755304.79,USD,Amazon
TXN0000013580,2024-05-27T00:41:30,ACC00009425,Payment,271.54,-755576.33,JPY,Amazon
TXN0000013581,2024-06-07T08:35:02,ACC00003675,Debit,1171.03,-756747.36,EUR,Amazon
TXN0000013582,2024-01-11T02:32:53,ACC00003848,Payment,621.46,-757368.82,GBP,Grocery
TXN0000013583,2024-03-28T20:02:45,ACC00006556,Debit,512.45,-757881.27,USD,Target
TXN0000013584,2024-10-24T23:27:01,ACC00003513,Credit,1116.8,-756764.47,GBP,Shell
TXN0000013585,2024-08-21T22:24:16,ACC00003247,Transfer,922.71,-755841.76,GBP,Starbucks
TXN0000013586,2024-02-08T12:42:59,ACC00006864,Credit,686.97,-755154.79,JPY,Shell
TXN0000013587,2024-08-31T14:20:45,ACC00008495,Debit,1315.91,-756470.7,JPY,Online Store
TXN0000013588,2024-05-29T15:48:35,ACC00008929,Debit,1067.7,-757538.4,EUR,Online Store
TXN0000013589,2024-06-29T06:49:45,ACC00007497,ATM,1126.74,-758665.14,JPY,Walmart
TXN0000013590,2024-06-22T01:07:17,ACC00001174,Debit,12.39,-758677.53,JPY,Target
TXN0000013591,2024-05-01T07:29:37,ACC00005808,Debit,1564.7,-760242.23,JPY,Online Store
TXN0000013592,2024-05-31T13:47:56,ACC00009382,Transfer,655.47,-759586.76,EUR,Walmart
TXN0000013593,2024-09-29T01:47:47,ACC00005851,Credit,979.95,-758606.81,JPY,Starbucks
TXN0000013594,2024-08-05T22:47:18,ACC00003862,Debit,1622.46,-760229.27,EUR,Starbucks
TXN0000013595,2024-01-31T04:18:07,ACC00005803,Debit,1047.51,-761276.78,EUR,Online Store
TXN0000013596,2024-02-13T08:28:36,ACC00002046,Debit,1460.94,-762737.72,EUR,Amazon
TXN0000013597,2024-02-26T09:26:54,ACC00002194,Payment,1234.47,-763972.19,JPY,Target
TXN0000013598,2024-03-21T11:05:14,ACC00004537,ATM,1326.9,-765299.09,GBP,Target
TXN0000013599,2024-06-09T10:26:31,ACC00006558,ATM,403.53,-765702.62,JPY,Starbucks
TXN0000013600,2024-10-19T06:52:43,ACC00000811,Payment,1494.67,-767197.29,JPY,Online Store
TXN0000013601,2024-05-24T22:07:06,ACC00004395,Credit,621.82,-766575.47,JPY,Online Store
TXN0000013602,2024-06-26T01:10:07,ACC00009814,Payment,1529.11,-768104.58,GBP,Online Store
TXN0000013603,2024-01-28T10:12:10,ACC00009821,Credit,1515.19,-766589.39,GBP,Restaurant
TXN0000013604,2024-01-21T14:10:04,ACC00008767,Debit,1904.59,-768493.98,GBP,Restaurant
TXN0000013605,2024-12-05T17:18:16,ACC00000772,Payment,1379.19,-769873.17,EUR,Starbucks
TXN0000013606,2024-10-06T11:23:51,ACC00000010,Credit,1443.51,-768429.66,EUR,Grocery
TXN0000013607,2024-02-23T08:24:19,ACC00005072,ATM,1332.2,-769761.86,USD,Restaurant
TXN0000013608,2024-03-09T16:03:27,ACC00005361,Transfer,529.25,-769232.61,EUR,Online Store
TXN0000013609,2024-04-17T20:15:38,ACC00002026,Transfer,1069.28,-768163.33,JPY,Starbucks
TXN0000013610,2024-02-06T11:28:22,ACC00001902,Transfer,254.63,-767908.7,JPY,Walmart
TXN0000013611,2024-04-20T02:55:14,ACC00002242,ATM,977.75,-768886.45,USD,Walmart
TXN0000013612,2024-02-05T10:29:49,ACC00006943,Credit,563.78,-768322.67,JPY,Walmart
TXN0000013613,2024-08-31T06:01:33,ACC00000733,Transfer,1089.61,-767233.06,USD,Target
TXN0000013614,2024-09-25T22:38:50,ACC00004241,Credit,989.01,-766244.05,JPY,Shell
TXN0000013615,2024-01-05T16:03:22,ACC00009387,Payment,1844.39,-768088.44,GBP,Shell
TXN0000013616,2024-11-18T12:25:33,ACC00006973,ATM,1476.72,-769565.16,EUR,Starbucks
TXN0000013617,2024-03-12T07:46:38,ACC00006243,Debit,571.27,-770136.43,JPY,Shell
TXN0000013618,2024-09-29T15:44:40,ACC00008678,Debit,1236.0,-771372.43,EUR,Target
TXN0000013619,2024-12-24T18:31:09,ACC00007615,Debit,635.72,-772008.15,GBP,Restaurant
TXN0000013620,2024-10-25T23:54:33,ACC00006325,Transfer,1906.25,-770101.9,JPY,Amazon
TXN0000013621,2024-08-14T05:10:39,ACC00009050,Transfer,1610.67,-768491.23,JPY,Restaurant
TXN0000013622,2024-02-02T02:40:57,ACC00001831,Transfer,851.13,-767640.1,USD,Walmart
TXN0000013623,2024-10-20T08:18:53,ACC00006006,Debit,1504.81,-769144.91,JPY,Starbucks
TXN0000013624,2024-05-28T13:42:13,ACC00003499,Transfer,189.88,-768955.03,USD,Target
TXN0000013625,2024-01-29T18:06:17,ACC00005729,Credit,1338.34,-767616.69,EUR,Starbucks
TXN0000013626,2024-03-03T09:11:19,ACC00008576,Transfer,1973.96,-765642.73,GBP,Amazon
TXN0000013627,2024-09-04T03:03:39,ACC00001542,Transfer,1026.82,-764615.91,EUR,Shell
TXN0000013628,2024-05-04T20:54:47,ACC00002418,Payment,1704.07,-766319.98,GBP,Online Store
TXN0000013629,2024-09-02T04:08:55,ACC00005291,Debit,225.49,-766545.47,EUR,Starbucks
TXN0000013630,2024-12-22T12:19:01,ACC00002077,Credit,1787.33,-764758.14,GBP,Online Store
TXN0000013631,2024-06-08T14:56:40,ACC00006909,Debit,190.7,-764948.84,GBP,Grocery
TXN0000013632,2024-06-16T21:31:04,ACC00004435,ATM,103.61,-765052.45,GBP,Online Store
TXN0000013633,2024-06-11T11:59:20,ACC00003791,ATM,581.72,-765634.17,USD,Grocery
TXN0000013634,2024-03-28T08:50:21,ACC00002167,Credit,1319.64,-764314.53,USD,Starbucks
TXN0000013635,2024-12-06T12:22:54,ACC00005690,Transfer,990.15,-763324.38,JPY,Walmart
TXN0000013636,2024-08-15T13:11:06,ACC00000651,ATM,1424.24,-764748.62,USD,Amazon
TXN0000013637,2024-01-08T00:04:36,ACC00006501,Credit,623.53,-764125.09,GBP,Amazon
TXN0000013638,2024-10-24T05:11:52,ACC00006147,Debit,1093.27,-765218.36,USD,Online Store
TXN0000013639,2024-09-13T12:03:56,ACC00004975,Debit,21.77,-765240.13,EUR,Online Store
TXN0000013640,2024-07-04T08:40:44,ACC00009670,Payment,372.83,-765612.96,GBP,Online Store
TXN0000013641,2024-06-13T16:05:27,ACC00007972,Credit,787.16,-764825.8,USD,Grocery
TXN0000013642,2024-07-09T01:09:23,ACC00007221,ATM,1862.95,-766688.75,JPY,Online Store
TXN0000013643,2024-02-26T16:18:16,ACC00006435,ATM,1110.53,-767799.28,JPY,Walmart
TXN0000013644,2024-08-16T01:29:38,ACC00004049,Credit,570.91,-767228.37,GBP,Starbucks
TXN0000013645,2024-03-09T22:38:40,ACC00006009,ATM,1069.07,-768297.44,GBP,Online Store
TXN0000013646,2024-03-15T12:52:07,ACC00008516,Transfer,1188.36,-767109.08,EUR,Shell
TXN0000013647,2024-11-23T02:02:10,ACC00004584,Transfer,1077.43,-766031.65,JPY,Target
TXN0000013648,2024-09-08T11:33:27,ACC00009471,Credit,1283.3,-764748.35,GBP,Restaurant
TXN0000013649,2024-03-18T06:59:06,ACC00007644,Credit,681.58,-764066.77,EUR,Grocery
TXN0000013650,2024-07-02T19:06:12,ACC00004956,Debit,315.72,-764382.49,JPY,Amazon
TXN0000013651,2024-11-10T23:57:11,ACC00001976,ATM,1835.43,-766217.92,USD,Online Store
TXN0000013652,2024-10-24T05:45:54,ACC00009551,ATM,1909.08,-768127.0,JPY,Restaurant
TXN0000013653,2024-09-26T12:21:26,ACC00005131,Credit,1596.56,-766530.44,GBP,Shell
TXN0000013654,2024-01-03T14:36:25,ACC00009117,Credit,282.71,-766247.73,JPY,Shell
TXN0000013655,2024-03-19T19:41:49,ACC00004620,ATM,1350.03,-767597.76,GBP,Online Store
TXN0000013656,2024-08-22T13:39:19,ACC00000112,Debit,766.94,-768364.7,JPY,Target
TXN0000013657,2024-06-01T16:15:30,ACC00008572,Payment,1649.15,-770013.85,GBP,Restaurant
TXN0000013658,2024-01-25T03:08:51,ACC00002698,Transfer,1869.49,-768144.36,JPY,Amazon
TXN0000013659,2024-02-29T18:00:24,ACC00005954,Transfer,1656.34,-766488.02,JPY,Amazon
TXN0000013660,2024-01-04T14:27:09,ACC00001496,Payment,1980.44,-768468.46,JPY,Amazon
TXN0000013661,2024-06-03T11:56:30,ACC00009885,Transfer,911.08,-767557.38,JPY,Online Store
TXN0000013662,2024-07-12T06:42:52,ACC00001091,Credit,375.72,-767181.66,USD,Amazon
TXN0000013663,2024-06-28T19:59:27,ACC00004103,Credit,1623.5,-765558.16,EUR,Grocery
TXN0000013664,2024-11-10T10:48:14,ACC00006601,Debit,1293.68,-766851.84,GBP,Target
TXN0000013665,2024-01-02T17:54:31,ACC00002350,Payment,1680.18,-768532.02,EUR,Grocery
TXN0000013666,2024-05-26T22:03:56,ACC00006438,Debit,1171.91,-769703.93,USD,Amazon
TXN0000013667,2024-08-15T18:56:06,ACC00004353,Transfer,620.91,-769083.02,JPY,Starbucks
TXN0000013668,2024-11-26T04:12:44,ACC00004288,ATM,155.85,-769238.87,JPY,Walmart
TXN0000013669,2024-06-15T10:22:21,ACC00005035,Payment,303.37,-769542.24,JPY,Online Store
TXN0000013670,2024-07-10T05:24:11,ACC00001239,Transfer,1144.93,-768397.31,GBP,Walmart
TXN0000013671,2024-12-28T02:39:08,ACC00007643,Transfer,1438.15,-766959.16,EUR,Grocery
TXN0000013672,2024-10-09T11:46:57,ACC00004348,Credit,407.52,-766551.64,JPY,Amazon
TXN0000013673,2024-05-05T19:22:54,ACC00001933,Credit,1755.23,-764796.41,USD,Grocery
TXN0000013674,2024-04-26T22:42:14,ACC00005666,ATM,1954.64,-766751.05,USD,Target
TXN0000013675,2024-09-12T10:06:23,ACC00005838,ATM,1823.79,-768574.84,EUR,Online Store
TXN0000013676,2024-06-11T14:41:22,ACC00007928,Transfer,1165.11,-767409.73,EUR,Restaurant
TXN0000013677,2024-06-03T04:58:51,ACC00003177,Credit,1646.03,-765763.7,EUR,Restaurant
TXN0000013678,2024-07-13T04:56:16,ACC00008433,ATM,286.67,-766050.37,JPY,Amazon
TXN0000013679,2024-06-22T05:14:29,ACC00002147,Transfer,1847.98,-764202.39,EUR,Online Store
TXN0000013680,2024-11-12T05:20:34,ACC00000898,ATM,992.67,-765195.06,EUR,Shell
TXN0000013681,2024-06-19T08:56:40,ACC00000058,Payment,1052.74,-766247.8,EUR,Restaurant
TXN0000013682,2024-03-03T18:11:31,ACC00003771,ATM,1073.6,-767321.4,EUR,Amazon
TXN0000013683,2024-11-14T03:58:25,ACC00000434,Payment,744.22,-768065.62,EUR,Shell
TXN0000013684,2024-05-18T13:41:48,ACC00009074,Debit,1936.49,-770002.11,GBP,Restaurant
TXN0000013685,2024-05-22T17:27:29,ACC00001503,Transfer,1987.21,-768014.9,JPY,Amazon
TXN0000013686,2024-10-03T10:40:10,ACC00003529,Transfer,1385.31,-766629.59,JPY,Online Store
TXN0000013687,2024-01-08T03:57:01,ACC00002395,Debit,1200.85,-767830.44,USD,Restaurant
TXN0000013688,2024-11-02T10:15:47,ACC00007942,Transfer,1716.0,-766114.44,USD,Grocery
TXN0000013689,2024-04-02T05:38:07,ACC00001046,Credit,55.6,-766058.84,EUR,Target
TXN0000013690,2024-01-24T18:10:15,ACC00009825,ATM,1347.81,-767406.65,JPY,Grocery
TXN0000013691,2024-06-04T06:02:54,ACC00009395,Debit,1552.98,-768959.63,GBP,Walmart
TXN0000013692,2024-12-15T13:09:30,ACC00002410,Transfer,1715.83,-767243.8,JPY,Amazon
TXN0000013693,2024-09-19T06:50:49,ACC00006647,Payment,1400.38,-768644.18,JPY,Amazon
TXN0000013694,2024-07-24T19:10:54,ACC00007799,Payment,766.56,-769410.74,GBP,Restaurant
TXN0000013695,2024-05-25T22:34:14,ACC00006013,Transfer,887.81,-768522.93,GBP,Grocery
TXN0000013696,2024-05-21T02:26:04,ACC00006776,Payment,1678.44,-770201.37,EUR,Restaurant
TXN0000013697,2024-02-20T04:00:38,ACC00005283,Debit,740.68,-770942.05,JPY,Grocery
TXN0000013698,2024-05-30T12:25:17,ACC00005314,ATM,1221.83,-772163.88,USD,Online Store
TXN0000013699,2024-01-27T14:12:06,ACC00000672,Credit,309.03,-771854.85,GBP,Starbucks
TXN0000013700,2024-01-30T04:11:26,ACC00007812,Transfer,1325.51,-770529.34,USD,Amazon
TXN0000013701,2024-01-08T21:49:10,ACC00000443,Payment,152.27,-770681.61,USD,Online Store
TXN0000013702,2024-12-01T04:10:56,ACC00009295,Transfer,794.78,-769886.83,EUR,Shell
TXN0000013703,2024-04-22T01:04:11,ACC00008924,Transfer,1334.81,-768552.02,JPY,Grocery
TXN0000013704,2024-08-28T16:58:05,ACC00008250,Transfer,425.22,-768126.8,JPY,Restaurant
TXN0000013705,2024-10-16T03:54:57,ACC00000899,Credit,48.55,-768078.25,GBP,Target
TXN0000013706,2024-10-06T10:20:31,ACC00003718,ATM,367.43,-768445.68,JPY,Amazon
TXN0000013707,2024-05-30T08:31:09,ACC00006591,Payment,1251.51,-769697.19,EUR,Starbucks
TXN0000013708,2024-09-07T15:03:03,ACC00008049,Credit,1145.51,-768551.68,USD,Online Store
TXN0000013709,2024-03-29T23:26:27,ACC00003152,ATM,1608.12,-770159.8,GBP,Restaurant
TXN0000013710,2024-01-24T18:35:33,ACC00005857,Transfer,1550.94,-768608.86,EUR,Starbucks
TXN0000013711,2024-09-14T10:36:19,ACC00003883,Payment,1003.42,-769612.28,GBP,Walmart
TXN0000013712,2024-02-07T23:29:21,ACC00009926,Transfer,972.29,-768639.99,JPY,Online Store
TXN0000013713,2024-01-09T16:48:53,ACC00008467,Transfer,199.82,-768440.17,GBP,Shell
TXN0000013714,2024-07-31T20:12:53,ACC00002973,Credit,1006.95,-767433.22,USD,Target
TXN0000013715,2024-09-05T04:11:00,ACC00002807,Transfer,244.91,-767188.31,USD,Starbucks
TXN0000013716,2024-03-22T05:40:43,ACC00004024,Credit,1227.92,-765960.39,EUR,Target
TXN0000013717,2024-10-15T07:03:59,ACC00000711,Payment,1975.58,-767935.97,GBP,Target
TXN0000013718,2024-07-22T19:04:05,ACC00004618,Debit,1650.13,-769586.1,USD,Amazon
TXN0000013719,2024-03-26T22:46:13,ACC00007953,ATM,1284.64,-770870.74,EUR,Walmart
TXN0000013720,2024-02-04T15:08:12,ACC00001646,Transfer,1202.33,-769668.41,EUR,Amazon
TXN0000013721,2024-05-29T19:29:39,ACC00003384,Transfer,1459.84,-768208.57,GBP,Restaurant
TXN0000013722,2024-09-28T04:35:02,ACC00002224,Payment,464.85,-768673.42,GBP,Shell
TXN0000013723,2024-05-18T17:25:06,ACC00006154,Debit,1525.32,-770198.74,GBP,Shell
TXN0000013724,2024-02-24T11:50:07,ACC00009802,Transfer,1153.4,-769045.34,JPY,Amazon
TXN0000013725,2024-09-08T14:26:04,ACC00004784,Transfer,628.95,-768416.39,JPY,Online Store
TXN0000013726,2024-02-13T18:17:48,ACC00006213,Credit,660.4,-767755.99,EUR,Target
TXN0000013727,2024-06-23T09:37:07,ACC00001337,Debit,1004.85,-768760.84,GBP,Starbucks
TXN0000013728,2024-05-23T17:46:58,ACC00001719,Transfer,111.69,-768649.15,JPY,Online Store
TXN0000013729,2024-02-23T16:17:49,ACC00004326,Debit,783.95,-769433.1,EUR,Target
TXN0000013730,2024-12-24T22:27:31,ACC00009977,Credit,1688.56,-767744.54,GBP,Target
TXN0000013731,2024-01-05T14:18:28,ACC00003734,Transfer,1774.01,-765970.53,USD,Starbucks
TXN0000013732,2024-06-18T09:15:11,ACC00007953,Credit,1145.39,-764825.14,USD,Target
TXN0000013733,2024-01-13T07:37:30,ACC00002908,Debit,1156.56,-765981.7,USD,Target
TXN0000013734,2024-10-06T13:50:44,ACC00006917,ATM,1964.8,-767946.5,EUR,Shell
TXN0000013735,2024-03-27T05:43:00,ACC00008739,Payment,1639.43,-769585.93,EUR,Amazon
TXN0000013736,2024-12-27T23:04:34,ACC00004236,ATM,164.92,-769750.85,GBP,Starbucks
TXN0000013737,2024-05-31T18:37:53,ACC00002127,Payment,1999.33,-771750.18,GBP,Grocery
TXN0000013738,2024-03-07T04:16:42,ACC00006194,ATM,905.97,-772656.15,EUR,Walmart
TXN0000013739,2024-08-23T03:38:21,ACC00007293,Payment,297.05,-772953.2,USD,Starbucks
TXN0000013740,2024-11-29T15:03:10,ACC00007868,Debit,399.88,-773353.08,EUR,Restaurant
TXN0000013741,2024-07-13T12:53:56,ACC00007937,Debit,1923.31,-775276.39,JPY,Grocery
TXN0000013742,2024-07-17T04:26:19,ACC00002483,Credit,1259.98,-774016.41,EUR,Grocery
TXN0000013743,2024-05-15T01:41:01,ACC00003642,Debit,1709.95,-775726.36,GBP,Walmart
TXN0000013744,2024-11-19T03:53:00,ACC00004312,Transfer,1735.61,-773990.75,EUR,Amazon
TXN0000013745,2024-07-19T21:55:35,ACC00001682,Payment,1851.45,-775842.2,USD,Walmart
TXN0000013746,2024-02-25T21:31:27,ACC00002705,Debit,53.3,-775895.5,GBP,Target
TXN0000013747,2024-04-13T03:35:38,ACC00003679,Transfer,708.98,-775186.52,EUR,Starbucks
TXN0000013748,2024-11-30T22:24:14,ACC00000757,Transfer,1108.41,-774078.11,USD,Restaurant
TXN0000013749,2024-08-09T18:02:00,ACC00005002,ATM,529.0,-774607.11,GBP,Shell
TXN0000013750,2024-07-03T22:43:27,ACC00004407,Debit,666.38,-775273.49,EUR,Grocery
TXN0000013751,2024-09-17T20:24:16,ACC00009559,ATM,1910.94,-777184.43,USD,Restaurant
TXN0000013752,2024-08-30T04:30:39,ACC00006793,ATM,1501.97,-778686.4,JPY,Grocery
TXN0000013753,2024-02-09T11:17:42,ACC00009228,Transfer,1219.85,-777466.55,JPY,Online Store
TXN0000013754,2024-08-18T06:18:00,ACC00002970,Payment,458.4,-777924.95,GBP,Shell
TXN0000013755,2024-06-23T15:00:06,ACC00002465,Transfer,1043.02,-776881.93,EUR,Walmart
TXN0000013756,2024-11-05T12:59:47,ACC00001767,Payment,315.77,-777197.7,EUR,Amazon
TXN0000013757,2024-01-22T09:02:32,ACC00001140,Credit,1092.92,-776104.78,EUR,Target
TXN0000013758,2024-07-22T10:38:22,ACC00002030,Debit,1486.88,-777591.66,GBP,Starbucks
TXN0000013759,2024-01-25T16:47:21,ACC00003841,Transfer,1318.96,-776272.7,EUR,Starbucks
TXN0000013760,2024-12-21T00:02:45,ACC00009636,ATM,1528.91,-777801.61,JPY,Walmart
TXN0000013761,2024-12-25T00:25:57,ACC00008660,Transfer,513.09,-777288.52,USD,Online Store
TXN0000013762,2024-09-11T04:17:19,ACC00004949,Credit,754.31,-776534.21,EUR,Starbucks
TXN0000013763,2024-09-26T08:01:52,ACC00009446,Debit,1321.31,-777855.52,EUR,Restaurant
TXN0000013764,2024-05-18T21:36:37,ACC00006977,ATM,1361.1,-779216.62,JPY,Online Store
TXN0000013765,2024-03-30T08:00:10,ACC00002329,Credit,330.44,-778886.18,GBP,Online Store
TXN0000013766,2024-10-08T05:16:02,ACC00001033,Transfer,1438.22,-777447.96,USD,Online Store
TXN0000013767,2024-02-20T04:33:16,ACC00009976,Credit,661.57,-776786.39,EUR,Amazon
TXN0000013768,2024-04-14T13:49:50,ACC00000123,Credit,1684.26,-775102.13,EUR,Amazon
TXN0000013769,2024-08-21T21:46:57,ACC00005437,Transfer,1986.06,-773116.07,EUR,Online Store
TXN0000013770,2024-06-21T15:32:38,ACC00006358,ATM,840.01,-773956.08,EUR,Grocery
TXN0000013771,2024-06-21T01:58:26,ACC00001427,ATM,1371.16,-775327.24,JPY,Amazon
TXN0000013772,2024-06-10T13:54:31,ACC00003700,Debit,1702.9,-777030.14,USD,Restaurant
TXN0000013773,2024-07-09T05:43:07,ACC00000258,Payment,420.98,-777451.12,JPY,Starbucks
TXN0000013774,2024-01-05T08:08:50,ACC00001792,Debit,344.2,-777795.32,USD,Walmart
TXN0000013775,2024-04-20T15:37:38,ACC00002005,Payment,1765.85,-779561.17,JPY,Amazon
TXN0000013776,2024-07-18T20:41:50,ACC00009777,Debit,1697.29,-781258.46,GBP,Shell
TXN0000013777,2024-02-07T00:38:06,ACC00002286,Credit,1680.05,-779578.41,JPY,Restaurant
TXN0000013778,2024-11-06T04:54:24,ACC00000354,Payment,1103.46,-780681.87,USD,Starbucks
TXN0000013779,2024-02-25T03:35:37,ACC00001423,ATM,803.72,-781485.59,USD,Starbucks
TXN0000013780,2024-10-01T23:56:33,ACC00001931,Debit,910.26,-782395.85,JPY,Starbucks
TXN0000013781,2024-08-31T22:50:55,ACC00007809,Debit,41.09,-782436.94,USD,Amazon
TXN0000013782,2024-12-11T08:36:04,ACC00007778,ATM,226.04,-782662.98,GBP,Shell
TXN0000013783,2024-01-24T17:42:19,ACC00006450,ATM,387.6,-783050.58,GBP,Online Store
TXN0000013784,2024-11-29T16:06:41,ACC00001544,Transfer,806.55,-782244.03,EUR,Starbucks
TXN0000013785,2024-09-01T01:55:22,ACC00009048,Debit,1941.51,-784185.54,EUR,Online Store
TXN0000013786,2024-06-05T17:38:36,ACC00002416,Debit,1856.67,-786042.21,JPY,Target
TXN0000013787,2024-09-07T10:49:09,ACC00001544,Debit,1649.49,-787691.7,JPY,Walmart
TXN0000013788,2024-06-30T00:33:51,ACC00002216,Transfer,325.62,-787366.08,GBP,Restaurant
TXN0000013789,2024-12-08T12:43:59,ACC00002876,Payment,1193.96,-788560.04,EUR,Starbucks
TXN0000013790,2024-08-29T04:27:06,ACC00002335,ATM,282.74,-788842.78,JPY,Target
TXN0000013791,2024-11-03T01:17:39,ACC00004775,Credit,853.72,-787989.06,USD,Online Store
TXN0000013792,2024-04-05T04:44:48,ACC00002687,Transfer,818.54,-787170.52,GBP,Grocery
TXN0000013793,2024-01-01T01:40:31,ACC00007899,Credit,1203.89,-785966.63,GBP,Grocery
TXN0000013794,2024-04-12T14:54:29,ACC00008773,Credit,1034.7,-784931.93,JPY,Online Store
TXN0000013795,2024-11-24T07:59:07,ACC00003057,Payment,1528.52,-786460.45,EUR,Amazon
TXN0000013796,2024-12-24T03:25:06,ACC00003221,ATM,1409.37,-787869.82,USD,Target
TXN0000013797,2024-01-12T00:48:14,ACC00001547,Debit,1927.5,-789797.32,JPY,Restaurant
TXN0000013798,2024-08-11T01:47:23,ACC00009200,ATM,1967.03,-791764.35,GBP,Walmart
TXN0000013799,2024-10-15T10:18:48,ACC00005375,Payment,287.76,-792052.11,GBP,Restaurant
TXN0000013800,2024-04-02T21:15:47,ACC00007837,ATM,380.32,-792432.43,JPY,Online Store
TXN0000013801,2024-07-23T00:39:33,ACC00003298,Debit,528.31,-792960.74,USD,Target
TXN0000013802,2024-11-26T10:49:44,ACC00009995,Payment,606.95,-793567.69,USD,Amazon
TXN0000013803,2024-11-10T10:08:19,ACC00000553,Debit,396.44,-793964.13,EUR,Amazon
TXN0000013804,2024-07-05T21:26:17,ACC00001552,Debit,201.43,-794165.56,USD,Grocery
TXN0000013805,2024-11-19T13:17:45,ACC00004017,Transfer,1464.65,-792700.91,JPY,Target
TXN0000013806,2024-06-10T13:49:08,ACC00000756,Transfer,965.0,-791735.91,USD,Shell
TXN0000013807,2024-04-26T23:41:09,ACC00007130,Debit,819.96,-792555.87,JPY,Restaurant
TXN0000013808,2024-04-14T10:18:49,ACC00006897,ATM,74.16,-792630.03,JPY,Shell
TXN0000013809,2024-09-30T05:21:31,ACC00000589,ATM,663.01,-793293.04,JPY,Restaurant
TXN0000013810,2024-02-28T11:43:20,ACC00004805,Transfer,1458.17,-791834.87,GBP,Amazon
TXN0000013811,2024-02-26T14:23:08,ACC00009020,Credit,1580.71,-790254.16,EUR,Starbucks
TXN0000013812,2024-10-31T10:24:19,ACC00009066,Credit,855.82,-789398.34,USD,Starbucks
TXN0000013813,2024-07-20T02:05:14,ACC00000308,Credit,1473.57,-787924.77,GBP,Starbucks
TXN0000013814,2024-10-16T03:57:01,ACC00003812,ATM,980.13,-788904.9,EUR,Starbucks
TXN0000013815,2024-03-31T02:01:49,ACC00006117,ATM,465.1,-789370.0,GBP,Online Store
TXN0000013816,2024-07-09T00:05:11,ACC00005200,Debit,1864.07,-791234.07,GBP,Walmart
TXN0000013817,2024-04-03T05:45:33,ACC00004081,ATM,1441.76,-792675.83,USD,Walmart
TXN0000013818,2024-09-28T00:44:53,ACC00004555,Debit,312.24,-792988.07,USD,Online Store
TXN0000013819,2024-11-04T08:10:36,ACC00002804,Payment,462.35,-793450.42,EUR,Walmart
TXN0000013820,2024-10-19T07:27:47,ACC00008344,Transfer,11.95,-793438.47,USD,Starbucks
TXN0000013821,2024-04-29T00:39:04,ACC00002930,Payment,1226.98,-794665.45,EUR,Starbucks
TXN0000013822,2024-02-11T02:41:34,ACC00006295,ATM,1222.92,-795888.37,JPY,Target
TXN0000013823,2024-07-31T14:20:15,ACC00006968,ATM,262.95,-796151.32,JPY,Starbucks
TXN0000013824,2024-02-19T06:39:51,ACC00008467,Transfer,1028.83,-795122.49,GBP,Restaurant
TXN0000013825,2024-02-13T05:51:14,ACC00006249,ATM,583.96,-795706.45,GBP,Target
TXN0000013826,2024-11-03T22:35:50,ACC00007207,Transfer,1202.51,-794503.94,GBP,Walmart
TXN0000013827,2024-07-19T18:53:10,ACC00000004,ATM,1649.81,-796153.75,GBP,Shell
TXN0000013828,2024-03-26T18:45:43,ACC00007805,Credit,852.25,-795301.5,EUR,Online Store
TXN0000013829,2024-02-18T23:22:03,ACC00000717,Payment,569.87,-795871.37,USD,Restaurant
TXN0000013830,2024-12-24T23:18:48,ACC00006213,Transfer,63.81,-795807.56,USD,Restaurant
TXN0000013831,2024-03-15T04:13:34,ACC00001894,ATM,847.5,-796655.06,USD,Starbucks
TXN0000013832,2024-08-03T17:08:33,ACC00001492,Payment,1085.26,-797740.32,EUR,Grocery
TXN0000013833,2024-12-21T12:48:43,ACC00008615,Credit,1404.82,-796335.5,JPY,Restaurant
TXN0000013834,2024-12-06T17:52:16,ACC00000432,ATM,1790.16,-798125.66,JPY,Walmart
TXN0000013835,2024-07-05T02:12:23,ACC00005427,Payment,1656.17,-799781.83,USD,Restaurant
TXN0000013836,2024-10-28T15:45:15,ACC00009417,ATM,334.7,-800116.53,EUR,Restaurant
TXN0000013837,2024-07-16T01:17:19,ACC00006893,Debit,1369.95,-801486.48,USD,Online Store
TXN0000013838,2024-11-19T22:07:12,ACC00009527,Debit,1450.79,-802937.27,EUR,Walmart
TXN0000013839,2024-05-10T11:54:54,ACC00005319,ATM,1378.56,-804315.83,USD,Online Store
TXN0000013840,2024-08-09T05:52:50,ACC00000773,Transfer,1783.22,-802532.61,JPY,Starbucks
TXN0000013841,2024-04-03T03:55:53,ACC00006815,ATM,1381.27,-803913.88,GBP,Shell
TXN0000013842,2024-11-20T13:47:51,ACC00009134,ATM,776.46,-804690.34,USD,Starbucks
TXN0000013843,2024-08-04T07:29:35,ACC00009048,Debit,1584.54,-806274.88,USD,Restaurant
TXN0000013844,2024-07-21T10:07:13,ACC00009710,ATM,913.1,-807187.98,USD,Restaurant
TXN0000013845,2024-10-26T12:01:21,ACC00007491,Transfer,312.7,-806875.28,GBP,Shell
TXN0000013846,2024-02-22T16:11:24,ACC00002237,Payment,1016.55,-807891.83,USD,Walmart
TXN0000013847,2024-05-11T20:27:05,ACC00008017,Transfer,1053.49,-806838.34,JPY,Restaurant
TXN0000013848,2024-10-04T00:37:53,ACC00007579,Payment,122.92,-806961.26,GBP,Grocery
TXN0000013849,2024-04-05T13:50:00,ACC00002329,Credit,1905.1,-805056.16,GBP,Grocery
TXN0000013850,2024-08-22T16:10:10,ACC00005873,Credit,73.24,-804982.92,EUR,Grocery
TXN0000013851,2024-03-04T09:53:50,ACC00009376,Credit,1169.66,-803813.26,EUR,Shell
TXN0000013852,2024-09-24T14:10:07,ACC00004865,Payment,1391.66,-805204.92,EUR,Walmart
TXN0000013853,2024-01-13T09:00:12,ACC00004460,Credit,1526.9,-803678.02,JPY,Restaurant
TXN0000013854,2024-02-24T19:30:05,ACC00000060,Debit,982.64,-804660.66,GBP,Amazon
TXN0000013855,2024-05-10T14:17:23,ACC00009252,ATM,325.21,-804985.87,EUR,Shell
TXN0000013856,2024-08-18T18:59:56,ACC00009311,Credit,206.42,-804779.45,USD,Online Store
TXN0000013857,2024-10-24T12:26:45,ACC00008173,Payment,1939.88,-806719.33,GBP,Target
TXN0000013858,2024-03-12T12:52:06,ACC00004149,Transfer,1416.58,-805302.75,EUR,Starbucks
TXN0000013859,2024-05-31T23:35:06,ACC00008166,Debit,679.23,-805981.98,USD,Grocery
TXN0000013860,2024-12-09T21:27:56,ACC00009176,Debit,1828.42,-807810.4,EUR,Starbucks
TXN0000013861,2024-08-25T08:26:14,ACC00006940,ATM,1675.31,-809485.71,GBP,Online Store
TXN0000013862,2024-12-26T19:04:46,ACC00003913,Payment,594.33,-810080.04,EUR,Online Store
TXN0000013863,2024-11-25T18:20:11,ACC00003917,Credit,1384.59,-808695.45,JPY,Starbucks
TXN0000013864,2024-09-16T21:47:32,ACC00005908,Payment,1502.91,-810198.36,EUR,Walmart
TXN0000013865,2024-09-02T14:57:00,ACC00003538,Credit,614.81,-809583.55,EUR,Amazon
TXN0000013866,2024-02-15T08:06:17,ACC00004929,ATM,568.89,-810152.44,JPY,Walmart
TXN0000013867,2024-03-14T05:17:21,ACC00008240,Debit,366.05,-810518.49,GBP,Restaurant
TXN0000013868,2024-07-08T14:38:28,ACC00009495,Payment,124.76,-810643.25,GBP,Online Store
TXN0000013869,2024-11-27T16:23:27,ACC00001056,Debit,1040.58,-811683.83,EUR,Starbucks
TXN0000013870,2024-06-16T23:46:07,ACC00004596,Transfer,825.59,-810858.24,USD,Starbucks
TXN0000013871,2024-07-20T11:08:30,ACC00004974,Credit,1723.71,-809134.53,JPY,Target
TXN0000013872,2024-08-20T02:16:33,ACC00005212,Debit,81.73,-809216.26,JPY,Grocery
TXN0000013873,2024-11-11T08:09:13,ACC00002112,Credit,1939.71,-807276.55,JPY,Restaurant
TXN0000013874,2024-07-25T01:07:27,ACC00000677,ATM,370.64,-807647.19,EUR,Shell
TXN0000013875,2024-05-14T01:21:25,ACC00003782,ATM,1975.35,-809622.54,JPY,Starbucks
TXN0000013876,2024-11-01T21:37:53,ACC00009279,ATM,305.76,-809928.3,EUR,Shell
TXN0000013877,2024-04-26T15:40:03,ACC00000796,Transfer,862.41,-809065.89,JPY,Restaurant
TXN0000013878,2024-12-30T19:08:34,ACC00007920,ATM,99.98,-809165.87,GBP,Grocery
TXN0000013879,2024-05-21T01:12:18,ACC00004737,Debit,276.12,-809441.99,EUR,Walmart
TXN0000013880,2024-01-20T06:19:50,ACC00001243,Transfer,1803.45,-807638.54,EUR,Grocery
TXN0000013881,2024-12-12T08:32:42,ACC00000353,ATM,504.5,-808143.04,GBP,Restaurant
TXN0000013882,2024-07-19T03:45:04,ACC00007074,ATM,1858.07,-810001.11,USD,Online Store
TXN0000013883,2024-05-26T07:17:58,ACC00000713,Transfer,1639.06,-808362.05,EUR,Walmart
TXN0000013884,2024-02-09T08:15:31,ACC00002039,Payment,1893.03,-810255.08,USD,Target
TXN0000013885,2024-02-07T18:28:31,ACC00002812,Transfer,905.83,-809349.25,JPY,Target
TXN0000013886,2024-11-26T08:31:03,ACC00004702,Payment,1533.07,-810882.32,EUR,Grocery
TXN0000013887,2024-05-10T19:48:10,ACC00009298,Credit,666.08,-810216.24,USD,Shell
TXN0000013888,2024-08-31T18:07:49,ACC00000485,ATM,250.99,-810467.23,EUR,Starbucks
TXN0000013889,2024-02-26T23:21:07,ACC00005124,ATM,1524.38,-811991.61,EUR,Target
TXN0000013890,2024-09-10T22:20:46,ACC00003923,ATM,1444.86,-813436.47,GBP,Online Store
TXN0000013891,2024-06-01T15:54:41,ACC00004447,Transfer,1739.63,-811696.84,JPY,Target
TXN0000013892,2024-06-25T04:29:07,ACC00009183,Credit,314.85,-811381.99,EUR,Shell
TXN0000013893,2024-06-13T19:18:44,ACC00005442,Credit,344.34,-811037.65,USD,Grocery
TXN0000013894,2024-03-12T09:18:33,ACC00002680,Payment,1092.99,-812130.64,USD,Grocery
TXN0000013895,2024-04-08T02:29:11,ACC00009600,Payment,1206.67,-813337.31,JPY,Target
TXN0000013896,2024-03-10T05:17:37,ACC00008932,Transfer,1805.92,-811531.39,GBP,Grocery
TXN0000013897,2024-09-16T15:27:25,ACC00002895,ATM,376.36,-811907.75,GBP,Walmart
TXN0000013898,2024-05-28T13:21:50,ACC00007912,Credit,382.3,-811525.45,USD,Target
TXN0000013899,2024-05-03T13:24:30,ACC00002474,ATM,1139.94,-812665.39,USD,Grocery
TXN0000013900,2024-01-13T08:42:37,ACC00006246,Payment,948.58,-813613.97,EUR,Shell
TXN0000013901,2024-02-20T01:45:38,ACC00005275,Payment,876.56,-814490.53,GBP,Amazon
TXN0000013902,2024-04-20T22:37:09,ACC00002578,Debit,1838.45,-816328.98,USD,Walmart
TXN0000013903,2024-01-21T18:40:53,ACC00009475,Transfer,1366.03,-814962.95,JPY,Restaurant
TXN0000013904,2024-02-23T16:27:36,ACC00002839,Payment,231.1,-815194.05,EUR,Shell
TXN0000013905,2024-12-04T03:41:36,ACC00005102,Payment,874.85,-816068.9,USD,Online Store
TXN0000013906,2024-08-14T03:21:24,ACC00004551,Debit,251.43,-816320.33,GBP,Grocery
TXN0000013907,2024-12-25T06:55:19,ACC00005091,Payment,1508.45,-817828.78,GBP,Shell
TXN0000013908,2024-02-16T23:49:44,ACC00002263,ATM,1494.02,-819322.8,GBP,Target
TXN0000013909,2024-07-09T16:51:41,ACC00007035,Debit,564.43,-819887.23,GBP,Online Store
TXN0000013910,2024-05-29T01:02:38,ACC00005106,Debit,1972.62,-821859.85,USD,Online Store
TXN0000013911,2024-12-11T04:32:44,ACC00000806,ATM,1365.66,-823225.51,JPY,Starbucks
TXN0000013912,2024-09-21T14:39:13,ACC00004982,Transfer,1140.76,-822084.75,EUR,Shell
TXN0000013913,2024-04-06T07:42:39,ACC00005596,ATM,156.45,-822241.2,JPY,Starbucks
TXN0000013914,2024-04-18T23:28:13,ACC00008662,Payment,168.76,-822409.96,EUR,Shell
TXN0000013915,2024-08-15T13:40:52,ACC00007034,Transfer,530.85,-821879.11,GBP,Walmart
TXN0000013916,2024-08-26T15:47:40,ACC00000565,Transfer,171.78,-821707.33,JPY,Starbucks
TXN0000013917,2024-07-28T04:49:08,ACC00001935,Transfer,1498.08,-820209.25,JPY,Walmart
TXN0000013918,2024-12-02T16:48:26,ACC00001462,Credit,418.31,-819790.94,GBP,Amazon
TXN0000013919,2024-03-03T16:28:20,ACC00000753,Payment,1332.17,-821123.11,USD,Online Store
TXN0000013920,2024-07-29T17:59:33,ACC00003428,Payment,1456.39,-822579.5,JPY,Grocery
TXN0000013921,2024-03-08T02:23:37,ACC00009287,Credit,1126.04,-821453.46,JPY,Amazon
TXN0000013922,2024-01-08T04:53:02,ACC00004971,ATM,904.86,-822358.32,USD,Walmart
TXN0000013923,2024-03-13T18:48:43,ACC00008586,Debit,353.47,-822711.79,GBP,Amazon
TXN0000013924,2024-06-24T10:57:29,ACC00005256,Debit,1200.73,-823912.52,EUR,Online Store
TXN0000013925,2024-06-13T00:08:57,ACC00000333,Payment,1031.24,-824943.76,GBP,Target
TXN0000013926,2024-08-23T00:32:26,ACC00009537,Payment,868.94,-825812.7,JPY,Grocery
TXN0000013927,2024-10-27T14:12:12,ACC00001739,Payment,1183.23,-826995.93,JPY,Shell
TXN0000013928,2024-08-25T15:02:03,ACC00008122,ATM,563.66,-827559.59,USD,Restaurant
TXN0000013929,2024-10-20T03:18:06,ACC00003566,Debit,1133.79,-828693.38,EUR,Online Store
TXN0000013930,2024-04-26T04:59:14,ACC00009009,Payment,257.2,-828950.58,EUR,Shell
TXN0000013931,2024-10-26T12:50:25,ACC00000558,Debit,300.1,-829250.68,EUR,Online Store
TXN0000013932,2024-12-09T22:04:11,ACC00006231,Debit,128.76,-829379.44,USD,Walmart
TXN0000013933,2024-10-31T14:55:36,ACC00003671,Transfer,881.07,-828498.37,JPY,Starbucks
TXN0000013934,2024-01-28T18:33:56,ACC00003459,Transfer,1694.72,-826803.65,JPY,Online Store
TXN0000013935,2024-09-01T14:01:41,ACC00001201,ATM,1023.53,-827827.18,JPY,Amazon
TXN0000013936,2024-09-14T18:20:23,ACC00006845,Credit,383.0,-827444.18,GBP,Grocery
TXN0000013937,2024-04-02T13:36:05,ACC00002701,Debit,423.43,-827867.61,GBP,Amazon
TXN0000013938,2024-04-19T05:14:53,ACC00009741,ATM,22.85,-827890.46,EUR,Starbucks
TXN0000013939,2024-04-19T11:18:55,ACC00002724,Credit,1226.45,-826664.01,JPY,Target
TXN0000013940,2024-06-17T10:09:50,ACC00007446,Credit,1506.81,-825157.2,JPY,Starbucks
TXN0000013941,2024-11-22T05:01:19,ACC00009694,Payment,706.48,-825863.68,USD,Online Store
TXN0000013942,2024-05-13T20:11:52,ACC00008732,Debit,464.45,-826328.13,USD,Grocery
TXN0000013943,2024-07-17T22:03:50,ACC00008893,Transfer,1019.64,-825308.49,EUR,Target
TXN0000013944,2024-02-20T17:17:23,ACC00005803,Transfer,973.45,-824335.04,JPY,Target
TXN0000013945,2024-12-25T07:06:27,ACC00007604,Transfer,1670.02,-822665.02,JPY,Walmart
TXN0000013946,2024-04-16T14:22:53,ACC00009060,Transfer,149.87,-822515.15,USD,Walmart
TXN0000013947,2024-11-13T22:10:53,ACC00007061,Credit,839.03,-821676.12,EUR,Online Store
TXN0000013948,2024-09-17T02:26:22,ACC00000737,ATM,1416.07,-823092.19,EUR,Walmart
TXN0000013949,2024-10-02T01:03:24,ACC00004372,Credit,124.51,-822967.68,USD,Target
TXN0000013950,2024-12-01T19:59:59,ACC00003899,Credit,1443.44,-821524.24,GBP,Starbucks
TXN0000013951,2024-07-04T02:26:24,ACC00008999,Credit,848.56,-820675.68,GBP,Starbucks
TXN0000013952,2024-03-27T14:22:03,ACC00002300,Debit,824.98,-821500.66,JPY,Restaurant
TXN0000013953,2024-10-16T05:02:10,ACC00005464,Debit,717.08,-822217.74,JPY,Amazon
TXN0000013954,2024-09-07T00:48:50,ACC00001740,Debit,426.61,-822644.35,USD,Shell
TXN0000013955,2024-09-13T07:15:12,ACC00002002,ATM,97.3,-822741.65,USD,Grocery
TXN0000013956,2024-07-14T00:51:32,ACC00004765,Payment,1673.21,-824414.86,EUR,Grocery
TXN0000013957,2024-06-14T00:42:46,ACC00006031,Transfer,584.27,-823830.59,EUR,Target
TXN0000013958,2024-01-24T07:37:22,ACC00002744,Payment,1735.85,-825566.44,USD,Shell
TXN0000013959,2024-10-10T05:35:36,ACC00008763,ATM,1567.67,-827134.11,JPY,Grocery
TXN0000013960,2024-02-19T15:56:21,ACC00001035,ATM,910.22,-828044.33,GBP,Online Store
TXN0000013961,2024-05-31T16:31:40,ACC00009992,Debit,1933.04,-829977.37,GBP,Online Store
TXN0000013962,2024-10-14T18:05:45,ACC00009876,Transfer,636.48,-829340.89,GBP,Shell
TXN0000013963,2024-06-25T14:53:42,ACC00008319,Transfer,166.49,-829174.4,GBP,Shell
TXN0000013964,2024-09-21T10:11:04,ACC00009206,Transfer,29.89,-829144.51,JPY,Restaurant
TXN0000013965,2024-07-05T08:09:02,ACC00002090,Debit,830.22,-829974.73,JPY,Online Store
TXN0000013966,2024-08-16T18:05:02,ACC00006147,Credit,455.81,-829518.92,GBP,Walmart
TXN0000013967,2024-11-20T11:50:32,ACC00000100,Transfer,699.03,-828819.89,EUR,Starbucks
TXN0000013968,2024-07-22T11:28:58,ACC00000601,Credit,145.34,-828674.55,GBP,Restaurant
TXN0000013969,2024-09-07T17:08:45,ACC00000743,Debit,53.66,-828728.21,USD,Restaurant
TXN0000013970,2024-02-05T08:58:58,ACC00007410,Credit,1609.19,-827119.02,USD,Walmart
TXN0000013971,2024-01-31T21:31:23,ACC00001092,Credit,1091.58,-826027.44,JPY,Walmart
TXN0000013972,2024-12-27T06:13:37,ACC00004649,Payment,1344.82,-827372.26,EUR,Online Store
TXN0000013973,2024-11-11T04:49:18,ACC00004727,ATM,830.39,-828202.65,JPY,Online Store
TXN0000013974,2024-04-13T15:22:29,ACC00004697,ATM,1450.04,-829652.69,GBP,Restaurant
TXN0000013975,2024-01-27T16:36:48,ACC00008995,Payment,1411.27,-831063.96,GBP,Shell
TXN0000013976,2024-02-29T09:13:59,ACC00006740,ATM,1176.96,-832240.92,GBP,Starbucks
TXN0000013977,2024-05-22T18:06:35,ACC00003177,ATM,186.29,-832427.21,EUR,Target
TXN0000013978,2024-10-29T03:29:24,ACC00007266,Transfer,875.87,-831551.34,USD,Walmart
TXN0000013979,2024-12-27T17:18:08,ACC00000087,Credit,1562.74,-829988.6,EUR,Starbucks
TXN0000013980,2024-11-01T08:33:14,ACC00004027,ATM,537.86,-830526.46,JPY,Restaurant
TXN0000013981,2024-08-28T01:22:46,ACC00005630,Debit,1112.6,-831639.06,JPY,Walmart
TXN0000013982,2024-10-08T19:29:25,ACC00009734,Debit,1455.22,-833094.28,JPY,Target
TXN0000013983,2024-03-30T10:50:48,ACC00002867,Transfer,57.37,-833036.91,GBP,Shell
TXN0000013984,2024-10-02T21:27:47,ACC00006472,Credit,1895.03,-831141.88,GBP,Walmart
TXN0000013985,2024-04-20T11:39:26,ACC00001525,Transfer,1347.05,-829794.83,EUR,Shell
TXN0000013986,2024-09-05T08:11:11,ACC00001270,Payment,1184.04,-830978.87,EUR,Starbucks
TXN0000013987,2024-01-14T02:48:07,ACC00007486,Credit,1253.36,-829725.51,USD,Amazon
TXN0000013988,2024-04-08T19:00:54,ACC00000572,Transfer,332.86,-829392.65,GBP,Target
TXN0000013989,2024-10-23T11:55:18,ACC00004695,Transfer,1742.43,-827650.22,GBP,Restaurant
TXN0000013990,2024-07-12T17:59:59,ACC00009666,Transfer,146.18,-827504.04,GBP,Target
TXN0000013991,2024-10-21T08:14:51,ACC00008006,Debit,1140.42,-828644.46,JPY,Amazon
TXN0000013992,2024-11-10T15:06:51,ACC00005790,Transfer,322.35,-828322.11,USD,Walmart
TXN0000013993,2024-02-27T13:57:59,ACC00009585,Payment,874.09,-829196.2,JPY,Restaurant
TXN0000013994,2024-03-26T17:22:09,ACC00004848,Debit,437.15,-829633.35,JPY,Target
TXN0000013995,2024-09-06T11:08:56,ACC00008743,ATM,595.63,-830228.98,EUR,Restaurant
TXN0000013996,2024-11-02T00:08:48,ACC00000474,Payment,865.62,-831094.6,GBP,Grocery
TXN0000013997,2024-01-30T12:03:15,ACC00004851,Credit,215.81,-830878.79,GBP,Starbucks
TXN0000013998,2024-06-30T20:18:04,ACC00008923,Transfer,1341.55,-829537.24,EUR,Grocery
TXN0000013999,2024-01-14T11:08:38,ACC00007183,Transfer,440.07,-829097.17,USD,Starbucks
TXN0000014000,2024-04-11T21:42:27,ACC00006247,Transfer,1663.0,-827434.17,JPY,Amazon
TXN0000014001,2024-01-17T23:05:06,ACC00003073,Payment,1118.81,-828552.98,USD,Online Store
TXN0000014002,2024-04-10T17:11:39,ACC00009048,Debit,1913.03,-830466.01,JPY,Walmart
TXN0000014003,2024-05-16T00:42:45,ACC00002076,Payment,665.96,-831131.97,EUR,Amazon
TXN0000014004,2024-09-21T22:16:38,ACC00004958,Credit,46.14,-831085.83,EUR,Target
TXN0000014005,2024-10-03T18:11:37,ACC00000748,Credit,1119.29,-829966.54,EUR,Starbucks
TXN0000014006,2024-02-18T02:00:01,ACC00003344,Payment,289.05,-830255.59,GBP,Amazon
TXN0000014007,2024-09-21T23:37:36,ACC00005133,Credit,1585.71,-828669.88,JPY,Target
TXN0000014008,2024-01-08T06:04:23,ACC00008815,Debit,1333.82,-830003.7,EUR,Target
TXN0000014009,2024-05-20T00:44:11,ACC00005197,Credit,1210.76,-828792.94,USD,Starbucks
TXN0000014010,2024-04-17T13:29:42,ACC00006133,ATM,957.47,-829750.41,USD,Shell
TXN0000014011,2024-10-05T14:26:39,ACC00006870,Credit,1771.61,-827978.8,USD,Starbucks
TXN0000014012,2024-07-11T09:55:28,ACC00005246,ATM,1341.3,-829320.1,GBP,Grocery
TXN0000014013,2024-08-25T06:11:44,ACC00000148,Credit,1596.52,-827723.58,EUR,Shell
TXN0000014014,2024-11-14T10:25:00,ACC00006478,Payment,371.69,-828095.27,EUR,Online Store
TXN0000014015,2024-12-23T07:48:59,ACC00006236,Transfer,92.95,-828002.32,GBP,Grocery
TXN0000014016,2024-02-05T22:20:21,ACC00005681,Transfer,308.28,-827694.04,USD,Target
TXN0000014017,2024-04-03T13:41:48,ACC00006255,Transfer,1956.29,-825737.75,EUR,Online Store
TXN0000014018,2024-02-20T08:42:19,ACC00005714,Transfer,1854.75,-823883.0,EUR,Walmart
TXN0000014019,2024-08-21T04:21:16,ACC00009038,Payment,847.61,-824730.61,USD,Walmart
TXN0000014020,2024-05-05T07:07:57,ACC00001749,Payment,1180.78,-825911.39,EUR,Starbucks
TXN0000014021,2024-02-02T00:44:35,ACC00003032,Debit,174.37,-826085.76,GBP,Amazon
TXN0000014022,2024-03-30T00:09:31,ACC00009781,Credit,1969.94,-824115.82,EUR,Amazon
TXN0000014023,2024-04-21T04:28:42,ACC00007706,Transfer,730.69,-823385.13,GBP,Shell
TXN0000014024,2024-06-17T16:29:14,ACC00006244,ATM,1703.98,-825089.11,USD,Restaurant
TXN0000014025,2024-01-04T01:33:41,ACC00002394,Transfer,1734.97,-823354.14,GBP,Amazon
TXN0000014026,2024-09-06T02:32:33,ACC00006535,Transfer,1760.19,-821593.95,JPY,Shell
TXN0000014027,2024-07-17T02:27:20,ACC00001097,Credit,1340.9,-820253.05,EUR,Restaurant
TXN0000014028,2024-09-01T17:09:17,ACC00005785,Transfer,196.45,-820056.6,GBP,Walmart
TXN0000014029,2024-05-12T14:04:32,ACC00008352,ATM,1142.92,-821199.52,EUR,Target
TXN0000014030,2024-06-03T06:25:11,ACC00007899,ATM,1964.25,-823163.77,GBP,Grocery
TXN0000014031,2024-07-15T07:11:26,ACC00001669,ATM,216.54,-823380.31,USD,Grocery
TXN0000014032,2024-06-17T10:27:41,ACC00004351,Transfer,225.5,-823154.81,USD,Shell
TXN0000014033,2024-05-27T08:22:07,ACC00004402,Debit,35.8,-823190.61,GBP,Walmart
TXN0000014034,2024-02-17T10:33:38,ACC00002526,Credit,1987.45,-821203.16,EUR,Target
TXN0000014035,2024-07-16T16:54:22,ACC00001605,ATM,156.47,-821359.63,USD,Restaurant
TXN0000014036,2024-01-14T23:09:36,ACC00003880,Debit,266.09,-821625.72,EUR,Amazon
TXN0000014037,2024-08-09T09:56:51,ACC00004290,Transfer,304.96,-821320.76,USD,Online Store
TXN0000014038,2024-03-22T20:00:50,ACC00009832,Transfer,882.37,-820438.39,EUR,Grocery
TXN0000014039,2024-06-03T12:52:46,ACC00006179,Credit,602.72,-819835.67,USD,Target
TXN0000014040,2024-04-06T20:46:30,ACC00005049,ATM,870.5,-820706.17,USD,Grocery
TXN0000014041,2024-09-06T04:13:26,ACC00008166,Payment,564.52,-821270.69,GBP,Starbucks
TXN0000014042,2024-05-23T02:06:01,ACC00004728,Debit,1598.81,-822869.5,USD,Restaurant
TXN0000014043,2024-05-01T11:59:06,ACC00008498,Debit,1920.45,-824789.95,JPY,Walmart
TXN0000014044,2024-11-08T10:09:30,ACC00008305,ATM,1278.53,-826068.48,GBP,Online Store
TXN0000014045,2024-11-21T01:47:03,ACC00007756,Transfer,803.13,-825265.35,USD,Grocery
TXN0000014046,2024-12-10T17:27:35,ACC00004108,Payment,1592.42,-826857.77,USD,Walmart
TXN0000014047,2024-02-29T12:07:52,ACC00009593,Debit,399.28,-827257.05,USD,Shell
TXN0000014048,2024-03-01T19:42:20,ACC00007341,Transfer,80.64,-827176.41,GBP,Target
TXN0000014049,2024-10-24T11:16:57,ACC00009744,ATM,850.53,-828026.94,USD,Grocery
TXN0000014050,2024-12-28T08:54:05,ACC00004072,Debit,1346.78,-829373.72,JPY,Restaurant
TXN0000014051,2024-12-18T23:13:28,ACC00002454,Payment,1422.78,-830796.5,GBP,Walmart
TXN0000014052,2024-03-04T23:02:08,ACC00005476,ATM,1903.41,-832699.91,GBP,Shell
TXN0000014053,2024-03-17T10:40:26,ACC00008945,Payment,1904.55,-834604.46,EUR,Shell
TXN0000014054,2024-09-22T16:19:44,ACC00000031,Payment,1554.95,-836159.41,EUR,Starbucks
TXN0000014055,2024-04-11T14:29:08,ACC00009053,Payment,1771.46,-837930.87,USD,Online Store
TXN0000014056,2024-11-29T08:04:34,ACC00003729,Payment,1001.48,-838932.35,JPY,Restaurant
TXN0000014057,2024-04-29T03:23:50,ACC00009033,Debit,1769.65,-840702.0,JPY,Grocery
TXN0000014058,2024-12-24T14:54:33,ACC00004788,Transfer,730.63,-839971.37,JPY,Target
TXN0000014059,2024-12-26T03:45:13,ACC00000800,Payment,1173.38,-841144.75,EUR,Grocery
TXN0000014060,2024-03-21T15:27:46,ACC00005449,Credit,518.08,-840626.67,JPY,Starbucks
TXN0000014061,2024-12-25T18:25:59,ACC00009233,Debit,945.27,-841571.94,GBP,Restaurant
TXN0000014062,2024-06-25T02:29:49,ACC00006580,Transfer,870.41,-840701.53,JPY,Restaurant
TXN0000014063,2024-10-05T23:46:39,ACC00006224,Debit,1974.1,-842675.63,USD,Grocery
TXN0000014064,2024-11-13T14:12:27,ACC00009282,Transfer,84.08,-842591.55,USD,Online Store
TXN0000014065,2024-08-14T03:38:13,ACC00008471,Transfer,362.36,-842229.19,USD,Restaurant
TXN0000014066,2024-03-27T23:45:55,ACC00002545,ATM,1741.83,-843971.02,JPY,Restaurant
TXN0000014067,2024-03-18T03:37:15,ACC00008279,Transfer,1042.93,-842928.09,GBP,Shell
TXN0000014068,2024-11-01T19:51:20,ACC00001325,Credit,323.89,-842604.2,EUR,Restaurant
TXN0000014069,2024-02-14T12:54:54,ACC00001412,ATM,645.63,-843249.83,EUR,Starbucks
TXN0000014070,2024-05-23T23:22:46,ACC00005194,Transfer,1947.73,-841302.1,GBP,Walmart
TXN0000014071,2024-10-08T08:36:59,ACC00002227,Payment,1543.39,-842845.49,EUR,Online Store
TXN0000014072,2024-05-28T12:35:10,ACC00002209,Payment,1044.12,-843889.61,USD,Starbucks
TXN0000014073,2024-09-11T21:45:43,ACC00004539,Credit,311.75,-843577.86,USD,Walmart
TXN0000014074,2024-12-26T08:10:57,ACC00006665,Debit,258.16,-843836.02,GBP,Grocery
TXN0000014075,2024-10-30T12:40:28,ACC00000706,Credit,380.9,-843455.12,JPY,Online Store
TXN0000014076,2024-08-29T04:06:05,ACC00009815,ATM,367.66,-843822.78,JPY,Target
TXN0000014077,2024-12-19T21:08:18,ACC00003141,ATM,583.21,-844405.99,USD,Starbucks
TXN0000014078,2024-09-26T13:43:15,ACC00008421,Credit,1700.35,-842705.64,JPY,Walmart
TXN0000014079,2024-07-23T11:15:27,ACC00001118,ATM,503.91,-843209.55,GBP,Shell
TXN0000014080,2024-02-10T20:35:13,ACC00002024,Credit,1926.5,-841283.05,EUR,Restaurant
TXN0000014081,2024-06-04T11:44:29,ACC00007366,ATM,1360.57,-842643.62,EUR,Amazon
TXN0000014082,2024-07-09T21:50:52,ACC00002800,ATM,1865.83,-844509.45,EUR,Grocery
TXN0000014083,2024-10-10T02:26:53,ACC00000787,Transfer,807.69,-843701.76,USD,Amazon
TXN0000014084,2024-01-09T16:48:48,ACC00004393,Credit,550.17,-843151.59,GBP,Shell
TXN0000014085,2024-02-06T12:15:56,ACC00008710,Credit,124.51,-843027.08,JPY,Grocery
TXN0000014086,2024-12-13T06:03:51,ACC00008887,ATM,1251.27,-844278.35,JPY,Walmart
TXN0000014087,2024-04-22T08:59:49,ACC00002467,Transfer,1632.76,-842645.59,USD,Restaurant
TXN0000014088,2024-07-09T16:42:47,ACC00003591,Credit,842.71,-841802.88,EUR,Amazon
TXN0000014089,2024-02-29T05:05:09,ACC00000939,Payment,136.17,-841939.05,EUR,Amazon
TXN0000014090,2024-02-25T01:54:26,ACC00000564,Credit,141.53,-841797.52,EUR,Amazon
TXN0000014091,2024-10-02T18:06:43,ACC00001328,ATM,1585.43,-843382.95,GBP,Target
TXN0000014092,2024-03-31T09:47:17,ACC00007635,Payment,74.35,-843457.3,USD,Starbucks
TXN0000014093,2024-07-26T15:15:40,ACC00002403,Credit,350.8,-843106.5,JPY,Starbucks
TXN0000014094,2024-01-28T14:49:37,ACC00000801,Transfer,466.63,-842639.87,USD,Restaurant
TXN0000014095,2024-05-29T04:14:36,ACC00003554,Debit,505.24,-843145.11,JPY,Online Store
TXN0000014096,2024-07-27T14:22:01,ACC00006737,Payment,1270.22,-844415.33,EUR,Shell
TXN0000014097,2024-03-19T15:10:16,ACC00002056,Credit,1558.35,-842856.98,GBP,Shell
TXN0000014098,2024-11-01T16:57:35,ACC00003776,Debit,1012.34,-843869.32,EUR,Walmart
TXN0000014099,2024-04-07T09:50:00,ACC00007974,Debit,1637.27,-845506.59,GBP,Restaurant
TXN0000014100,2024-11-22T18:15:52,ACC00009171,Credit,133.3,-845373.29,USD,Target
TXN0000014101,2024-12-24T03:13:29,ACC00007716,Payment,915.88,-846289.17,USD,Restaurant
TXN0000014102,2024-02-04T17:48:18,ACC00002800,Credit,200.55,-846088.62,EUR,Starbucks
TXN0000014103,2024-09-23T00:35:46,ACC00007892,ATM,587.12,-846675.74,EUR,Amazon
TXN0000014104,2024-05-12T21:13:18,ACC00004928,ATM,1262.55,-847938.29,JPY,Online Store
TXN0000014105,2024-08-23T08:39:37,ACC00001934,Payment,1561.74,-849500.03,EUR,Restaurant
TXN0000014106,2024-12-30T02:44:01,ACC00006088,Debit,967.03,-850467.06,EUR,Target
TXN0000014107,2024-12-13T07:46:34,ACC00006876,Transfer,856.75,-849610.31,JPY,Amazon
TXN0000014108,2024-03-17T00:27:13,ACC00000834,Credit,391.22,-849219.09,JPY,Grocery
TXN0000014109,2024-01-15T02:51:49,ACC00009841,ATM,495.89,-849714.98,GBP,Shell
TXN0000014110,2024-09-02T19:48:55,ACC00005326,Payment,1997.5,-851712.48,GBP,Online Store
TXN0000014111,2024-10-24T21:38:56,ACC00004122,Debit,954.25,-852666.73,JPY,Restaurant
TXN0000014112,2024-07-24T22:32:08,ACC00005522,ATM,1974.41,-854641.14,USD,Starbucks
TXN0000014113,2024-06-08T07:44:41,ACC00008681,ATM,876.26,-855517.4,JPY,Amazon
TXN0000014114,2024-01-28T23:00:20,ACC00008514,Payment,1121.68,-856639.08,GBP,Restaurant
TXN0000014115,2024-08-19T05:39:00,ACC00004656,Transfer,1070.92,-855568.16,GBP,Walmart
TXN0000014116,2024-03-05T14:05:50,ACC00002813,Credit,27.65,-855540.51,JPY,Online Store
TXN0000014117,2024-10-12T02:07:25,ACC00006293,Payment,1280.57,-856821.08,JPY,Amazon
TXN0000014118,2024-08-02T05:07:49,ACC00000277,Debit,370.49,-857191.57,GBP,Amazon
TXN0000014119,2024-01-19T08:09:22,ACC00003703,Credit,1278.21,-855913.36,USD,Online Store
TXN0000014120,2024-06-04T11:35:43,ACC00003343,ATM,1093.46,-857006.82,GBP,Walmart
TXN0000014121,2024-05-23T21:20:59,ACC00002804,Transfer,1161.98,-855844.84,EUR,Online Store
TXN0000014122,2024-01-03T23:23:23,ACC00004409,Debit,1869.19,-857714.03,GBP,Starbucks
TXN0000014123,2024-05-19T02:08:55,ACC00003030,ATM,887.61,-858601.64,GBP,Restaurant
TXN0000014124,2024-05-18T08:16:39,ACC00001829,Debit,535.1,-859136.74,JPY,Online Store
TXN0000014125,2024-07-24T01:01:51,ACC00005472,Transfer,462.15,-858674.59,JPY,Target
TXN0000014126,2024-08-27T12:11:53,ACC00001942,Transfer,237.48,-858437.11,GBP,Shell
TXN0000014127,2024-11-13T04:00:32,ACC00006463,Debit,364.03,-858801.14,USD,Starbucks
TXN0000014128,2024-01-16T20:08:56,ACC00000530,Payment,570.41,-859371.55,GBP,Shell
TXN0000014129,2024-07-13T11:31:33,ACC00008027,Transfer,785.41,-858586.14,USD,Restaurant
TXN0000014130,2024-03-19T22:39:03,ACC00000728,Payment,1027.15,-859613.29,EUR,Starbucks
TXN0000014131,2024-10-09T02:56:46,ACC00000650,Transfer,1900.48,-857712.81,JPY,Starbucks
TXN0000014132,2024-09-13T14:15:07,ACC00002578,Debit,1003.12,-858715.93,EUR,Starbucks
TXN0000014133,2024-10-04T08:19:24,ACC00005237,ATM,1487.07,-860203.0,USD,Grocery
TXN0000014134,2024-12-02T01:15:03,ACC00009459,Payment,237.59,-860440.59,USD,Grocery
TXN0000014135,2024-02-11T11:38:57,ACC00001202,Transfer,1290.97,-859149.62,EUR,Restaurant
TXN0000014136,2024-12-03T06:30:50,ACC00004782,Transfer,112.53,-859037.09,EUR,Walmart
TXN0000014137,2024-11-15T03:41:51,ACC00008579,Debit,1686.9,-860723.99,GBP,Grocery
TXN0000014138,2024-02-01T12:29:04,ACC00003272,Credit,1517.69,-859206.3,USD,Starbucks
TXN0000014139,2024-11-23T23:02:25,ACC00006188,Transfer,1170.33,-858035.97,EUR,Amazon
TXN0000014140,2024-07-14T08:06:05,ACC00009555,Debit,1483.61,-859519.58,EUR,Starbucks
TXN0000014141,2024-07-27T23:46:53,ACC00004210,ATM,1890.13,-861409.71,JPY,Restaurant
TXN0000014142,2024-10-09T11:33:43,ACC00003543,Debit,1006.85,-862416.56,USD,Restaurant
TXN0000014143,2024-04-30T20:20:56,ACC00008243,Payment,145.92,-862562.48,EUR,Walmart
TXN0000014144,2024-01-29T20:26:05,ACC00008670,Payment,1597.04,-864159.52,GBP,Target
TXN0000014145,2024-02-01T07:29:46,ACC00003448,Transfer,261.91,-863897.61,USD,Grocery
TXN0000014146,2024-04-26T05:46:33,ACC00000015,Credit,1541.28,-862356.33,USD,Online Store
TXN0000014147,2024-09-23T23:27:00,ACC00009675,Transfer,1155.97,-861200.36,JPY,Target
TXN0000014148,2024-06-26T10:41:18,ACC00001943,Credit,1064.66,-860135.7,USD,Grocery
TXN0000014149,2024-05-29T10:14:32,ACC00006001,Transfer,1818.47,-858317.23,JPY,Target
TXN0000014150,2024-04-22T05:41:30,ACC00007213,Payment,306.34,-858623.57,JPY,Grocery
TXN0000014151,2024-11-11T20:06:40,ACC00003232,ATM,1885.77,-860509.34,JPY,Online Store
TXN0000014152,2024-06-24T01:45:42,ACC00009712,Credit,941.68,-859567.66,USD,Amazon
TXN0000014153,2024-02-25T22:26:28,ACC00007406,Payment,1090.19,-860657.85,EUR,Starbucks
TXN0000014154,2024-03-24T04:15:47,ACC00006960,Transfer,1958.87,-858698.98,EUR,Online Store
TXN0000014155,2024-12-17T06:45:27,ACC00003198,Debit,967.02,-859666.0,USD,Restaurant
TXN0000014156,2024-05-24T01:00:18,ACC00001116,Transfer,408.04,-859257.96,USD,Grocery
TXN0000014157,2024-07-17T15:10:27,ACC00009212,Credit,900.95,-858357.01,JPY,Amazon
TXN0000014158,2024-03-09T04:33:10,ACC00000810,Transfer,1355.65,-857001.36,GBP,Walmart
TXN0000014159,2024-04-19T09:52:49,ACC00007940,Credit,1967.35,-855034.01,JPY,Online Store
TXN0000014160,2024-09-13T23:23:33,ACC00006087,ATM,746.31,-855780.32,USD,Grocery
TXN0000014161,2024-01-11T04:49:44,ACC00007895,Payment,1187.19,-856967.51,USD,Shell
TXN0000014162,2024-07-31T12:22:02,ACC00001189,Debit,1018.25,-857985.76,USD,Restaurant
TXN0000014163,2024-09-30T03:16:19,ACC00002408,Credit,409.72,-857576.04,JPY,Amazon
TXN0000014164,2024-01-31T15:07:27,ACC00008577,Credit,1070.64,-856505.4,EUR,Walmart
TXN0000014165,2024-12-28T17:41:15,ACC00007772,Debit,236.67,-856742.07,USD,Starbucks
TXN0000014166,2024-07-28T14:48:08,ACC00003986,Transfer,1779.89,-854962.18,GBP,Walmart
TXN0000014167,2024-01-02T16:33:27,ACC00007209,Payment,1555.48,-856517.66,EUR,Restaurant
TXN0000014168,2024-04-27T20:40:52,ACC00001382,ATM,1545.26,-858062.92,GBP,Online Store
TXN0000014169,2024-05-21T15:28:43,ACC00001461,Debit,1359.95,-859422.87,USD,Target
TXN0000014170,2024-12-04T05:17:13,ACC00003886,Credit,1551.87,-857871.0,USD,Walmart
TXN0000014171,2024-12-14T20:03:07,ACC00002291,Credit,131.2,-857739.8,EUR,Walmart
TXN0000014172,2024-12-04T18:19:31,ACC00002152,ATM,1186.97,-858926.77,USD,Starbucks
TXN0000014173,2024-04-10T23:42:50,ACC00005571,Transfer,1376.85,-857549.92,JPY,Shell
TXN0000014174,2024-03-22T00:28:29,ACC00005298,Credit,285.17,-857264.75,JPY,Target
TXN0000014175,2024-02-13T14:04:45,ACC00009882,ATM,321.39,-857586.14,USD,Target
TXN0000014176,2024-02-25T02:18:09,ACC00005782,Payment,1796.62,-859382.76,GBP,Starbucks
TXN0000014177,2024-10-26T10:28:37,ACC00008005,Debit,1957.12,-861339.88,EUR,Restaurant
TXN0000014178,2024-03-01T11:36:47,ACC00007213,Credit,1257.97,-860081.91,EUR,Target
TXN0000014179,2024-03-08T03:50:06,ACC00005224,Transfer,1725.95,-858355.96,EUR,Walmart
TXN0000014180,2024-09-26T14:22:26,ACC00005701,Transfer,1584.95,-856771.01,GBP,Target
TXN0000014181,2024-07-22T12:55:19,ACC00003825,Transfer,700.16,-856070.85,EUR,Walmart
TXN0000014182,2024-08-02T15:05:35,ACC00009275,Credit,392.03,-855678.82,JPY,Walmart
TXN0000014183,2024-03-25T00:21:16,ACC00001894,Credit,1417.23,-854261.59,USD,Walmart
TXN0000014184,2024-02-02T03:01:32,ACC00002818,Transfer,370.52,-853891.07,USD,Amazon
TXN0000014185,2024-08-04T15:41:41,ACC00002122,Transfer,252.83,-853638.24,EUR,Amazon
TXN0000014186,2024-07-20T03:36:26,ACC00009258,Payment,371.68,-854009.92,GBP,Shell
TXN0000014187,2024-12-25T20:49:59,ACC00004457,Debit,949.93,-854959.85,USD,Amazon
TXN0000014188,2024-07-21T18:41:02,ACC00008960,Debit,946.09,-855905.94,EUR,Target
TXN0000014189,2024-08-28T08:35:21,ACC00000887,Payment,1531.1,-857437.04,JPY,Amazon
TXN0000014190,2024-11-27T23:43:23,ACC00001508,Debit,1236.92,-858673.96,EUR,Restaurant
TXN0000014191,2024-11-06T08:35:29,ACC00004950,Credit,666.86,-858007.1,USD,Grocery
TXN0000014192,2024-12-01T22:42:42,ACC00004105,ATM,1094.86,-859101.96,GBP,Target
TXN0000014193,2024-10-30T11:37:11,ACC00002788,ATM,1073.73,-860175.69,GBP,Starbucks
TXN0000014194,2024-06-16T22:54:49,ACC00002056,Debit,85.02,-860260.71,GBP,Shell
TXN0000014195,2024-04-06T12:29:07,ACC00006654,Payment,357.49,-860618.2,USD,Amazon
TXN0000014196,2024-12-23T07:17:41,ACC00008748,Transfer,600.69,-860017.51,USD,Starbucks
TXN0000014197,2024-04-28T22:10:11,ACC00003543,ATM,891.57,-860909.08,USD,Amazon
TXN0000014198,2024-09-17T04:21:29,ACC00003671,Debit,777.28,-861686.36,GBP,Grocery
TXN0000014199,2024-06-17T04:54:11,ACC00007195,Credit,1843.21,-859843.15,USD,Online Store
TXN0000014200,2024-11-20T10:42:03,ACC00003381,Transfer,91.11,-859752.04,EUR,Walmart
TXN0000014201,2024-01-25T04:46:35,ACC00008701,Debit,1278.99,-861031.03,GBP,Shell
TXN0000014202,2024-04-01T13:52:07,ACC00007853,Debit,945.66,-861976.69,USD,Target
TXN0000014203,2024-04-24T16:30:30,ACC00001511,ATM,752.02,-862728.71,USD,Grocery
TXN0000014204,2024-12-10T03:04:33,ACC00009323,Credit,888.38,-861840.33,GBP,Online Store
TXN0000014205,2024-09-18T03:37:35,ACC00006122,ATM,804.04,-862644.37,USD,Walmart
TXN0000014206,2024-07-29T01:32:22,ACC00006116,ATM,685.52,-863329.89,USD,Starbucks
TXN0000014207,2024-10-02T05:53:54,ACC00004210,Debit,10.61,-863340.5,USD,Grocery
TXN0000014208,2024-05-09T09:07:41,ACC00005396,Transfer,660.84,-862679.66,GBP,Amazon
TXN0000014209,2024-09-29T18:25:35,ACC00001094,ATM,983.83,-863663.49,EUR,Starbucks
TXN0000014210,2024-11-01T09:19:58,ACC00009627,Credit,881.61,-862781.88,GBP,Starbucks
TXN0000014211,2024-01-19T14:26:49,ACC00003284,Debit,975.84,-863757.72,EUR,Shell
TXN0000014212,2024-11-29T16:32:53,ACC00005612,Debit,161.2,-863918.92,EUR,Shell
TXN0000014213,2024-10-10T12:31:54,ACC00008248,ATM,609.25,-864528.17,EUR,Grocery
TXN0000014214,2024-06-22T10:04:54,ACC00005956,Credit,1440.13,-863088.04,EUR,Shell
TXN0000014215,2024-04-08T16:04:47,ACC00007940,Payment,146.08,-863234.12,USD,Shell
TXN0000014216,2024-08-28T17:44:56,ACC00001428,Debit,1745.25,-864979.37,USD,Grocery
TXN0000014217,2024-09-22T08:17:22,ACC00002259,ATM,1618.66,-866598.03,USD,Restaurant
TXN0000014218,2024-05-26T13:15:51,ACC00003777,Debit,700.18,-867298.21,USD,Target
TXN0000014219,2024-02-27T11:16:17,ACC00007620,Debit,440.88,-867739.09,USD,Grocery
TXN0000014220,2024-01-03T10:06:08,ACC00006082,Transfer,1560.05,-866179.04,EUR,Online Store
TXN0000014221,2024-09-27T09:05:19,ACC00004926,Payment,760.92,-866939.96,GBP,Shell
TXN0000014222,2024-08-25T20:39:05,ACC00004126,ATM,1043.84,-867983.8,USD,Shell
TXN0000014223,2024-06-15T21:21:39,ACC00003823,ATM,724.1,-868707.9,USD,Restaurant
TXN0000014224,2024-08-02T05:26:04,ACC00006532,Debit,1264.68,-869972.58,JPY,Shell
TXN0000014225,2024-10-18T22:14:14,ACC00006644,Payment,963.56,-870936.14,GBP,Target
TXN0000014226,2024-11-09T23:28:27,ACC00005926,Transfer,175.16,-870760.98,EUR,Grocery
TXN0000014227,2024-09-02T19:38:49,ACC00005424,Debit,1923.47,-872684.45,EUR,Online Store
TXN0000014228,2024-10-28T05:29:40,ACC00002310,Credit,202.18,-872482.27,EUR,Walmart
TXN0000014229,2024-05-15T20:20:59,ACC00006983,Transfer,1256.22,-871226.05,EUR,Shell
TXN0000014230,2024-05-05T02:47:42,ACC00000900,Transfer,450.93,-870775.12,EUR,Target
TXN0000014231,2024-08-14T21:36:29,ACC00001290,Debit,1751.86,-872526.98,JPY,Restaurant
TXN0000014232,2024-11-07T13:37:52,ACC00006650,Credit,225.69,-872301.29,USD,Online Store
TXN0000014233,2024-08-08T17:15:08,ACC00008580,Payment,1842.16,-874143.45,EUR,Target
TXN0000014234,2024-12-24T19:20:23,ACC00001115,ATM,1304.9,-875448.35,JPY,Amazon
TXN0000014235,2024-01-31T04:44:51,ACC00006183,ATM,1622.41,-877070.76,EUR,Online Store
TXN0000014236,2024-03-12T10:41:29,ACC00009101,ATM,1724.72,-878795.48,EUR,Restaurant
TXN0000014237,2024-12-26T00:59:39,ACC00003259,Transfer,1681.66,-877113.82,USD,Grocery
TXN0000014238,2024-08-29T19:15:57,ACC00008185,Debit,649.2,-877763.02,EUR,Grocery
TXN0000014239,2024-07-28T16:59:53,ACC00009732,Credit,773.73,-876989.29,GBP,Target
TXN0000014240,2024-12-01T05:48:36,ACC00000198,Payment,598.7,-877587.99,EUR,Walmart
TXN0000014241,2024-01-28T19:53:39,ACC00008374,ATM,1252.1,-878840.09,USD,Walmart
TXN0000014242,2024-10-07T14:55:42,ACC00001814,ATM,367.27,-879207.36,EUR,Starbucks
TXN0000014243,2024-09-29T17:06:58,ACC00000775,Debit,1579.61,-880786.97,GBP,Restaurant
TXN0000014244,2024-11-04T04:56:23,ACC00000896,Payment,443.89,-881230.86,USD,Restaurant
TXN0000014245,2024-03-26T23:35:56,ACC00004308,Payment,525.94,-881756.8,USD,Walmart
TXN0000014246,2024-03-05T01:07:48,ACC00007252,ATM,365.51,-882122.31,USD,Target
TXN0000014247,2024-03-14T12:16:52,ACC00001332,Credit,881.91,-881240.4,GBP,Walmart
TXN0000014248,2024-12-07T06:51:33,ACC00006200,Credit,1026.39,-880214.01,GBP,Shell
TXN0000014249,2024-05-17T09:40:43,ACC00009791,Debit,73.65,-880287.66,USD,Amazon
TXN0000014250,2024-10-20T21:56:24,ACC00008629,Transfer,1080.52,-879207.14,JPY,Target
TXN0000014251,2024-08-27T16:13:39,ACC00007028,Credit,270.97,-878936.17,JPY,Amazon
TXN0000014252,2024-01-05T10:06:36,ACC00007844,Credit,1700.45,-877235.72,GBP,Amazon
TXN0000014253,2024-01-24T08:58:39,ACC00003465,Payment,1913.87,-879149.59,EUR,Amazon
TXN0000014254,2024-01-01T06:17:36,ACC00001111,Payment,184.91,-879334.5,JPY,Walmart
TXN0000014255,2024-03-14T00:29:28,ACC00002266,Transfer,532.01,-878802.49,USD,Walmart
TXN0000014256,2024-10-12T03:33:25,ACC00001531,Credit,1084.26,-877718.23,USD,Target
TXN0000014257,2024-07-30T11:24:02,ACC00004212,Credit,1170.88,-876547.35,EUR,Amazon
TXN0000014258,2024-04-30T20:09:32,ACC00001846,Credit,1437.47,-875109.88,EUR,Grocery
TXN0000014259,2024-10-04T22:46:54,ACC00006683,Payment,851.9,-875961.78,USD,Online Store
TXN0000014260,2024-01-17T10:55:17,ACC00008011,Credit,79.05,-875882.73,GBP,Starbucks
TXN0000014261,2024-05-30T17:08:25,ACC00008004,Debit,1971.23,-877853.96,GBP,Amazon
TXN0000014262,2024-07-28T03:46:07,ACC00000611,ATM,1327.68,-879181.64,USD,Walmart
TXN0000014263,2024-03-14T00:04:20,ACC00002810,Debit,973.23,-880154.87,GBP,Online Store
TXN0000014264,2024-01-15T21:18:48,ACC00003738,Transfer,579.31,-879575.56,GBP,Restaurant
TXN0000014265,2024-05-21T08:46:06,ACC00004275,Credit,844.53,-878731.03,JPY,Shell
TXN0000014266,2024-11-15T06:36:01,ACC00001213,ATM,148.38,-878879.41,USD,Shell
TXN0000014267,2024-06-25T08:13:38,ACC00003552,Debit,751.57,-879630.98,GBP,Restaurant
TXN0000014268,2024-12-30T09:57:32,ACC00001228,Debit,756.23,-880387.21,JPY,Target
TXN0000014269,2024-05-15T04:32:14,ACC00005818,ATM,1258.53,-881645.74,USD,Starbucks
TXN0000014270,2024-05-24T19:43:55,ACC00008515,Payment,1001.84,-882647.58,GBP,Grocery
TXN0000014271,2024-08-27T14:42:37,ACC00002146,Credit,902.21,-881745.37,GBP,Online Store
TXN0000014272,2024-06-13T13:54:26,ACC00008463,ATM,1576.66,-883322.03,JPY,Amazon
TXN0000014273,2024-11-25T15:46:40,ACC00007177,Debit,116.18,-883438.21,USD,Target
TXN0000014274,2024-12-24T08:37:15,ACC00005557,ATM,1766.85,-885205.06,USD,Target
TXN0000014275,2024-05-28T22:40:24,ACC00009628,Debit,1258.93,-886463.99,USD,Walmart
TXN0000014276,2024-05-05T23:26:59,ACC00008285,Transfer,235.69,-886228.3,JPY,Grocery
TXN0000014277,2024-05-09T23:23:57,ACC00005798,Credit,1398.91,-884829.39,GBP,Amazon
TXN0000014278,2024-04-27T03:37:09,ACC00007791,Credit,893.54,-883935.85,EUR,Starbucks
TXN0000014279,2024-11-09T03:54:20,ACC00005892,ATM,1392.86,-885328.71,EUR,Shell
TXN0000014280,2024-02-29T00:57:31,ACC00008486,Transfer,686.27,-884642.44,GBP,Starbucks
TXN0000014281,2024-11-19T10:33:02,ACC00002288,Debit,337.33,-884979.77,USD,Starbucks
TXN0000014282,2024-05-06T21:13:08,ACC00005346,Credit,1628.71,-883351.06,JPY,Amazon
TXN0000014283,2024-08-07T19:47:46,ACC00009766,Payment,118.07,-883469.13,GBP,Grocery
TXN0000014284,2024-06-29T12:31:56,ACC00001975,ATM,148.33,-883617.46,JPY,Amazon
TXN0000014285,2024-04-07T01:14:34,ACC00004289,ATM,826.69,-884444.15,EUR,Grocery
TXN0000014286,2024-04-07T07:26:01,ACC00004522,Transfer,898.28,-883545.87,USD,Shell
TXN0000014287,2024-02-02T04:11:13,ACC00003260,Transfer,105.45,-883440.42,JPY,Online Store
TXN0000014288,2024-02-07T08:44:10,ACC00006682,Credit,1845.47,-881594.95,JPY,Grocery
TXN0000014289,2024-07-11T14:08:44,ACC00004541,Debit,94.18,-881689.13,EUR,Starbucks
TXN0000014290,2024-04-26T21:03:27,ACC00008219,Transfer,735.25,-880953.88,EUR,Restaurant
TXN0000014291,2024-04-09T23:37:49,ACC00005590,Transfer,1666.58,-879287.3,USD,Shell
TXN0000014292,2024-11-05T15:57:33,ACC00001213,Debit,866.21,-880153.51,JPY,Shell
TXN0000014293,2024-08-09T04:22:22,ACC00002148,ATM,102.23,-880255.74,EUR,Grocery
TXN0000014294,2024-11-13T02:22:00,ACC00008368,Payment,1226.75,-881482.49,EUR,Walmart
TXN0000014295,2024-10-29T05:10:37,ACC00008741,Payment,475.57,-881958.06,GBP,Online Store
TXN0000014296,2024-07-29T10:18:42,ACC00004896,Payment,443.71,-882401.77,GBP,Online Store
TXN0000014297,2024-07-17T10:34:58,ACC00003876,Transfer,553.48,-881848.29,GBP,Starbucks
TXN0000014298,2024-08-14T09:30:57,ACC00000565,Transfer,1147.33,-880700.96,JPY,Amazon
TXN0000014299,2024-04-30T19:15:28,ACC00002423,Credit,80.16,-880620.8,JPY,Grocery
TXN0000014300,2024-06-02T21:50:12,ACC00005703,Credit,897.58,-879723.22,EUR,Restaurant
TXN0000014301,2024-02-27T22:29:41,ACC00002471,Transfer,533.69,-879189.53,JPY,Online Store
TXN0000014302,2024-06-27T20:42:08,ACC00004705,ATM,749.12,-879938.65,GBP,Shell
TXN0000014303,2024-12-08T15:29:20,ACC00001361,Debit,143.22,-880081.87,EUR,Target
TXN0000014304,2024-01-11T14:47:59,ACC00008703,Debit,1763.99,-881845.86,EUR,Restaurant
TXN0000014305,2024-08-16T12:55:04,ACC00004782,Payment,1403.72,-883249.58,JPY,Target
TXN0000014306,2024-11-09T09:08:19,ACC00008182,Transfer,252.21,-882997.37,EUR,Online Store
TXN0000014307,2024-12-19T21:58:04,ACC00002680,Debit,919.62,-883916.99,EUR,Restaurant
TXN0000014308,2024-05-21T16:12:29,ACC00000313,ATM,1589.27,-885506.26,USD,Amazon
TXN0000014309,2024-03-19T17:54:11,ACC00005806,Payment,677.44,-886183.7,JPY,Amazon
TXN0000014310,2024-12-22T19:24:50,ACC00000098,Transfer,1067.09,-885116.61,GBP,Grocery
TXN0000014311,2024-05-12T00:47:12,ACC00004602,Credit,393.76,-884722.85,JPY,Online Store
TXN0000014312,2024-06-20T14:44:53,ACC00000325,Transfer,845.33,-883877.52,JPY,Walmart
TXN0000014313,2024-07-23T05:54:03,ACC00002880,Debit,1162.14,-885039.66,JPY,Shell
TXN0000014314,2024-02-27T19:09:41,ACC00008028,Credit,1858.39,-883181.27,EUR,Starbucks
TXN0000014315,2024-02-12T18:59:47,ACC00006828,Transfer,275.68,-882905.59,USD,Target
TXN0000014316,2024-05-30T20:44:20,ACC00007706,Payment,971.24,-883876.83,EUR,Grocery
TXN0000014317,2024-07-29T18:24:35,ACC00000470,ATM,139.09,-884015.92,GBP,Grocery
TXN0000014318,2024-06-30T09:09:40,ACC00006959,Transfer,778.56,-883237.36,EUR,Restaurant
TXN0000014319,2024-06-14T02:17:21,ACC00001076,Credit,1454.56,-881782.8,JPY,Walmart
TXN0000014320,2024-03-14T22:39:02,ACC00005473,Credit,1375.28,-880407.52,USD,Online Store
TXN0000014321,2024-02-12T23:18:54,ACC00000578,Debit,66.53,-880474.05,GBP,Online Store
TXN0000014322,2024-06-07T01:35:44,ACC00002063,Debit,852.44,-881326.49,USD,Starbucks
TXN0000014323,2024-04-12T01:52:34,ACC00008483,Payment,621.79,-881948.28,EUR,Starbucks
TXN0000014324,2024-10-10T05:55:25,ACC00009040,Credit,384.79,-881563.49,USD,Online Store
TXN0000014325,2024-02-27T20:56:15,ACC00000843,Debit,1022.54,-882586.03,EUR,Shell
TXN0000014326,2024-08-17T11:00:39,ACC00003682,Transfer,496.85,-882089.18,JPY,Online Store
TXN0000014327,2024-07-23T17:14:45,ACC00000706,ATM,1570.78,-883659.96,USD,Restaurant
TXN0000014328,2024-09-24T13:42:03,ACC00004626,Debit,85.57,-883745.53,EUR,Amazon
TXN0000014329,2024-06-26T08:36:05,ACC00001720,Credit,1348.94,-882396.59,USD,Shell
TXN0000014330,2024-08-06T14:47:27,ACC00002980,Payment,1751.52,-884148.11,GBP,Grocery
TXN0000014331,2024-02-04T02:17:50,ACC00004361,Transfer,1387.11,-882761.0,EUR,Starbucks
TXN0000014332,2024-02-22T01:27:55,ACC00000017,Payment,1210.0,-883971.0,EUR,Walmart
TXN0000014333,2024-09-19T08:12:29,ACC00008690,Payment,762.17,-884733.17,JPY,Grocery
TXN0000014334,2024-07-06T20:47:06,ACC00004921,Transfer,178.37,-884554.8,GBP,Target
TXN0000014335,2024-07-30T05:56:03,ACC00007294,Credit,327.75,-884227.05,GBP,Target
TXN0000014336,2024-03-16T21:03:16,ACC00006521,Credit,480.23,-883746.82,GBP,Starbucks
TXN0000014337,2024-05-13T20:26:14,ACC00005649,Credit,750.16,-882996.66,JPY,Walmart
TXN0000014338,2024-10-22T11:07:16,ACC00004732,Credit,492.01,-882504.65,JPY,Restaurant
TXN0000014339,2024-08-06T02:51:54,ACC00006257,Transfer,1081.62,-881423.03,EUR,Starbucks
TXN0000014340,2024-02-12T18:40:48,ACC00003455,Credit,103.49,-881319.54,USD,Amazon
TXN0000014341,2024-06-23T13:25:59,ACC00009361,Debit,866.82,-882186.36,USD,Shell
TXN0000014342,2024-07-20T13:50:52,ACC00001048,Payment,510.87,-882697.23,USD,Amazon
TXN0000014343,2024-04-21T03:02:13,ACC00004102,ATM,1173.49,-883870.72,USD,Restaurant
TXN0000014344,2024-05-12T17:31:55,ACC00008082,Transfer,1795.82,-882074.9,EUR,Amazon
TXN0000014345,2024-12-25T00:21:43,ACC00000722,ATM,1040.65,-883115.55,USD,Target
TXN0000014346,2024-07-18T14:09:58,ACC00006193,Debit,1399.76,-884515.31,EUR,Amazon
TXN0000014347,2024-02-15T18:43:40,ACC00001175,ATM,1084.1,-885599.41,GBP,Walmart
TXN0000014348,2024-09-19T00:02:51,ACC00000404,Payment,730.37,-886329.78,GBP,Grocery
TXN0000014349,2024-02-01T03:58:59,ACC00007091,Transfer,1396.9,-884932.88,EUR,Target
TXN0000014350,2024-11-29T19:39:03,ACC00007673,Debit,46.13,-884979.01,GBP,Restaurant
TXN0000014351,2024-07-09T03:19:13,ACC00002227,Transfer,1649.56,-883329.45,JPY,Grocery
TXN0000014352,2024-09-25T03:53:20,ACC00002328,ATM,1624.02,-884953.47,GBP,Starbucks
TXN0000014353,2024-11-10T18:49:28,ACC00003602,Payment,748.9,-885702.37,JPY,Shell
TXN0000014354,2024-09-16T19:39:20,ACC00000198,Transfer,1531.37,-884171.0,USD,Grocery
TXN0000014355,2024-12-15T23:26:17,ACC00004665,Debit,687.42,-884858.42,JPY,Shell
TXN0000014356,2024-09-03T11:08:37,ACC00008835,ATM,1136.62,-885995.04,JPY,Walmart
TXN0000014357,2024-03-20T18:35:41,ACC00006578,Payment,219.62,-886214.66,EUR,Grocery
TXN0000014358,2024-10-11T05:38:46,ACC00002907,Payment,1191.88,-887406.54,USD,Amazon
TXN0000014359,2024-01-02T13:02:10,ACC00001704,Transfer,723.91,-886682.63,EUR,Restaurant
TXN0000014360,2024-02-13T08:08:42,ACC00002387,Transfer,1366.85,-885315.78,JPY,Grocery
TXN0000014361,2024-09-29T05:20:59,ACC00001548,Credit,272.59,-885043.19,GBP,Amazon
TXN0000014362,2024-07-29T08:47:40,ACC00003010,Credit,1421.09,-883622.1,EUR,Amazon
TXN0000014363,2024-02-15T21:29:01,ACC00004470,Credit,14.88,-883607.22,EUR,Amazon
TXN0000014364,2024-09-07T12:26:11,ACC00009634,Debit,1581.08,-885188.3,GBP,Grocery
TXN0000014365,2024-03-20T20:37:49,ACC00002607,Payment,205.83,-885394.13,USD,Starbucks
TXN0000014366,2024-08-13T17:32:41,ACC00004210,ATM,1769.37,-887163.5,USD,Amazon
TXN0000014367,2024-01-13T07:57:51,ACC00001308,ATM,1823.25,-888986.75,USD,Shell
TXN0000014368,2024-09-02T22:04:41,ACC00002430,Payment,1569.88,-890556.63,USD,Online Store
TXN0000014369,2024-04-03T18:28:07,ACC00004954,Payment,511.38,-891068.01,USD,Starbucks
TXN0000014370,2024-09-26T12:25:22,ACC00002431,Debit,411.3,-891479.31,USD,Target
TXN0000014371,2024-04-28T15:45:35,ACC00006401,ATM,1902.41,-893381.72,JPY,Target
TXN0000014372,2024-04-23T20:44:46,ACC00000792,Credit,403.1,-892978.62,JPY,Online Store
TXN0000014373,2024-06-02T10:34:22,ACC00005391,Transfer,737.53,-892241.09,EUR,Starbucks
TXN0000014374,2024-08-05T08:06:31,ACC00003991,ATM,140.5,-892381.59,USD,Grocery
TXN0000014375,2024-04-05T13:40:48,ACC00001745,Credit,214.1,-892167.49,EUR,Shell
TXN0000014376,2024-08-15T05:29:38,ACC00007772,ATM,1655.9,-893823.39,GBP,Walmart
TXN0000014377,2024-10-26T12:34:28,ACC00008467,ATM,1740.34,-895563.73,GBP,Online Store
TXN0000014378,2024-11-05T06:44:16,ACC00004945,Credit,397.44,-895166.29,USD,Online Store
TXN0000014379,2024-01-25T18:05:22,ACC00000047,ATM,1073.84,-896240.13,EUR,Online Store
TXN0000014380,2024-06-16T22:31:31,ACC00001352,Transfer,283.73,-895956.4,JPY,Walmart
TXN0000014381,2024-06-28T22:18:15,ACC00004770,Debit,936.67,-896893.07,JPY,Starbucks
TXN0000014382,2024-11-19T12:29:06,ACC00007835,ATM,361.09,-897254.16,EUR,Grocery
TXN0000014383,2024-11-21T06:04:13,ACC00000193,ATM,1930.69,-899184.85,JPY,Starbucks
TXN0000014384,2024-05-05T08:27:21,ACC00007416,Payment,221.56,-899406.41,USD,Walmart
TXN0000014385,2024-08-29T23:38:18,ACC00009742,Payment,1843.57,-901249.98,JPY,Shell
TXN0000014386,2024-01-15T21:46:29,ACC00002143,Transfer,1115.08,-900134.9,GBP,Shell
TXN0000014387,2024-01-27T13:39:57,ACC00000789,Transfer,1486.34,-898648.56,JPY,Restaurant
TXN0000014388,2024-07-18T20:23:19,ACC00006446,Debit,1848.34,-900496.9,JPY,Restaurant
TXN0000014389,2024-12-07T11:46:33,ACC00000716,Payment,173.68,-900670.58,JPY,Shell
TXN0000014390,2024-09-19T08:02:41,ACC00002941,Payment,745.73,-901416.31,GBP,Walmart
TXN0000014391,2024-06-04T06:36:59,ACC00004268,Debit,1885.67,-903301.98,JPY,Shell
TXN0000014392,2024-11-19T19:41:20,ACC00004218,Payment,1582.83,-904884.81,USD,Amazon
TXN0000014393,2024-04-08T01:56:09,ACC00005445,Credit,456.63,-904428.18,EUR,Walmart
TXN0000014394,2024-01-24T11:13:55,ACC00002745,ATM,510.38,-904938.56,GBP,Grocery
TXN0000014395,2024-10-28T14:29:29,ACC00008139,ATM,861.79,-905800.35,USD,Shell
TXN0000014396,2024-03-16T06:45:36,ACC00006155,Payment,1092.8,-906893.15,GBP,Restaurant
TXN0000014397,2024-04-03T21:20:03,ACC00001116,Credit,881.38,-906011.77,GBP,Shell
TXN0000014398,2024-06-30T01:41:58,ACC00009962,ATM,476.39,-906488.16,EUR,Target
TXN0000014399,2024-11-15T14:29:00,ACC00009693,Transfer,412.04,-906076.12,JPY,Shell
TXN0000014400,2024-08-17T05:36:22,ACC00001619,Payment,410.05,-906486.17,JPY,Shell
TXN0000014401,2024-08-17T06:45:56,ACC00005825,ATM,589.9,-907076.07,EUR,Restaurant
TXN0000014402,2024-05-18T20:23:24,ACC00004628,Credit,685.41,-906390.66,GBP,Online Store
TXN0000014403,2024-04-16T23:33:48,ACC00005231,Credit,884.75,-905505.91,USD,Restaurant
TXN0000014404,2024-02-24T19:43:30,ACC00005059,Payment,1879.85,-907385.76,JPY,Grocery
TXN0000014405,2024-01-20T13:41:28,ACC00001331,Debit,381.51,-907767.27,GBP,Restaurant
TXN0000014406,2024-03-15T08:09:07,ACC00001658,Payment,1782.82,-909550.09,GBP,Grocery
TXN0000014407,2024-06-26T22:15:18,ACC00002676,Payment,1280.02,-910830.11,USD,Walmart
TXN0000014408,2024-06-22T13:37:51,ACC00002960,Payment,1974.03,-912804.14,JPY,Walmart
TXN0000014409,2024-05-03T09:48:44,ACC00002148,ATM,340.64,-913144.78,JPY,Walmart
TXN0000014410,2024-06-26T21:21:18,ACC00007322,ATM,661.82,-913806.6,JPY,Shell
TXN0000014411,2024-04-05T19:26:54,ACC00008580,Debit,1443.41,-915250.01,JPY,Starbucks
TXN0000014412,2024-11-11T08:08:24,ACC00004907,Credit,837.94,-914412.07,JPY,Target
TXN0000014413,2024-04-13T22:41:00,ACC00009599,Debit,1126.58,-915538.65,USD,Walmart
TXN0000014414,2024-03-27T09:13:07,ACC00007151,ATM,1144.58,-916683.23,USD,Target
TXN0000014415,2024-09-26T04:04:54,ACC00001706,Payment,1013.3,-917696.53,GBP,Amazon
TXN0000014416,2024-08-09T20:10:20,ACC00002235,Transfer,1475.22,-916221.31,EUR,Walmart
TXN0000014417,2024-07-26T05:59:33,ACC00006898,Payment,1975.71,-918197.02,GBP,Walmart
TXN0000014418,2024-09-19T06:12:10,ACC00001438,ATM,23.02,-918220.04,GBP,Target
TXN0000014419,2024-01-10T13:25:07,ACC00006184,ATM,1396.62,-919616.66,EUR,Amazon
TXN0000014420,2024-05-06T09:23:07,ACC00009557,ATM,1473.05,-921089.71,GBP,Walmart
TXN0000014421,2024-04-07T04:42:20,ACC00002281,ATM,1850.47,-922940.18,USD,Online Store
TXN0000014422,2024-05-28T22:10:24,ACC00008990,Transfer,143.97,-922796.21,GBP,Restaurant
TXN0000014423,2024-12-17T05:11:40,ACC00003775,Credit,1959.87,-920836.34,EUR,Shell
TXN0000014424,2024-08-06T04:45:15,ACC00006940,ATM,764.07,-921600.41,GBP,Amazon
TXN0000014425,2024-03-05T00:02:54,ACC00002487,Debit,1668.65,-923269.06,JPY,Shell
TXN0000014426,2024-09-21T07:51:29,ACC00009685,ATM,1965.04,-925234.1,GBP,Grocery
TXN0000014427,2024-11-06T23:01:33,ACC00007779,Debit,261.35,-925495.45,JPY,Restaurant
TXN0000014428,2024-09-17T13:21:15,ACC00006497,Credit,1996.63,-923498.82,GBP,Shell
TXN0000014429,2024-10-02T20:59:39,ACC00005134,Credit,1012.76,-922486.06,JPY,Shell
TXN0000014430,2024-04-08T23:25:38,ACC00008165,Payment,274.04,-922760.1,JPY,Amazon
TXN0000014431,2024-02-18T01:42:52,ACC00001339,ATM,1464.66,-924224.76,USD,Restaurant
TXN0000014432,2024-11-18T21:01:05,ACC00003433,Transfer,92.83,-924131.93,EUR,Walmart
TXN0000014433,2024-10-01T07:17:24,ACC00002440,Debit,123.42,-924255.35,EUR,Walmart
TXN0000014434,2024-04-22T01:06:46,ACC00001351,Transfer,962.06,-923293.29,EUR,Grocery
TXN0000014435,2024-07-29T19:12:24,ACC00002886,Transfer,1069.96,-922223.33,USD,Restaurant
TXN0000014436,2024-01-19T00:39:58,ACC00002239,ATM,472.89,-922696.22,EUR,Amazon
TXN0000014437,2024-07-18T03:57:36,ACC00003628,Transfer,990.97,-921705.25,JPY,Amazon
TXN0000014438,2024-03-15T18:27:52,ACC00009096,ATM,958.51,-922663.76,JPY,Shell
TXN0000014439,2024-02-09T09:28:48,ACC00003333,ATM,1839.01,-924502.77,JPY,Grocery
TXN0000014440,2024-06-03T14:25:30,ACC00000343,Credit,531.18,-923971.59,EUR,Walmart
TXN0000014441,2024-07-09T05:45:27,ACC00000713,Transfer,1307.9,-922663.69,EUR,Grocery
TXN0000014442,2024-07-10T18:05:44,ACC00000496,Payment,1758.19,-924421.88,EUR,Amazon
TXN0000014443,2024-05-27T19:26:05,ACC00001319,ATM,1942.54,-926364.42,JPY,Grocery
TXN0000014444,2024-07-20T16:52:23,ACC00003690,Debit,946.11,-927310.53,EUR,Restaurant
TXN0000014445,2024-04-02T21:43:23,ACC00001147,Debit,1832.82,-929143.35,USD,Walmart
TXN0000014446,2024-04-23T15:13:11,ACC00007713,ATM,1129.05,-930272.4,USD,Grocery
TXN0000014447,2024-11-21T21:42:55,ACC00006367,ATM,1505.64,-931778.04,EUR,Online Store
TXN0000014448,2024-10-20T06:27:53,ACC00007829,Credit,1087.01,-930691.03,EUR,Grocery
TXN0000014449,2024-08-16T02:06:54,ACC00004137,Credit,1611.16,-929079.87,EUR,Grocery
TXN0000014450,2024-07-27T09:27:39,ACC00000694,Credit,1125.7,-927954.17,EUR,Online Store
TXN0000014451,2024-07-11T00:11:48,ACC00000486,Credit,1260.1,-926694.07,USD,Starbucks
TXN0000014452,2024-08-11T02:55:03,ACC00006633,Payment,1284.37,-927978.44,GBP,Starbucks
TXN0000014453,2024-12-13T18:33:15,ACC00001215,Credit,186.05,-927792.39,EUR,Amazon
TXN0000014454,2024-11-22T00:59:48,ACC00008357,Debit,1910.19,-929702.58,EUR,Online Store
TXN0000014455,2024-12-29T10:55:07,ACC00003558,Transfer,1086.86,-928615.72,JPY,Grocery
TXN0000014456,2024-09-21T16:51:09,ACC00003002,Payment,824.49,-929440.21,USD,Walmart
TXN0000014457,2024-01-31T04:30:52,ACC00007079,Credit,1474.62,-927965.59,USD,Shell
TXN0000014458,2024-07-29T13:55:08,ACC00003916,Payment,1723.19,-929688.78,EUR,Grocery
TXN0000014459,2024-11-19T14:48:05,ACC00002600,Credit,915.99,-928772.79,GBP,Starbucks
TXN0000014460,2024-09-04T21:43:15,ACC00003727,Transfer,1512.6,-927260.19,EUR,Shell
TXN0000014461,2024-08-06T03:44:54,ACC00000500,ATM,720.5,-927980.69,JPY,Starbucks
TXN0000014462,2024-11-05T18:29:45,ACC00002332,Transfer,81.45,-927899.24,JPY,Online Store
TXN0000014463,2024-12-21T01:35:52,ACC00001547,ATM,916.31,-928815.55,JPY,Amazon
TXN0000014464,2024-10-02T08:34:41,ACC00005472,Payment,1377.5,-930193.05,USD,Restaurant
TXN0000014465,2024-10-20T08:51:01,ACC00009224,Transfer,339.29,-929853.76,JPY,Starbucks
TXN0000014466,2024-01-02T20:55:08,ACC00006590,ATM,1553.69,-931407.45,JPY,Online Store
TXN0000014467,2024-03-05T21:28:36,ACC00000232,Credit,565.57,-930841.88,USD,Amazon
TXN0000014468,2024-06-21T09:56:56,ACC00005133,Debit,1104.75,-931946.63,USD,Starbucks
TXN0000014469,2024-04-22T00:26:15,ACC00003735,Transfer,600.12,-931346.51,USD,Walmart
TXN0000014470,2024-03-20T04:28:50,ACC00006190,Debit,925.78,-932272.29,GBP,Shell
TXN0000014471,2024-12-06T16:12:26,ACC00001797,Payment,1815.8,-934088.09,JPY,Grocery
TXN0000014472,2024-08-25T16:18:25,ACC00008324,Credit,154.98,-933933.11,GBP,Walmart
TXN0000014473,2024-08-06T05:35:20,ACC00004922,Transfer,602.16,-933330.95,USD,Target
TXN0000014474,2024-03-17T15:43:00,ACC00008603,Payment,1823.61,-935154.56,JPY,Online Store
TXN0000014475,2024-05-19T07:52:02,ACC00000538,Debit,1752.58,-936907.14,USD,Amazon
TXN0000014476,2024-08-16T08:18:29,ACC00000163,ATM,1168.1,-938075.24,JPY,Online Store
TXN0000014477,2024-05-16T04:02:28,ACC00007982,Credit,972.43,-937102.81,EUR,Walmart
TXN0000014478,2024-08-06T10:49:08,ACC00004827,ATM,1807.11,-938909.92,GBP,Starbucks
TXN0000014479,2024-08-08T11:01:04,ACC00009585,Payment,248.76,-939158.68,GBP,Grocery
TXN0000014480,2024-09-25T15:03:49,ACC00006310,Debit,1857.01,-941015.69,JPY,Grocery
TXN0000014481,2024-09-15T01:16:22,ACC00009060,ATM,711.39,-941727.08,EUR,Walmart
TXN0000014482,2024-07-03T06:11:31,ACC00009707,Transfer,1312.66,-940414.42,EUR,Amazon
TXN0000014483,2024-01-04T14:54:39,ACC00007674,Credit,207.32,-940207.1,JPY,Amazon
TXN0000014484,2024-06-13T11:45:24,ACC00002714,ATM,370.25,-940577.35,EUR,Starbucks
TXN0000014485,2024-09-30T02:24:18,ACC00006707,ATM,1730.66,-942308.01,USD,Online Store
TXN0000014486,2024-08-09T12:45:02,ACC00005993,Credit,1534.31,-940773.7,EUR,Restaurant
TXN0000014487,2024-12-09T11:42:43,ACC00009035,Credit,731.96,-940041.74,USD,Walmart
TXN0000014488,2024-06-23T09:46:37,ACC00001958,Payment,846.85,-940888.59,USD,Restaurant
TXN0000014489,2024-03-29T15:17:23,ACC00007598,Debit,391.12,-941279.71,GBP,Shell
TXN0000014490,2024-05-16T10:52:05,ACC00000296,ATM,1759.46,-943039.17,GBP,Shell
TXN0000014491,2024-08-30T16:22:05,ACC00008679,Payment,269.13,-943308.3,JPY,Walmart
TXN0000014492,2024-03-01T08:24:21,ACC00006486,Payment,270.27,-943578.57,GBP,Online Store
TXN0000014493,2024-05-16T07:42:53,ACC00008704,Transfer,417.94,-943160.63,EUR,Online Store
TXN0000014494,2024-11-16T17:10:51,ACC00001003,Credit,1557.55,-941603.08,USD,Restaurant
TXN0000014495,2024-08-30T04:14:02,ACC00003393,Transfer,1660.43,-939942.65,JPY,Restaurant
TXN0000014496,2024-04-14T11:59:15,ACC00005149,Transfer,1009.46,-938933.19,JPY,Grocery
TXN0000014497,2024-01-15T18:56:44,ACC00006851,Credit,935.8,-937997.39,GBP,Walmart
TXN0000014498,2024-01-14T04:30:14,ACC00000616,Payment,1493.59,-939490.98,JPY,Shell
TXN0000014499,2024-01-04T18:38:12,ACC00000624,Payment,1170.28,-940661.26,USD,Grocery
TXN0000014500,2024-04-21T20:13:54,ACC00000497,Payment,929.29,-941590.55,USD,Starbucks
TXN0000014501,2024-03-07T18:47:19,ACC00005189,Credit,1299.47,-940291.08,EUR,Amazon
TXN0000014502,2024-01-23T23:32:38,ACC00005505,Credit,1292.22,-938998.86,JPY,Grocery
TXN0000014503,2024-08-11T11:28:55,ACC00007340,Debit,991.25,-939990.11,EUR,Target
TXN0000014504,2024-02-04T14:14:48,ACC00003708,ATM,1200.63,-941190.74,EUR,Target
TXN0000014505,2024-04-14T02:16:12,ACC00004478,Transfer,1287.6,-939903.14,GBP,Amazon
TXN0000014506,2024-05-04T20:22:09,ACC00008809,Debit,1038.75,-940941.89,GBP,Amazon
TXN0000014507,2024-11-08T01:36:12,ACC00001358,Debit,701.79,-941643.68,JPY,Walmart
TXN0000014508,2024-03-03T03:10:34,ACC00005017,Credit,1006.69,-940636.99,USD,Restaurant
TXN0000014509,2024-07-26T16:05:39,ACC00000791,Credit,1681.48,-938955.51,GBP,Target
TXN0000014510,2024-12-27T01:18:36,ACC00004555,Debit,737.27,-939692.78,USD,Walmart
TXN0000014511,2024-08-31T22:05:59,ACC00001486,Transfer,1300.3,-938392.48,USD,Walmart
TXN0000014512,2024-02-21T10:00:54,ACC00000279,Credit,1307.55,-937084.93,USD,Restaurant
TXN0000014513,2024-02-25T03:06:52,ACC00008652,Credit,1824.23,-935260.7,EUR,Shell
TXN0000014514,2024-08-03T10:58:25,ACC00006329,Transfer,604.85,-934655.85,JPY,Target
TXN0000014515,2024-03-11T03:32:19,ACC00006775,Debit,1453.95,-936109.8,EUR,Restaurant
TXN0000014516,2024-09-20T14:05:13,ACC00002758,ATM,993.45,-937103.25,EUR,Target
TXN0000014517,2024-08-09T20:18:02,ACC00008806,Debit,256.94,-937360.19,USD,Shell
TXN0000014518,2024-03-29T03:09:27,ACC00001969,Credit,1294.2,-936065.99,GBP,Grocery
TXN0000014519,2024-01-21T00:27:51,ACC00007078,Transfer,1402.83,-934663.16,EUR,Online Store
TXN0000014520,2024-08-04T13:12:08,ACC00007279,Transfer,1225.79,-933437.37,JPY,Target
TXN0000014521,2024-03-28T12:24:29,ACC00005570,Transfer,1682.68,-931754.69,EUR,Online Store
TXN0000014522,2024-06-12T02:49:35,ACC00004719,Payment,205.77,-931960.46,GBP,Online Store
TXN0000014523,2024-12-20T13:54:26,ACC00008220,Credit,436.08,-931524.38,EUR,Online Store
TXN0000014524,2024-07-01T23:59:57,ACC00009951,Debit,1166.86,-932691.24,JPY,Walmart
TXN0000014525,2024-05-26T21:03:15,ACC00001683,ATM,175.05,-932866.29,USD,Target
TXN0000014526,2024-05-08T23:36:59,ACC00002875,Payment,961.58,-933827.87,JPY,Target
TXN0000014527,2024-07-05T13:04:40,ACC00006997,Debit,1054.81,-934882.68,EUR,Grocery
TXN0000014528,2024-12-07T16:59:33,ACC00005798,Debit,313.73,-935196.41,JPY,Online Store
TXN0000014529,2024-02-13T19:20:42,ACC00004004,Debit,1600.68,-936797.09,JPY,Amazon
TXN0000014530,2024-07-08T00:29:44,ACC00006721,Payment,213.19,-937010.28,USD,Starbucks
TXN0000014531,2024-05-25T16:42:53,ACC00008548,ATM,999.63,-938009.91,JPY,Walmart
TXN0000014532,2024-06-24T22:44:10,ACC00003533,Credit,290.87,-937719.04,EUR,Shell
TXN0000014533,2024-12-10T16:44:37,ACC00001476,Payment,1575.6,-939294.64,GBP,Target
TXN0000014534,2024-07-23T19:50:01,ACC00000704,Payment,1974.08,-941268.72,JPY,Starbucks
TXN0000014535,2024-04-17T09:34:29,ACC00000740,Transfer,608.85,-940659.87,USD,Restaurant
TXN0000014536,2024-05-28T01:43:37,ACC00000784,Payment,869.96,-941529.83,USD,Walmart
TXN0000014537,2024-07-27T04:44:10,ACC00007686,ATM,915.04,-942444.87,GBP,Grocery
TXN0000014538,2024-10-09T17:05:37,ACC00008573,Debit,1804.24,-944249.11,JPY,Target
TXN0000014539,2024-06-09T10:28:46,ACC00005410,ATM,97.22,-944346.33,USD,Online Store
TXN0000014540,2024-02-23T03:26:26,ACC00007020,Transfer,269.97,-944076.36,GBP,Target
TXN0000014541,2024-12-28T07:48:29,ACC00000180,Credit,1960.82,-942115.54,GBP,Starbucks
TXN0000014542,2024-04-20T05:54:15,ACC00009084,ATM,783.32,-942898.86,EUR,Amazon
TXN0000014543,2024-06-12T07:29:03,ACC00003923,Transfer,1428.52,-941470.34,JPY,Target
TXN0000014544,2024-10-12T12:06:59,ACC00000244,ATM,657.3,-942127.64,EUR,Amazon
TXN0000014545,2024-11-03T01:21:05,ACC00005180,Transfer,1165.55,-940962.09,USD,Shell
TXN0000014546,2024-11-27T08:21:56,ACC00005428,Credit,43.29,-940918.8,EUR,Shell
TXN0000014547,2024-12-26T07:19:19,ACC00003964,Payment,975.27,-941894.07,GBP,Amazon
TXN0000014548,2024-04-04T07:07:14,ACC00001507,Debit,1273.91,-943167.98,GBP,Starbucks
TXN0000014549,2024-05-09T18:10:35,ACC00005702,Credit,1377.44,-941790.54,EUR,Restaurant
TXN0000014550,2024-12-13T04:11:04,ACC00003684,Payment,878.95,-942669.49,JPY,Online Store
TXN0000014551,2024-11-19T01:27:19,ACC00007858,ATM,1300.97,-943970.46,USD,Grocery
TXN0000014552,2024-12-05T10:44:15,ACC00005510,Payment,510.96,-944481.42,USD,Starbucks
TXN0000014553,2024-07-18T08:32:31,ACC00008935,Transfer,226.78,-944254.64,JPY,Walmart
TXN0000014554,2024-03-28T02:04:18,ACC00003321,Credit,1286.69,-942967.95,USD,Shell
TXN0000014555,2024-10-16T22:09:10,ACC00005542,Transfer,674.74,-942293.21,GBP,Online Store
TXN0000014556,2024-12-15T18:56:08,ACC00000939,Payment,363.4,-942656.61,GBP,Shell
TXN0000014557,2024-03-06T04:30:36,ACC00004934,Payment,1007.74,-943664.35,EUR,Restaurant
TXN0000014558,2024-11-02T02:12:26,ACC00002831,Payment,1112.37,-944776.72,GBP,Amazon
TXN0000014559,2024-12-10T01:38:55,ACC00003143,Payment,1061.18,-945837.9,EUR,Amazon
TXN0000014560,2024-02-08T01:05:03,ACC00007599,Transfer,1205.35,-944632.55,USD,Target
TXN0000014561,2024-02-11T10:58:53,ACC00006601,Credit,455.42,-944177.13,GBP,Grocery
TXN0000014562,2024-07-07T13:03:50,ACC00004768,Debit,1444.61,-945621.74,GBP,Shell
TXN0000014563,2024-09-15T21:56:29,ACC00006168,Transfer,521.6,-945100.14,JPY,Walmart
TXN0000014564,2024-09-30T10:00:35,ACC00006648,Debit,1648.83,-946748.97,EUR,Restaurant
TXN0000014565,2024-07-18T22:32:12,ACC00006450,ATM,1310.99,-948059.96,JPY,Grocery
TXN0000014566,2024-06-07T14:24:38,ACC00009941,ATM,1151.86,-949211.82,JPY,Starbucks
TXN0000014567,2024-01-30T08:39:52,ACC00000406,ATM,236.58,-949448.4,EUR,Amazon
TXN0000014568,2024-01-10T11:18:34,ACC00000142,ATM,1081.13,-950529.53,USD,Amazon
TXN0000014569,2024-08-11T12:14:24,ACC00008420,Transfer,706.44,-949823.09,JPY,Restaurant
TXN0000014570,2024-02-19T08:53:19,ACC00007285,Credit,1672.75,-948150.34,GBP,Online Store
TXN0000014571,2024-05-02T08:52:33,ACC00005585,ATM,1404.45,-949554.79,GBP,Target
TXN0000014572,2024-08-12T06:29:07,ACC00005595,Transfer,180.33,-949374.46,GBP,Amazon
TXN0000014573,2024-01-02T06:37:17,ACC00003524,Payment,1190.56,-950565.02,EUR,Restaurant
TXN0000014574,2024-11-16T10:02:32,ACC00008948,Credit,667.75,-949897.27,GBP,Shell
TXN0000014575,2024-01-10T23:18:17,ACC00007556,ATM,1305.79,-951203.06,EUR,Target
TXN0000014576,2024-06-28T05:22:18,ACC00000385,Payment,404.19,-951607.25,JPY,Starbucks
TXN0000014577,2024-10-05T10:41:03,ACC00007042,Debit,1090.2,-952697.45,USD,Restaurant
TXN0000014578,2024-09-15T20:12:37,ACC00008769,Payment,374.76,-953072.21,GBP,Target
TXN0000014579,2024-02-05T11:03:19,ACC00005600,Payment,1542.6,-954614.81,GBP,Shell
TXN0000014580,2024-11-24T07:45:01,ACC00007529,Transfer,573.3,-954041.51,JPY,Grocery
TXN0000014581,2024-06-20T02:06:04,ACC00003933,Debit,274.34,-954315.85,USD,Online Store
TXN0000014582,2024-01-30T19:52:53,ACC00003586,Transfer,192.78,-954123.07,EUR,Shell
TXN0000014583,2024-07-20T01:14:42,ACC00000659,Debit,1703.27,-955826.34,USD,Target
TXN0000014584,2024-09-15T12:10:21,ACC00009365,Debit,42.91,-955869.25,GBP,Walmart
TXN0000014585,2024-03-16T08:50:39,ACC00007161,Credit,945.35,-954923.9,JPY,Walmart
TXN0000014586,2024-11-02T05:13:42,ACC00008800,Transfer,859.38,-954064.52,JPY,Grocery
TXN0000014587,2024-09-09T09:55:33,ACC00009165,Payment,1949.87,-956014.39,EUR,Starbucks
TXN0000014588,2024-08-18T21:07:20,ACC00009228,ATM,1930.33,-957944.72,JPY,Grocery
TXN0000014589,2024-07-22T15:09:27,ACC00005480,Credit,1500.62,-956444.1,GBP,Online Store
TXN0000014590,2024-05-07T20:58:42,ACC00008191,Debit,911.63,-957355.73,JPY,Starbucks
TXN0000014591,2024-01-21T15:55:40,ACC00000569,Transfer,990.44,-956365.29,JPY,Amazon
TXN0000014592,2024-12-18T22:08:22,ACC00007959,Credit,359.43,-956005.86,USD,Starbucks
TXN0000014593,2024-03-09T02:56:00,ACC00006361,Transfer,384.77,-955621.09,USD,Shell
TXN0000014594,2024-12-19T10:09:17,ACC00006219,ATM,893.98,-956515.07,EUR,Amazon
TXN0000014595,2024-03-03T14:38:26,ACC00007494,ATM,407.35,-956922.42,USD,Online Store
TXN0000014596,2024-01-13T02:50:02,ACC00008793,Credit,1846.33,-955076.09,EUR,Shell
TXN0000014597,2024-07-01T16:49:37,ACC00002245,Debit,1823.9,-956899.99,EUR,Starbucks
TXN0000014598,2024-03-06T23:11:03,ACC00008444,Payment,80.75,-956980.74,JPY,Amazon
TXN0000014599,2024-03-20T21:11:34,ACC00007866,Credit,1698.72,-955282.02,USD,Grocery
TXN0000014600,2024-03-02T01:48:04,ACC00007338,Payment,1761.21,-957043.23,EUR,Grocery
TXN0000014601,2024-11-16T07:43:37,ACC00004355,Debit,177.27,-957220.5,JPY,Grocery
TXN0000014602,2024-06-30T11:56:33,ACC00008897,Credit,1449.48,-955771.02,USD,Online Store
TXN0000014603,2024-07-25T16:53:28,ACC00008618,Payment,996.85,-956767.87,GBP,Starbucks
TXN0000014604,2024-09-16T11:21:43,ACC00004796,ATM,1526.29,-958294.16,JPY,Shell
TXN0000014605,2024-08-27T06:40:57,ACC00002239,Transfer,1271.63,-957022.53,JPY,Starbucks
TXN0000014606,2024-12-18T18:11:55,ACC00000612,Debit,1069.18,-958091.71,JPY,Amazon
TXN0000014607,2024-11-24T18:29:55,ACC00009567,ATM,1527.7,-959619.41,GBP,Restaurant
TXN0000014608,2024-07-28T23:11:13,ACC00002339,Payment,1600.47,-961219.88,GBP,Walmart
TXN0000014609,2024-04-28T05:21:43,ACC00000520,Debit,237.66,-961457.54,GBP,Walmart
TXN0000014610,2024-07-12T16:08:21,ACC00009284,Transfer,358.49,-961099.05,EUR,Online Store
TXN0000014611,2024-09-26T20:29:38,ACC00001034,Transfer,1151.04,-959948.01,EUR,Amazon
TXN0000014612,2024-08-24T09:01:04,ACC00009525,Credit,147.67,-959800.34,EUR,Grocery
TXN0000014613,2024-01-04T12:03:39,ACC00000102,Payment,1498.0,-961298.34,EUR,Target
TXN0000014614,2024-06-18T13:24:38,ACC00001354,Payment,854.89,-962153.23,GBP,Starbucks
TXN0000014615,2024-02-28T17:58:13,ACC00002834,Credit,139.71,-962013.52,EUR,Online Store
TXN0000014616,2024-12-02T16:22:19,ACC00009418,Payment,598.32,-962611.84,EUR,Grocery
TXN0000014617,2024-03-28T16:26:26,ACC00004087,Debit,468.06,-963079.9,JPY,Shell
TXN0000014618,2024-12-20T09:40:40,ACC00007675,Payment,1624.78,-964704.68,EUR,Online Store
TXN0000014619,2024-02-23T21:49:15,ACC00009457,Credit,1395.38,-963309.3,JPY,Target
TXN0000014620,2024-08-15T04:00:31,ACC00002838,Transfer,541.31,-962767.99,USD,Amazon
TXN0000014621,2024-02-19T15:19:59,ACC00007479,ATM,1460.23,-964228.22,JPY,Target
TXN0000014622,2024-09-01T20:29:41,ACC00004547,Credit,1984.65,-962243.57,GBP,Walmart
TXN0000014623,2024-05-03T06:41:06,ACC00005571,Payment,1122.57,-963366.14,GBP,Shell
TXN0000014624,2024-05-31T22:52:01,ACC00002625,Transfer,1878.63,-961487.51,JPY,Online Store
TXN0000014625,2024-12-07T08:31:44,ACC00009179,ATM,1891.37,-963378.88,EUR,Online Store
TXN0000014626,2024-09-30T20:47:09,ACC00008035,Credit,1455.44,-961923.44,GBP,Walmart
TXN0000014627,2024-11-04T23:28:39,ACC00001857,Credit,852.43,-961071.01,JPY,Shell
TXN0000014628,2024-03-27T15:35:53,ACC00004019,Payment,920.23,-961991.24,GBP,Target
TXN0000014629,2024-06-24T06:01:31,ACC00000190,Payment,751.92,-962743.16,JPY,Target
TXN0000014630,2024-11-25T05:56:22,ACC00008288,ATM,1074.5,-963817.66,USD,Online Store
TXN0000014631,2024-09-27T20:14:31,ACC00005313,Payment,1152.61,-964970.27,USD,Grocery
TXN0000014632,2024-11-28T10:48:18,ACC00003172,Transfer,1147.2,-963823.07,USD,Restaurant
TXN0000014633,2024-10-11T11:07:13,ACC00005228,Payment,947.14,-964770.21,EUR,Online Store
TXN0000014634,2024-09-22T12:35:31,ACC00005346,ATM,1097.63,-965867.84,USD,Shell
TXN0000014635,2024-09-03T13:34:48,ACC00009264,Transfer,100.09,-965767.75,EUR,Starbucks
TXN0000014636,2024-06-19T05:19:27,ACC00003438,ATM,791.57,-966559.32,EUR,Walmart
TXN0000014637,2024-05-06T20:22:46,ACC00009728,Credit,441.87,-966117.45,EUR,Amazon
TXN0000014638,2024-09-29T20:02:35,ACC00004051,Credit,1467.28,-964650.17,USD,Shell
TXN0000014639,2024-04-17T08:45:59,ACC00004282,Debit,689.68,-965339.85,GBP,Walmart
TXN0000014640,2024-04-10T16:52:18,ACC00004799,Credit,1363.0,-963976.85,GBP,Starbucks
TXN0000014641,2024-09-03T19:50:34,ACC00001657,ATM,1149.33,-965126.18,EUR,Amazon
TXN0000014642,2024-12-16T11:23:18,ACC00003506,Transfer,791.0,-964335.18,EUR,Amazon
TXN0000014643,2024-11-13T01:10:28,ACC00000705,Credit,816.03,-963519.15,JPY,Amazon
TXN0000014644,2024-03-09T12:05:53,ACC00007710,ATM,143.56,-963662.71,USD,Online Store
TXN0000014645,2024-02-08T10:30:31,ACC00008522,Payment,933.52,-964596.23,GBP,Shell
TXN0000014646,2024-01-20T02:04:03,ACC00000990,Credit,162.21,-964434.02,JPY,Online Store
TXN0000014647,2024-09-22T04:59:03,ACC00004481,Credit,1870.45,-962563.57,USD,Restaurant
TXN0000014648,2024-03-30T19:49:25,ACC00005580,Debit,1179.49,-963743.06,JPY,Target
TXN0000014649,2024-08-16T08:53:29,ACC00003532,Payment,1912.58,-965655.64,GBP,Walmart
TXN0000014650,2024-03-02T08:49:50,ACC00002643,ATM,604.28,-966259.92,GBP,Restaurant
TXN0000014651,2024-09-22T15:14:22,ACC00006053,Credit,1728.12,-964531.8,GBP,Grocery
TXN0000014652,2024-11-25T04:51:13,ACC00004657,Transfer,1610.83,-962920.97,GBP,Shell
TXN0000014653,2024-06-20T01:59:06,ACC00004446,Debit,831.96,-963752.93,JPY,Shell
TXN0000014654,2024-03-21T16:10:53,ACC00000799,ATM,203.09,-963956.02,JPY,Online Store
TXN0000014655,2024-03-23T05:09:41,ACC00006464,ATM,1467.34,-965423.36,GBP,Shell
TXN0000014656,2024-10-08T01:01:38,ACC00005490,Debit,102.01,-965525.37,JPY,Starbucks
TXN0000014657,2024-10-06T07:20:17,ACC00003056,Debit,58.32,-965583.69,JPY,Restaurant
TXN0000014658,2024-06-08T23:29:22,ACC00000072,Transfer,1727.05,-963856.64,EUR,Shell
TXN0000014659,2024-05-10T20:01:03,ACC00004581,Credit,1978.25,-961878.39,JPY,Target
TXN0000014660,2024-08-05T12:11:15,ACC00009623,Payment,1143.92,-963022.31,USD,Online Store
TXN0000014661,2024-03-14T23:56:12,ACC00004719,Debit,1027.01,-964049.32,EUR,Grocery
TXN0000014662,2024-07-21T17:25:48,ACC00000214,Debit,603.88,-964653.2,USD,Grocery
TXN0000014663,2024-08-06T16:27:47,ACC00003203,Transfer,396.16,-964257.04,GBP,Target
TXN0000014664,2024-01-26T03:03:09,ACC00007974,Transfer,1424.52,-962832.52,GBP,Amazon
TXN0000014665,2024-07-08T02:21:47,ACC00008886,Payment,1746.24,-964578.76,GBP,Shell
TXN0000014666,2024-11-04T07:31:05,ACC00008864,Payment,303.09,-964881.85,USD,Amazon
TXN0000014667,2024-04-18T06:39:30,ACC00003435,Credit,1465.86,-963415.99,JPY,Amazon
TXN0000014668,2024-11-13T13:59:42,ACC00004185,Debit,1071.02,-964487.01,JPY,Restaurant
TXN0000014669,2024-06-24T03:43:36,ACC00009935,Debit,1969.41,-966456.42,USD,Shell
TXN0000014670,2024-02-23T12:04:49,ACC00007783,Transfer,1155.22,-965301.2,EUR,Target
TXN0000014671,2024-09-30T07:48:34,ACC00008925,Credit,1680.18,-963621.02,USD,Target
TXN0000014672,2024-03-11T01:59:04,ACC00000784,Payment,924.67,-964545.69,USD,Online Store
TXN0000014673,2024-09-25T01:06:41,ACC00007539,ATM,135.62,-964681.31,GBP,Amazon
TXN0000014674,2024-04-13T16:00:29,ACC00000817,Payment,334.61,-965015.92,GBP,Amazon
TXN0000014675,2024-02-24T03:23:30,ACC00005432,ATM,421.46,-965437.38,EUR,Target
TXN0000014676,2024-10-05T08:50:10,ACC00000304,Credit,1374.8,-964062.58,GBP,Target
TXN0000014677,2024-01-04T16:58:14,ACC00009337,Credit,174.33,-963888.25,JPY,Walmart
TXN0000014678,2024-10-27T05:49:40,ACC00004892,ATM,1589.32,-965477.57,GBP,Target
TXN0000014679,2024-10-16T17:27:59,ACC00004268,Payment,280.32,-965757.89,EUR,Shell
TXN0000014680,2024-07-25T16:55:51,ACC00008514,ATM,1109.84,-966867.73,USD,Amazon
TXN0000014681,2024-12-04T12:07:32,ACC00003871,Debit,1172.35,-968040.08,EUR,Starbucks
TXN0000014682,2024-12-09T16:42:31,ACC00008333,Transfer,1207.28,-966832.8,GBP,Target
TXN0000014683,2024-05-06T20:30:58,ACC00004245,ATM,1870.77,-968703.57,EUR,Target
TXN0000014684,2024-05-31T17:56:54,ACC00009779,Debit,1523.01,-970226.58,EUR,Starbucks
TXN0000014685,2024-07-01T20:34:33,ACC00001750,Payment,1694.69,-971921.27,EUR,Walmart
TXN0000014686,2024-03-15T12:03:44,ACC00001327,Debit,1241.84,-973163.11,EUR,Starbucks
TXN0000014687,2024-04-08T15:07:44,ACC00002506,Transfer,821.62,-972341.49,GBP,Grocery
TXN0000014688,2024-10-28T21:40:29,ACC00002399,ATM,1363.44,-973704.93,GBP,Starbucks
TXN0000014689,2024-04-15T14:53:27,ACC00004411,ATM,159.65,-973864.58,GBP,Shell
TXN0000014690,2024-07-09T13:15:15,ACC00007075,Debit,462.96,-974327.54,USD,Starbucks
TXN0000014691,2024-12-27T09:11:35,ACC00007112,Debit,1930.27,-976257.81,GBP,Starbucks
TXN0000014692,2024-04-17T09:51:34,ACC00001390,Payment,1891.69,-978149.5,GBP,Starbucks
TXN0000014693,2024-11-28T01:58:26,ACC00006641,Credit,742.03,-977407.47,EUR,Restaurant
TXN0000014694,2024-08-23T15:21:26,ACC00006697,Debit,1129.37,-978536.84,USD,Amazon
TXN0000014695,2024-05-09T13:25:50,ACC00008375,Credit,1304.26,-977232.58,EUR,Target
TXN0000014696,2024-03-17T19:16:26,ACC00000190,Debit,1103.58,-978336.16,USD,Starbucks
TXN0000014697,2024-12-03T05:53:30,ACC00006818,Debit,1691.23,-980027.39,EUR,Amazon
TXN0000014698,2024-04-20T12:07:20,ACC00000309,Transfer,1427.55,-978599.84,USD,Grocery
TXN0000014699,2024-01-03T00:12:39,ACC00001516,Debit,1456.83,-980056.67,USD,Starbucks
TXN0000014700,2024-11-17T05:09:35,ACC00005537,Debit,1116.32,-981172.99,EUR,Target
TXN0000014701,2024-03-06T16:15:28,ACC00004247,ATM,1432.08,-982605.07,USD,Restaurant
TXN0000014702,2024-05-04T04:12:01,ACC00004664,Debit,103.92,-982708.99,JPY,Restaurant
TXN0000014703,2024-04-11T00:01:17,ACC00005625,ATM,1749.66,-984458.65,JPY,Starbucks
TXN0000014704,2024-05-16T05:48:42,ACC00001369,Debit,822.97,-985281.62,USD,Restaurant
TXN0000014705,2024-10-22T13:49:08,ACC00002244,Transfer,1299.55,-983982.07,JPY,Amazon
TXN0000014706,2024-11-27T21:25:38,ACC00009975,Payment,1419.74,-985401.81,GBP,Grocery
TXN0000014707,2024-12-19T22:53:08,ACC00004597,Credit,1833.62,-983568.19,EUR,Walmart
TXN0000014708,2024-08-02T17:18:57,ACC00009188,Transfer,1068.43,-982499.76,EUR,Walmart
TXN0000014709,2024-03-27T07:02:09,ACC00002681,Transfer,1370.11,-981129.65,USD,Target
TXN0000014710,2024-02-09T12:50:23,ACC00008290,Debit,546.19,-981675.84,JPY,Online Store
TXN0000014711,2024-04-22T14:20:24,ACC00005725,ATM,1818.58,-983494.42,EUR,Target
TXN0000014712,2024-09-03T23:38:36,ACC00002058,Credit,1904.26,-981590.16,GBP,Shell
TXN0000014713,2024-11-04T16:41:13,ACC00000659,Payment,192.78,-981782.94,EUR,Target
TXN0000014714,2024-03-18T20:46:47,ACC00009142,Debit,792.26,-982575.2,JPY,Target
TXN0000014715,2024-03-07T03:20:25,ACC00008127,Credit,1624.95,-980950.25,GBP,Walmart
TXN0000014716,2024-06-08T18:06:51,ACC00003653,Transfer,523.05,-980427.2,USD,Online Store
TXN0000014717,2024-12-16T19:11:54,ACC00007360,Payment,964.6,-981391.8,USD,Shell
TXN0000014718,2024-05-04T10:48:35,ACC00006456,Credit,1455.78,-979936.02,USD,Amazon
TXN0000014719,2024-02-05T21:31:41,ACC00009045,Credit,41.77,-979894.25,GBP,Starbucks
TXN0000014720,2024-06-13T15:38:48,ACC00009703,Credit,965.73,-978928.52,EUR,Shell
TXN0000014721,2024-04-16T04:51:14,ACC00009677,Payment,1731.03,-980659.55,GBP,Online Store
TXN0000014722,2024-02-20T17:54:26,ACC00001779,Debit,888.2,-981547.75,GBP,Shell
TXN0000014723,2024-03-09T07:27:34,ACC00003886,Credit,61.19,-981486.56,EUR,Shell
TXN0000014724,2024-10-06T01:41:31,ACC00005311,Debit,1071.15,-982557.71,EUR,Grocery
TXN0000014725,2024-07-30T12:11:55,ACC00004787,Debit,1906.7,-984464.41,USD,Restaurant
TXN0000014726,2024-09-23T18:53:21,ACC00007262,Debit,1259.43,-985723.84,USD,Grocery
TXN0000014727,2024-09-20T05:50:48,ACC00005000,Payment,951.06,-986674.9,EUR,Target
TXN0000014728,2024-07-01T20:52:36,ACC00001653,ATM,1799.04,-988473.94,GBP,Amazon
TXN0000014729,2024-12-23T09:02:48,ACC00006552,Credit,365.49,-988108.45,USD,Target
TXN0000014730,2024-09-07T06:13:40,ACC00005072,Transfer,839.77,-987268.68,JPY,Shell
TXN0000014731,2024-07-18T05:19:10,ACC00002241,Debit,1281.1,-988549.78,EUR,Target
TXN0000014732,2024-02-27T22:32:31,ACC00007850,Payment,476.9,-989026.68,EUR,Grocery
TXN0000014733,2024-10-08T04:21:19,ACC00003078,Debit,618.73,-989645.41,USD,Starbucks
TXN0000014734,2024-07-27T00:55:40,ACC00009927,Payment,249.83,-989895.24,GBP,Walmart
TXN0000014735,2024-05-03T18:22:14,ACC00000287,Transfer,145.99,-989749.25,USD,Starbucks
TXN0000014736,2024-08-03T18:35:02,ACC00006029,Payment,634.82,-990384.07,EUR,Shell
TXN0000014737,2024-01-01T03:21:24,ACC00000374,Credit,14.91,-990369.16,EUR,Shell
TXN0000014738,2024-06-28T18:18:38,ACC00006343,Credit,1678.12,-988691.04,JPY,Restaurant
TXN0000014739,2024-09-28T15:36:46,ACC00000633,ATM,398.23,-989089.27,GBP,Starbucks
TXN0000014740,2024-03-02T23:43:10,ACC00002567,Transfer,640.09,-988449.18,JPY,Starbucks
TXN0000014741,2024-02-17T05:51:25,ACC00007212,Debit,394.55,-988843.73,GBP,Walmart
TXN0000014742,2024-12-28T11:20:42,ACC00009718,Credit,612.78,-988230.95,USD,Online Store
TXN0000014743,2024-11-26T18:12:20,ACC00001870,Payment,1873.39,-990104.34,GBP,Starbucks
TXN0000014744,2024-03-04T14:51:10,ACC00008993,Debit,938.1,-991042.44,USD,Shell
TXN0000014745,2024-09-28T10:47:48,ACC00009646,Credit,1749.27,-989293.17,USD,Starbucks
TXN0000014746,2024-01-25T05:02:02,ACC00002310,Payment,1783.17,-991076.34,USD,Starbucks
TXN0000014747,2024-02-10T09:56:26,ACC00003442,Credit,375.3,-990701.04,JPY,Walmart
TXN0000014748,2024-06-28T13:55:16,ACC00004908,ATM,282.67,-990983.71,JPY,Walmart
TXN0000014749,2024-08-21T10:23:10,ACC00004168,Payment,1027.04,-992010.75,USD,Starbucks
TXN0000014750,2024-02-04T06:45:44,ACC00006254,Transfer,358.47,-991652.28,JPY,Restaurant
TXN0000014751,2024-01-13T12:21:52,ACC00006785,Credit,1278.57,-990373.71,GBP,Walmart
TXN0000014752,2024-11-15T16:57:59,ACC00005991,Credit,422.18,-989951.53,JPY,Target
TXN0000014753,2024-02-07T10:01:20,ACC00004006,Payment,195.52,-990147.05,JPY,Starbucks
TXN0000014754,2024-12-26T10:32:24,ACC00006573,Credit,22.92,-990124.13,EUR,Amazon
TXN0000014755,2024-01-22T02:01:56,ACC00007669,Debit,171.94,-990296.07,JPY,Amazon
TXN0000014756,2024-08-31T12:52:13,ACC00004659,Payment,1719.64,-992015.71,EUR,Shell
TXN0000014757,2024-10-25T23:30:23,ACC00001109,Credit,1898.2,-990117.51,GBP,Online Store
TXN0000014758,2024-05-10T01:23:42,ACC00007400,ATM,1975.59,-992093.1,GBP,Walmart
TXN0000014759,2024-09-28T17:28:03,ACC00008054,Payment,754.01,-992847.11,EUR,Walmart
TXN0000014760,2024-04-15T19:28:19,ACC00004220,Credit,288.95,-992558.16,GBP,Shell
TXN0000014761,2024-04-06T05:35:27,ACC00005167,Credit,915.42,-991642.74,GBP,Grocery
TXN0000014762,2024-09-08T19:20:47,ACC00000184,Payment,1757.92,-993400.66,USD,Target
TXN0000014763,2024-01-21T11:09:07,ACC00006686,Credit,1306.46,-992094.2,GBP,Shell
TXN0000014764,2024-02-04T12:48:09,ACC00002930,ATM,1183.94,-993278.14,EUR,Restaurant
TXN0000014765,2024-07-17T00:18:03,ACC00004131,Transfer,16.19,-993261.95,GBP,Amazon
TXN0000014766,2024-03-07T20:34:05,ACC00001232,Payment,608.1,-993870.05,GBP,Grocery
TXN0000014767,2024-05-10T01:21:02,ACC00003547,Transfer,1375.6,-992494.45,USD,Grocery
TXN0000014768,2024-05-06T09:10:37,ACC00009400,Payment,1189.43,-993683.88,EUR,Grocery
TXN0000014769,2024-06-16T00:32:49,ACC00003958,Payment,165.53,-993849.41,GBP,Starbucks
TXN0000014770,2024-12-01T19:54:45,ACC00003026,Transfer,1495.99,-992353.42,EUR,Shell
TXN0000014771,2024-05-08T05:23:44,ACC00003296,Credit,1805.43,-990547.99,EUR,Grocery
TXN0000014772,2024-12-08T22:15:16,ACC00003527,Credit,80.06,-990467.93,EUR,Amazon
TXN0000014773,2024-01-18T19:37:22,ACC00004231,ATM,1616.64,-992084.57,EUR,Target
TXN0000014774,2024-12-02T06:52:09,ACC00005652,Debit,1514.99,-993599.56,USD,Target
TXN0000014775,2024-09-02T07:37:39,ACC00001329,Payment,375.61,-993975.17,EUR,Amazon
TXN0000014776,2024-02-14T02:04:48,ACC00006346,Transfer,1380.64,-992594.53,EUR,Walmart
TXN0000014777,2024-04-24T19:56:45,ACC00006877,Debit,1860.39,-994454.92,EUR,Grocery
TXN0000014778,2024-03-26T11:00:07,ACC00008241,Transfer,761.54,-993693.38,USD,Shell
TXN0000014779,2024-08-10T17:35:28,ACC00006181,ATM,261.98,-993955.36,EUR,Starbucks
TXN0000014780,2024-06-25T18:47:34,ACC00004879,Debit,241.73,-994197.09,GBP,Shell
TXN0000014781,2024-11-05T12:47:18,ACC00008943,Debit,1464.81,-995661.9,EUR,Amazon
TXN0000014782,2024-03-21T03:59:34,ACC00004850,Payment,1559.52,-997221.42,JPY,Shell
TXN0000014783,2024-12-06T19:20:05,ACC00005005,Debit,1005.44,-998226.86,USD,Restaurant
TXN0000014784,2024-02-09T08:48:38,ACC00005544,Payment,455.9,-998682.76,USD,Shell
TXN0000014785,2024-03-04T07:07:02,ACC00009937,Debit,180.04,-998862.8,EUR,Target
TXN0000014786,2024-05-20T05:35:26,ACC00004590,Payment,569.59,-999432.39,JPY,Target
TXN0000014787,2024-08-07T00:29:39,ACC00007006,Debit,219.39,-999651.78,EUR,Walmart
TXN0000014788,2024-05-06T06:59:33,ACC00006581,Credit,222.17,-999429.61,USD,Grocery
TXN0000014789,2024-05-19T13:02:57,ACC00000669,Transfer,751.62,-998677.99,USD,Restaurant
TXN0000014790,2024-08-22T23:46:21,ACC00003512,Payment,753.31,-999431.3,JPY,Amazon
TXN0000014791,2024-06-14T09:18:45,ACC00005469,Transfer,1755.43,-997675.87,EUR,Walmart
TXN0000014792,2024-04-19T07:10:11,ACC00000460,Debit,1977.53,-999653.4,EUR,Starbucks
TXN0000014793,2024-09-09T01:02:06,ACC00009723,Credit,1440.57,-998212.83,GBP,Walmart
TXN0000014794,2024-07-26T08:46:21,ACC00002540,ATM,1379.5,-999592.33,USD,Online Store
TXN0000014795,2024-01-01T04:31:42,ACC00000086,Transfer,1913.59,-997678.74,USD,Starbucks
TXN0000014796,2024-05-25T02:48:06,ACC00006845,Payment,1894.33,-999573.07,JPY,Restaurant
TXN0000014797,2024-01-29T02:49:26,ACC00000565,Credit,1602.82,-997970.25,GBP,Target
TXN0000014798,2024-07-11T14:15:48,ACC00003596,Transfer,581.07,-997389.18,JPY,Shell
TXN0000014799,2024-02-17T13:07:04,ACC00003823,Transfer,1685.23,-995703.95,USD,Grocery
TXN0000014800,2024-07-08T08:14:24,ACC00006508,Debit,211.78,-995915.73,JPY,Shell
TXN0000014801,2024-01-15T20:40:02,ACC00004209,Debit,534.3,-996450.03,EUR,Target
TXN0000014802,2024-02-24T15:31:16,ACC00000973,ATM,1549.3,-997999.33,JPY,Online Store
TXN0000014803,2024-06-01T06:26:43,ACC00004771,ATM,1397.3,-999396.63,JPY,Starbucks
TXN0000014804,2024-03-06T10:49:28,ACC00002467,Payment,671.27,-1000067.9,GBP,Target
TXN0000014805,2024-01-11T22:30:43,ACC00005231,Transfer,416.11,-999651.79,JPY,Amazon
TXN0000014806,2024-10-07T23:04:57,ACC00003983,ATM,870.85,-1000522.64,JPY,Starbucks
TXN0000014807,2024-01-07T21:06:26,ACC00009882,ATM,1499.61,-1002022.25,JPY,Shell
TXN0000014808,2024-01-28T09:26:56,ACC00003184,Transfer,1717.07,-1000305.18,JPY,Online Store
TXN0000014809,2024-10-17T21:48:54,ACC00001596,Transfer,1540.43,-998764.75,EUR,Restaurant
TXN0000014810,2024-10-09T11:52:13,ACC00008896,Credit,1186.29,-997578.46,GBP,Shell
TXN0000014811,2024-03-11T17:39:03,ACC00000160,Debit,966.58,-998545.04,EUR,Grocery
TXN0000014812,2024-12-15T13:27:50,ACC00007285,Payment,1753.82,-1000298.86,GBP,Walmart
TXN0000014813,2024-07-29T23:40:57,ACC00007726,Transfer,1220.96,-999077.9,EUR,Amazon
TXN0000014814,2024-04-09T00:16:06,ACC00002577,Transfer,304.92,-998772.98,USD,Amazon
TXN0000014815,2024-08-15T03:28:39,ACC00004044,Payment,1474.55,-1000247.53,EUR,Amazon
TXN0000014816,2024-05-23T12:27:07,ACC00006300,Transfer,1468.0,-998779.53,USD,Online Store
TXN0000014817,2024-10-11T11:44:36,ACC00004678,Transfer,448.1,-998331.43,GBP,Amazon
TXN0000014818,2024-10-14T05:49:34,ACC00007378,ATM,515.96,-998847.39,EUR,Online Store
TXN0000014819,2024-08-07T05:59:54,ACC00001263,Transfer,1004.92,-997842.47,JPY,Amazon
TXN0000014820,2024-08-05T16:59:17,ACC00006602,Credit,1700.86,-996141.61,USD,Walmart
TXN0000014821,2024-02-12T18:23:58,ACC00002588,Transfer,1901.18,-994240.43,JPY,Shell
TXN0000014822,2024-01-25T16:11:05,ACC00002641,Transfer,1837.58,-992402.85,JPY,Online Store
TXN0000014823,2024-08-30T09:54:48,ACC00005422,Debit,1686.83,-994089.68,USD,Restaurant
TXN0000014824,2024-05-10T01:53:05,ACC00004866,ATM,1234.72,-995324.4,JPY,Walmart
TXN0000014825,2024-01-14T04:35:33,ACC00004349,Payment,582.6,-995907.0,USD,Online Store
TXN0000014826,2024-05-08T08:53:35,ACC00009423,Transfer,526.11,-995380.89,GBP,Target
TXN0000014827,2024-09-06T18:56:59,ACC00008299,ATM,1498.29,-996879.18,JPY,Restaurant
TXN0000014828,2024-04-27T13:15:03,ACC00006740,Transfer,1461.79,-995417.39,EUR,Grocery
TXN0000014829,2024-05-11T02:14:01,ACC00001758,Debit,1388.43,-996805.82,JPY,Starbucks
TXN0000014830,2024-10-25T22:59:41,ACC00000529,Payment,515.08,-997320.9,GBP,Restaurant
TXN0000014831,2024-03-11T13:58:37,ACC00004489,ATM,1306.21,-998627.11,USD,Amazon
TXN0000014832,2024-12-01T09:35:07,ACC00009809,Credit,1147.06,-997480.05,GBP,Target
TXN0000014833,2024-06-11T04:04:44,ACC00005672,Debit,74.91,-997554.96,GBP,Starbucks
TXN0000014834,2024-10-02T14:29:27,ACC00006384,Credit,379.65,-997175.31,JPY,Starbucks
TXN0000014835,2024-11-03T10:40:35,ACC00009441,Debit,1196.29,-998371.6,JPY,Restaurant
TXN0000014836,2024-07-20T17:05:25,ACC00000540,ATM,1873.87,-1000245.47,JPY,Starbucks
TXN0000014837,2024-09-21T20:57:06,ACC00005702,ATM,1474.48,-1001719.95,JPY,Target
TXN0000014838,2024-09-01T05:03:28,ACC00003584,Credit,436.59,-1001283.36,GBP,Restaurant
TXN0000014839,2024-10-12T12:46:46,ACC00004941,Credit,158.65,-1001124.71,USD,Amazon
TXN0000014840,2024-03-07T00:58:51,ACC00008222,Transfer,560.23,-1000564.48,USD,Shell
TXN0000014841,2024-06-09T04:42:08,ACC00003716,ATM,822.28,-1001386.76,USD,Amazon
TXN0000014842,2024-05-31T05:22:59,ACC00006986,Payment,220.61,-1001607.37,USD,Restaurant
TXN0000014843,2024-06-11T12:31:36,ACC00009444,Payment,29.77,-1001637.14,USD,Restaurant
TXN0000014844,2024-07-24T01:30:01,ACC00000716,Payment,1704.31,-1003341.45,GBP,Online Store
TXN0000014845,2024-06-04T12:06:27,ACC00008095,Payment,581.7,-1003923.15,JPY,Amazon
TXN0000014846,2024-07-07T11:54:43,ACC00006714,Transfer,1977.45,-1001945.7,USD,Grocery
TXN0000014847,2024-05-07T00:28:58,ACC00009859,Payment,967.42,-1002913.12,JPY,Amazon
TXN0000014848,2024-03-11T08:36:45,ACC00007100,Payment,1760.57,-1004673.69,USD,Walmart
TXN0000014849,2024-05-22T16:51:29,ACC00009909,Debit,1540.58,-1006214.27,USD,Target
TXN0000014850,2024-06-06T04:19:24,ACC00002977,Transfer,217.12,-1005997.15,USD,Shell
TXN0000014851,2024-11-25T04:22:23,ACC00005355,Debit,463.76,-1006460.91,USD,Starbucks
TXN0000014852,2024-06-30T23:33:37,ACC00006077,Credit,624.8,-1005836.11,EUR,Shell
TXN0000014853,2024-10-05T11:12:23,ACC00002057,Payment,1443.66,-1007279.77,USD,Amazon
TXN0000014854,2024-05-30T23:13:35,ACC00000001,Payment,1363.48,-1008643.25,EUR,Grocery
TXN0000014855,2024-12-13T05:02:59,ACC00006980,Transfer,517.22,-1008126.03,GBP,Walmart
TXN0000014856,2024-09-02T18:23:05,ACC00006106,Payment,1346.44,-1009472.47,JPY,Target
TXN0000014857,2024-06-17T02:59:56,ACC00009998,Transfer,449.1,-1009023.37,USD,Amazon
TXN0000014858,2024-04-07T16:20:16,ACC00009738,Debit,1711.49,-1010734.86,USD,Target
TXN0000014859,2024-03-20T20:33:21,ACC00007108,Transfer,1655.84,-1009079.02,JPY,Amazon
TXN0000014860,2024-07-25T03:05:00,ACC00009740,Transfer,331.17,-1008747.85,EUR,Online Store
TXN0000014861,2024-06-04T01:40:02,ACC00006203,Payment,193.99,-1008941.84,EUR,Target
TXN0000014862,2024-08-24T00:32:55,ACC00002058,Transfer,957.53,-1007984.31,JPY,Amazon
TXN0000014863,2024-10-05T03:31:57,ACC00003440,Transfer,1438.11,-1006546.2,GBP,Grocery
TXN0000014864,2024-08-31T23:37:51,ACC00004566,Debit,1459.62,-1008005.82,GBP,Online Store
TXN0000014865,2024-08-04T10:34:38,ACC00007893,Payment,718.7,-1008724.52,EUR,Grocery
TXN0000014866,2024-04-13T02:55:12,ACC00003802,Transfer,894.16,-1007830.36,USD,Shell
TXN0000014867,2024-05-21T22:30:15,ACC00005476,ATM,211.69,-1008042.05,JPY,Shell
TXN0000014868,2024-08-09T13:58:04,ACC00005436,Debit,655.41,-1008697.46,JPY,Online Store
TXN0000014869,2024-06-24T10:27:12,ACC00003860,Credit,837.69,-1007859.77,GBP,Amazon
TXN0000014870,2024-11-03T05:56:08,ACC00006422,Payment,393.99,-1008253.76,EUR,Grocery
TXN0000014871,2024-06-29T22:15:38,ACC00001130,Credit,1998.8,-1006254.96,EUR,Starbucks
TXN0000014872,2024-11-30T04:57:17,ACC00006999,Debit,1358.0,-1007612.96,JPY,Shell
TXN0000014873,2024-07-11T07:59:32,ACC00008440,Credit,1814.61,-1005798.35,GBP,Restaurant
TXN0000014874,2024-04-25T04:17:38,ACC00004026,Payment,113.89,-1005912.24,GBP,Grocery
TXN0000014875,2024-01-24T12:37:50,ACC00006431,Debit,1858.7,-1007770.94,EUR,Shell
TXN0000014876,2024-12-19T10:12:34,ACC00005184,Credit,1939.67,-1005831.27,USD,Amazon
TXN0000014877,2024-01-03T03:20:26,ACC00003960,Credit,1510.39,-1004320.88,JPY,Shell
TXN0000014878,2024-05-07T18:44:37,ACC00003129,Debit,571.05,-1004891.93,GBP,Shell
TXN0000014879,2024-07-14T20:57:56,ACC00006699,ATM,1990.02,-1006881.95,GBP,Grocery
TXN0000014880,2024-09-02T02:13:50,ACC00009161,Credit,548.17,-1006333.78,EUR,Restaurant
TXN0000014881,2024-11-22T00:04:43,ACC00002206,ATM,810.13,-1007143.91,JPY,Grocery
TXN0000014882,2024-07-07T14:07:38,ACC00005700,Payment,354.63,-1007498.54,USD,Shell
TXN0000014883,2024-02-06T07:31:41,ACC00009081,Transfer,352.31,-1007146.23,GBP,Amazon
TXN0000014884,2024-11-04T06:19:20,ACC00005227,ATM,1733.43,-1008879.66,JPY,Walmart
TXN0000014885,2024-01-20T22:47:09,ACC00002108,Debit,1336.91,-1010216.57,USD,Amazon
TXN0000014886,2024-06-22T14:26:26,ACC00001466,ATM,450.88,-1010667.45,JPY,Amazon
TXN0000014887,2024-02-04T03:39:58,ACC00001579,ATM,1974.04,-1012641.49,JPY,Online Store
TXN0000014888,2024-05-22T02:15:50,ACC00008996,Debit,391.96,-1013033.45,EUR,Starbucks
TXN0000014889,2024-08-11T21:15:48,ACC00001963,Credit,357.38,-1012676.07,EUR,Restaurant
TXN0000014890,2024-11-29T19:23:04,ACC00003448,Transfer,1326.95,-1011349.12,JPY,Target
TXN0000014891,2024-10-15T20:04:43,ACC00002916,Payment,1664.93,-1013014.05,EUR,Walmart
TXN0000014892,2024-08-12T22:15:31,ACC00005653,Credit,476.87,-1012537.18,EUR,Walmart
TXN0000014893,2024-08-28T22:57:18,ACC00002048,Debit,480.75,-1013017.93,GBP,Shell
TXN0000014894,2024-07-19T23:22:39,ACC00007843,ATM,1872.65,-1014890.58,EUR,Walmart
TXN0000014895,2024-09-26T00:39:36,ACC00005149,Debit,1978.05,-1016868.63,GBP,Walmart
TXN0000014896,2024-09-29T15:29:05,ACC00004788,Transfer,1881.83,-1014986.8,GBP,Grocery
TXN0000014897,2024-02-03T11:11:59,ACC00006964,Payment,1308.04,-1016294.84,JPY,Starbucks
TXN0000014898,2024-06-04T15:03:15,ACC00009234,Debit,1512.18,-1017807.02,USD,Grocery
TXN0000014899,2024-01-18T01:36:43,ACC00006769,Transfer,1185.75,-1016621.27,JPY,Restaurant
TXN0000014900,2024-06-25T02:57:13,ACC00000640,Debit,599.89,-1017221.16,GBP,Restaurant
TXN0000014901,2024-12-04T09:28:12,ACC00001273,Payment,1150.11,-1018371.27,EUR,Online Store
TXN0000014902,2024-08-10T10:03:08,ACC00005472,Payment,1115.43,-1019486.7,USD,Walmart
TXN0000014903,2024-06-18T00:37:17,ACC00008014,Credit,439.43,-1019047.27,GBP,Amazon
TXN0000014904,2024-06-30T03:50:38,ACC00004160,Payment,781.58,-1019828.85,GBP,Restaurant
TXN0000014905,2024-04-14T23:23:39,ACC00008691,Transfer,1545.41,-1018283.44,USD,Starbucks
TXN0000014906,2024-03-16T09:36:47,ACC00004353,Credit,1958.04,-1016325.4,USD,Walmart
TXN0000014907,2024-06-07T16:54:02,ACC00006045,Debit,888.11,-1017213.51,USD,Starbucks
TXN0000014908,2024-02-06T23:55:38,ACC00006145,Payment,481.44,-1017694.95,EUR,Target
TXN0000014909,2024-02-11T12:46:48,ACC00001311,Debit,1879.13,-1019574.08,GBP,Online Store
TXN0000014910,2024-10-14T05:40:18,ACC00008178,Debit,462.74,-1020036.82,USD,Starbucks
TXN0000014911,2024-06-24T12:22:40,ACC00001865,Transfer,166.78,-1019870.04,JPY,Walmart
TXN0000014912,2024-04-03T19:40:22,ACC00007948,Transfer,1437.24,-1018432.8,JPY,Starbucks
TXN0000014913,2024-08-31T13:20:11,ACC00009740,Payment,1068.25,-1019501.05,EUR,Target
TXN0000014914,2024-03-10T16:21:05,ACC00005189,Payment,1881.91,-1021382.96,JPY,Restaurant
TXN0000014915,2024-01-19T07:48:30,ACC00006709,Transfer,12.71,-1021370.25,EUR,Amazon
TXN0000014916,2024-03-12T07:30:52,ACC00002506,ATM,1901.82,-1023272.07,JPY,Shell
TXN0000014917,2024-11-06T09:30:32,ACC00009121,Credit,1290.15,-1021981.92,USD,Restaurant
TXN0000014918,2024-06-10T06:44:52,ACC00007388,Payment,848.69,-1022830.61,JPY,Amazon
TXN0000014919,2024-02-15T04:43:04,ACC00003870,Payment,499.14,-1023329.75,GBP,Starbucks
TXN0000014920,2024-07-17T23:16:24,ACC00001706,Payment,87.52,-1023417.27,USD,Restaurant
TXN0000014921,2024-08-22T19:51:35,ACC00007955,Debit,346.46,-1023763.73,EUR,Shell
TXN0000014922,2024-07-14T07:59:54,ACC00005834,Transfer,1099.84,-1022663.89,GBP,Starbucks
TXN0000014923,2024-10-22T15:11:16,ACC00009457,ATM,143.53,-1022807.42,USD,Online Store
TXN0000014924,2024-03-10T17:36:38,ACC00007076,Debit,1932.9,-1024740.32,EUR,Target
TXN0000014925,2024-11-30T03:52:05,ACC00006525,Transfer,309.79,-1024430.53,USD,Grocery
TXN0000014926,2024-04-15T16:54:39,ACC00009327,Payment,1298.08,-1025728.61,GBP,Grocery
TXN0000014927,2024-11-23T18:26:11,ACC00000460,Transfer,1630.94,-1024097.67,JPY,Walmart
TXN0000014928,2024-02-22T07:58:25,ACC00005318,ATM,907.18,-1025004.85,GBP,Online Store
TXN0000014929,2024-03-07T07:13:43,ACC00005306,Transfer,467.32,-1024537.53,USD,Target
TXN0000014930,2024-05-21T03:50:16,ACC00002571,Payment,1672.2,-1026209.73,GBP,Target
TXN0000014931,2024-11-03T09:53:44,ACC00009898,ATM,322.42,-1026532.15,GBP,Online Store
TXN0000014932,2024-11-14T20:47:24,ACC00006014,ATM,990.59,-1027522.74,EUR,Grocery
TXN0000014933,2024-07-19T15:35:33,ACC00002320,ATM,699.18,-1028221.92,USD,Restaurant
TXN0000014934,2024-03-15T16:25:53,ACC00000961,Payment,1610.1,-1029832.02,GBP,Target
TXN0000014935,2024-11-05T23:09:18,ACC00003469,ATM,144.24,-1029976.26,GBP,Online Store
TXN0000014936,2024-10-09T05:59:55,ACC00007576,Payment,307.31,-1030283.57,GBP,Walmart
TXN0000014937,2024-07-16T09:43:32,ACC00007490,Payment,1920.93,-1032204.5,GBP,Walmart
TXN0000014938,2024-11-03T12:05:16,ACC00003611,Credit,1194.25,-1031010.25,EUR,Target
TXN0000014939,2024-08-13T14:29:31,ACC00006238,Debit,462.53,-1031472.78,USD,Walmart
TXN0000014940,2024-12-20T17:38:10,ACC00002977,Debit,413.42,-1031886.2,JPY,Walmart
TXN0000014941,2024-10-25T03:55:33,ACC00004467,Debit,1126.99,-1033013.19,JPY,Restaurant
TXN0000014942,2024-11-25T06:28:33,ACC00004856,Debit,1182.56,-1034195.75,JPY,Grocery
TXN0000014943,2024-04-01T01:43:42,ACC00002596,Transfer,1416.7,-1032779.05,GBP,Online Store
TXN0000014944,2024-12-08T16:38:49,ACC00007047,Credit,1681.73,-1031097.32,USD,Walmart
TXN0000014945,2024-01-31T01:17:46,ACC00002948,Payment,549.71,-1031647.03,GBP,Starbucks
TXN0000014946,2024-11-14T10:13:16,ACC00009290,Transfer,1649.45,-1029997.58,EUR,Target
TXN0000014947,2024-07-14T07:23:06,ACC00008444,Debit,1814.8,-1031812.38,JPY,Starbucks
TXN0000014948,2024-04-11T07:30:22,ACC00004383,ATM,458.24,-1032270.62,GBP,Shell
TXN0000014949,2024-07-03T21:02:07,ACC00003452,Transfer,1534.59,-1030736.03,USD,Online Store
TXN0000014950,2024-02-15T11:38:55,ACC00002590,ATM,1187.31,-1031923.34,JPY,Online Store
TXN0000014951,2024-02-06T17:25:23,ACC00008635,Debit,1707.35,-1033630.69,GBP,Online Store
TXN0000014952,2024-06-08T13:51:56,ACC00006462,Debit,1185.72,-1034816.41,EUR,Walmart
TXN0000014953,2024-07-17T06:12:41,ACC00003606,Debit,177.21,-1034993.62,GBP,Walmart
TXN0000014954,2024-10-06T02:08:15,ACC00000451,Credit,406.47,-1034587.15,EUR,Walmart
TXN0000014955,2024-11-24T01:21:13,ACC00007335,Debit,1266.63,-1035853.78,JPY,Online Store
TXN0000014956,2024-11-26T12:30:42,ACC00008538,Transfer,489.04,-1035364.74,GBP,Online Store
TXN0000014957,2024-05-20T07:02:56,ACC00000494,Payment,860.13,-1036224.87,JPY,Online Store
TXN0000014958,2024-05-18T08:20:32,ACC00005122,Payment,1004.64,-1037229.51,GBP,Online Store
TXN0000014959,2024-02-22T16:06:50,ACC00009077,Payment,467.03,-1037696.54,JPY,Restaurant
TXN0000014960,2024-08-28T19:22:17,ACC00000450,ATM,872.81,-1038569.35,USD,Grocery
TXN0000014961,2024-08-16T09:28:29,ACC00003246,Payment,1261.05,-1039830.4,GBP,Amazon
TXN0000014962,2024-03-06T17:34:54,ACC00003748,Payment,1073.48,-1040903.88,JPY,Starbucks
TXN0000014963,2024-12-22T02:38:25,ACC00007418,Payment,178.38,-1041082.26,JPY,Amazon
TXN0000014964,2024-12-10T21:46:46,ACC00001715,Payment,885.02,-1041967.28,USD,Amazon
TXN0000014965,2024-03-24T16:10:53,ACC00005866,ATM,1215.29,-1043182.57,EUR,Starbucks
TXN0000014966,2024-11-14T07:02:26,ACC00006666,Payment,1201.22,-1044383.79,USD,Starbucks
TXN0000014967,2024-02-08T12:49:12,ACC00007133,Debit,1164.43,-1045548.22,GBP,Starbucks
TXN0000014968,2024-06-20T17:10:56,ACC00009091,Transfer,1718.1,-1043830.12,JPY,Grocery
TXN0000014969,2024-05-01T09:55:53,ACC00001335,Transfer,1485.99,-1042344.13,GBP,Shell
TXN0000014970,2024-10-06T15:39:12,ACC00008683,Credit,1219.56,-1041124.57,EUR,Grocery
TXN0000014971,2024-03-13T00:30:27,ACC00003359,Payment,1387.16,-1042511.73,GBP,Restaurant
TXN0000014972,2024-02-07T01:41:56,ACC00004406,Debit,904.87,-1043416.6,EUR,Restaurant
TXN0000014973,2024-03-08T13:55:12,ACC00005769,Credit,1480.38,-1041936.22,JPY,Starbucks
TXN0000014974,2024-01-03T13:42:45,ACC00002132,Transfer,1331.35,-1040604.87,GBP,Starbucks
TXN0000014975,2024-10-21T04:05:12,ACC00002426,Transfer,1634.0,-1038970.87,EUR,Grocery
TXN0000014976,2024-04-14T18:56:06,ACC00008310,Credit,746.83,-1038224.04,GBP,Restaurant
TXN0000014977,2024-01-20T01:52:11,ACC00001506,Transfer,1637.9,-1036586.14,USD,Walmart
TXN0000014978,2024-07-28T00:42:37,ACC00008146,ATM,194.57,-1036780.71,USD,Restaurant
TXN0000014979,2024-12-29T03:55:45,ACC00001496,Transfer,1222.75,-1035557.96,JPY,Starbucks
TXN0000014980,2024-02-09T03:35:58,ACC00005445,Transfer,1447.0,-1034110.96,GBP,Restaurant
TXN0000014981,2024-12-10T00:11:44,ACC00000188,ATM,962.14,-1035073.1,GBP,Online Store
TXN0000014982,2024-05-01T22:50:34,ACC00001564,ATM,1896.0,-1036969.1,EUR,Starbucks
TXN0000014983,2024-11-30T14:59:53,ACC00000167,Debit,738.26,-1037707.36,GBP,Target
TXN0000014984,2024-12-20T13:24:55,ACC00006452,Debit,293.61,-1038000.97,EUR,Target
TXN0000014985,2024-12-04T07:44:54,ACC00005869,Debit,409.43,-1038410.4,GBP,Walmart
TXN0000014986,2024-02-29T10:36:01,ACC00007740,Debit,1177.14,-1039587.54,USD,Restaurant
TXN0000014987,2024-11-30T09:05:07,ACC00005218,Debit,31.51,-1039619.05,USD,Restaurant
TXN0000014988,2024-05-30T06:03:34,ACC00004949,ATM,579.21,-1040198.26,JPY,Amazon
TXN0000014989,2024-07-17T21:33:26,ACC00006749,Payment,1520.9,-1041719.16,USD,Target
TXN0000014990,2024-03-06T19:43:23,ACC00006138,Payment,617.73,-1042336.89,USD,Walmart
TXN0000014991,2024-07-11T15:44:55,ACC00007448,ATM,280.03,-1042616.92,EUR,Shell
TXN0000014992,2024-01-20T00:32:54,ACC00007474,ATM,341.1,-1042958.02,JPY,Restaurant
TXN0000014993,2024-07-23T21:52:02,ACC00001447,Debit,987.41,-1043945.43,JPY,Starbucks
TXN0000014994,2024-07-20T15:06:21,ACC00007012,Debit,582.85,-1044528.28,EUR,Amazon
TXN0000014995,2024-12-21T23:19:59,ACC00003046,ATM,1937.09,-1046465.37,GBP,Shell
TXN0000014996,2024-09-18T17:25:46,ACC00004425,Credit,1091.34,-1045374.03,JPY,Shell
TXN0000014997,2024-08-27T14:49:36,ACC00005337,Transfer,1961.99,-1043412.04,GBP,Starbucks
TXN0000014998,2024-08-11T01:32:24,ACC00006117,Transfer,376.61,-1043035.43,JPY,Grocery
TXN0000014999,2024-08-07T07:05:24,ACC00009504,ATM,526.05,-1043561.48,GBP,Starbucks
TXN0000015000,2024-01-25T14:06:41,ACC00002195,ATM,358.3,-1043919.78,GBP,Shell
TXN0000015001,2024-01-11T06:55:10,ACC00006485,ATM,820.26,-1044740.04,EUR,Target
TXN0000015002,2024-06-03T04:01:53,ACC00007032,Credit,760.95,-1043979.09,JPY,Restaurant
TXN0000015003,2024-05-15T08:38:35,ACC00006324,ATM,522.75,-1044501.84,GBP,Online Store
TXN0000015004,2024-11-11T22:21:33,ACC00002176,Credit,692.62,-1043809.22,EUR,Target
TXN0000015005,2024-05-05T12:45:23,ACC00001243,ATM,1179.28,-1044988.5,USD,Restaurant
TXN0000015006,2024-09-26T15:54:31,ACC00008172,Payment,1568.25,-1046556.75,EUR,Online Store
TXN0000015007,2024-06-14T03:53:35,ACC00005863,Payment,406.23,-1046962.98,USD,Restaurant
TXN0000015008,2024-07-26T09:36:08,ACC00000338,ATM,18.21,-1046981.19,JPY,Starbucks
TXN0000015009,2024-07-29T14:56:06,ACC00004117,ATM,1365.97,-1048347.16,EUR,Shell
TXN0000015010,2024-06-22T05:09:41,ACC00002039,Transfer,1053.07,-1047294.09,USD,Restaurant
TXN0000015011,2024-12-19T02:59:10,ACC00009572,Payment,1791.37,-1049085.46,GBP,Starbucks
TXN0000015012,2024-03-10T10:04:37,ACC00004093,Transfer,105.31,-1048980.15,USD,Online Store
TXN0000015013,2024-01-06T20:18:57,ACC00004592,ATM,1535.99,-1050516.14,JPY,Starbucks
TXN0000015014,2024-02-15T22:38:27,ACC00008547,Credit,1399.52,-1049116.62,EUR,Shell
TXN0000015015,2024-04-30T23:15:40,ACC00003822,ATM,1740.92,-1050857.54,USD,Grocery
TXN0000015016,2024-08-27T12:38:13,ACC00007000,Transfer,65.27,-1050792.27,USD,Target
TXN0000015017,2024-08-05T15:45:17,ACC00001041,Transfer,1504.44,-1049287.83,USD,Online Store
TXN0000015018,2024-03-08T00:28:21,ACC00009314,Payment,692.23,-1049980.06,JPY,Amazon
TXN0000015019,2024-01-02T02:36:27,ACC00008134,Debit,1332.35,-1051312.41,JPY,Restaurant
TXN0000015020,2024-09-23T18:43:21,ACC00007984,Payment,1365.26,-1052677.67,EUR,Grocery
TXN0000015021,2024-09-11T01:49:54,ACC00003543,Debit,1126.27,-1053803.94,GBP,Shell
TXN0000015022,2024-06-17T07:16:48,ACC00003929,ATM,1938.01,-1055741.95,EUR,Online Store
TXN0000015023,2024-08-01T08:50:54,ACC00008201,Debit,1282.47,-1057024.42,EUR,Grocery
TXN0000015024,2024-11-14T21:44:46,ACC00000165,Payment,1835.47,-1058859.89,EUR,Amazon
TXN0000015025,2024-02-09T02:20:32,ACC00001378,Transfer,210.09,-1058649.8,EUR,Walmart
TXN0000015026,2024-04-06T18:03:02,ACC00009732,Debit,1610.72,-1060260.52,GBP,Amazon
TXN0000015027,2024-12-22T16:02:33,ACC00009435,Credit,1652.68,-1058607.84,GBP,Target
TXN0000015028,2024-11-16T17:40:03,ACC00000109,Transfer,687.06,-1057920.78,USD,Grocery
TXN0000015029,2024-06-13T01:44:55,ACC00007094,Debit,843.55,-1058764.33,GBP,Walmart
TXN0000015030,2024-08-26T22:35:46,ACC00006450,Transfer,1825.32,-1056939.01,EUR,Restaurant
TXN0000015031,2024-01-06T18:03:07,ACC00000081,Debit,311.71,-1057250.72,EUR,Shell
TXN0000015032,2024-01-10T00:21:44,ACC00004403,Debit,635.71,-1057886.43,EUR,Online Store
TXN0000015033,2024-07-21T09:17:43,ACC00006588,Debit,15.78,-1057902.21,EUR,Shell
TXN0000015034,2024-11-24T16:06:43,ACC00004674,Payment,1253.66,-1059155.87,GBP,Restaurant
TXN0000015035,2024-09-13T20:58:11,ACC00007455,ATM,1843.0,-1060998.87,JPY,Shell
TXN0000015036,2024-06-01T23:01:49,ACC00004409,Debit,307.14,-1061306.01,EUR,Restaurant
TXN0000015037,2024-05-13T08:14:11,ACC00007408,Credit,1029.15,-1060276.86,GBP,Online Store
TXN0000015038,2024-12-26T19:57:59,ACC00006256,Transfer,1254.47,-1059022.39,EUR,Online Store
TXN0000015039,2024-06-22T05:22:07,ACC00002798,ATM,1095.26,-1060117.65,USD,Target
TXN0000015040,2024-08-30T09:52:05,ACC00000831,Payment,1321.99,-1061439.64,EUR,Target
TXN0000015041,2024-10-24T03:42:05,ACC00009877,Payment,48.97,-1061488.61,USD,Restaurant
TXN0000015042,2024-02-07T12:38:28,ACC00007471,Credit,396.52,-1061092.09,USD,Amazon
TXN0000015043,2024-10-01T15:14:46,ACC00008526,Payment,961.1,-1062053.19,EUR,Target
TXN0000015044,2024-09-17T13:00:09,ACC00009271,Credit,1392.17,-1060661.02,JPY,Starbucks
TXN0000015045,2024-09-10T01:23:09,ACC00002374,Transfer,1404.85,-1059256.17,JPY,Amazon
TXN0000015046,2024-12-07T16:21:36,ACC00009137,Transfer,1726.53,-1057529.64,GBP,Starbucks
TXN0000015047,2024-02-03T23:44:46,ACC00008895,Transfer,1559.55,-1055970.09,USD,Target
TXN0000015048,2024-10-19T05:02:52,ACC00005513,Transfer,455.28,-1055514.81,USD,Grocery
TXN0000015049,2024-10-27T18:44:55,ACC00005371,Debit,154.1,-1055668.91,JPY,Shell
TXN0000015050,2024-12-04T12:15:01,ACC00008131,Payment,172.89,-1055841.8,GBP,Starbucks
TXN0000015051,2024-01-13T04:38:48,ACC00007397,Debit,959.02,-1056800.82,USD,Restaurant
TXN0000015052,2024-11-25T00:24:39,ACC00009442,Credit,291.62,-1056509.2,EUR,Restaurant
TXN0000015053,2024-03-08T10:43:44,ACC00006691,ATM,1629.89,-1058139.09,EUR,Amazon
TXN0000015054,2024-10-23T17:37:37,ACC00000203,Debit,1133.31,-1059272.4,EUR,Starbucks
TXN0000015055,2024-03-26T04:02:29,ACC00008924,Payment,670.24,-1059942.64,EUR,Restaurant
TXN0000015056,2024-07-29T19:00:05,ACC00003301,ATM,914.22,-1060856.86,JPY,Target
TXN0000015057,2024-12-21T06:29:04,ACC00007524,Transfer,356.34,-1060500.52,EUR,Target
TXN0000015058,2024-01-31T05:57:46,ACC00002946,Credit,174.38,-1060326.14,GBP,Grocery
TXN0000015059,2024-05-11T10:37:12,ACC00009860,Debit,72.77,-1060398.91,GBP,Walmart
TXN0000015060,2024-01-01T18:54:48,ACC00005412,Payment,54.27,-1060453.18,GBP,Restaurant
TXN0000015061,2024-09-06T03:54:56,ACC00004728,Payment,376.38,-1060829.56,GBP,Grocery
TXN0000015062,2024-09-29T11:19:45,ACC00006981,Transfer,269.55,-1060560.01,EUR,Restaurant
TXN0000015063,2024-01-19T03:09:01,ACC00002773,Payment,704.64,-1061264.65,GBP,Amazon
TXN0000015064,2024-06-16T10:49:03,ACC00004537,Transfer,1792.52,-1059472.13,JPY,Restaurant
TXN0000015065,2024-05-05T20:36:30,ACC00008271,Credit,448.36,-1059023.77,GBP,Grocery
TXN0000015066,2024-10-08T04:10:12,ACC00009160,Credit,1838.97,-1057184.8,USD,Starbucks
TXN0000015067,2024-03-17T10:25:11,ACC00000196,ATM,1615.11,-1058799.91,EUR,Shell
TXN0000015068,2024-11-09T19:16:06,ACC00003117,Credit,1628.93,-1057170.98,EUR,Shell
TXN0000015069,2024-06-18T14:28:49,ACC00006524,Credit,559.66,-1056611.32,EUR,Target
TXN0000015070,2024-11-18T16:39:50,ACC00003643,Debit,1733.65,-1058344.97,GBP,Target
TXN0000015071,2024-06-12T21:17:37,ACC00008544,Payment,469.56,-1058814.53,JPY,Restaurant
TXN0000015072,2024-09-30T02:44:39,ACC00008243,Transfer,531.38,-1058283.15,JPY,Amazon
TXN0000015073,2024-09-22T08:09:40,ACC00000066,Debit,294.22,-1058577.37,USD,Target
TXN0000015074,2024-06-05T12:30:15,ACC00001860,Payment,1973.84,-1060551.21,JPY,Grocery
TXN0000015075,2024-08-06T03:29:19,ACC00005712,Transfer,576.72,-1059974.49,EUR,Shell
TXN0000015076,2024-07-23T01:14:29,ACC00009737,Credit,716.88,-1059257.61,GBP,Grocery
TXN0000015077,2024-06-05T09:49:43,ACC00004551,Transfer,290.56,-1058967.05,GBP,Walmart
TXN0000015078,2024-10-28T12:09:25,ACC00003034,Credit,882.42,-1058084.63,EUR,Online Store
TXN0000015079,2024-03-30T21:48:49,ACC00002541,ATM,319.43,-1058404.06,GBP,Walmart
TXN0000015080,2024-04-19T02:07:42,ACC00008964,Debit,1429.71,-1059833.77,JPY,Restaurant
TXN0000015081,2024-07-26T13:24:28,ACC00008720,Transfer,419.67,-1059414.1,USD,Target
TXN0000015082,2024-08-27T00:28:16,ACC00007880,Debit,246.78,-1059660.88,EUR,Restaurant
TXN0000015083,2024-03-14T15:28:45,ACC00000960,Debit,953.86,-1060614.74,JPY,Grocery
TXN0000015084,2024-05-05T10:00:34,ACC00006296,Debit,1872.37,-1062487.11,USD,Grocery
TXN0000015085,2024-03-26T11:06:21,ACC00002958,Transfer,800.38,-1061686.73,GBP,Shell
TXN0000015086,2024-07-23T20:59:10,ACC00009850,Transfer,88.23,-1061598.5,JPY,Target
TXN0000015087,2024-03-27T14:05:17,ACC00006680,ATM,1507.6,-1063106.1,JPY,Restaurant
TXN0000015088,2024-07-30T02:40:46,ACC00002597,Credit,67.65,-1063038.45,USD,Walmart
TXN0000015089,2024-01-18T02:39:34,ACC00005169,Transfer,1339.84,-1061698.61,USD,Amazon
TXN0000015090,2024-09-10T13:40:37,ACC00009926,Debit,863.85,-1062562.46,USD,Walmart
TXN0000015091,2024-08-21T19:16:56,ACC00004932,ATM,1119.39,-1063681.85,JPY,Shell
TXN0000015092,2024-10-15T19:31:19,ACC00008537,Credit,640.54,-1063041.31,JPY,Restaurant
TXN0000015093,2024-10-10T14:04:32,ACC00006638,Credit,1038.95,-1062002.36,EUR,Shell
TXN0000015094,2024-07-11T13:43:05,ACC00005140,Debit,493.88,-1062496.24,JPY,Shell
TXN0000015095,2024-05-19T13:41:57,ACC00009715,ATM,1071.92,-1063568.16,GBP,Starbucks
TXN0000015096,2024-02-26T03:42:10,ACC00004543,Debit,981.87,-1064550.03,JPY,Amazon
TXN0000015097,2024-03-12T05:03:01,ACC00008790,Credit,595.05,-1063954.98,GBP,Target
TXN0000015098,2024-02-09T16:43:56,ACC00008796,Debit,867.36,-1064822.34,USD,Starbucks
TXN0000015099,2024-03-01T09:58:40,ACC00001283,Debit,194.79,-1065017.13,JPY,Starbucks
TXN0000015100,2024-03-23T15:09:58,ACC00007013,Debit,1069.37,-1066086.5,USD,Shell
TXN0000015101,2024-07-05T12:35:01,ACC00000282,Credit,167.01,-1065919.49,GBP,Starbucks
TXN0000015102,2024-11-18T22:00:50,ACC00003663,Debit,1377.56,-1067297.05,GBP,Grocery
TXN0000015103,2024-11-13T23:43:34,ACC00000496,Payment,1868.18,-1069165.23,EUR,Walmart
TXN0000015104,2024-03-16T07:42:03,ACC00008403,Debit,736.13,-1069901.36,EUR,Restaurant
TXN0000015105,2024-11-27T19:26:12,ACC00002435,Transfer,360.56,-1069540.8,GBP,Starbucks
TXN0000015106,2024-11-20T19:19:59,ACC00003506,Credit,1789.48,-1067751.32,EUR,Grocery
TXN0000015107,2024-11-22T11:06:04,ACC00001380,Payment,1650.81,-1069402.13,USD,Walmart
TXN0000015108,2024-02-03T22:03:11,ACC00007088,Transfer,703.07,-1068699.06,USD,Grocery
TXN0000015109,2024-11-11T12:38:41,ACC00008507,Transfer,100.58,-1068598.48,USD,Online Store
TXN0000015110,2024-10-10T18:43:26,ACC00003790,Debit,53.06,-1068651.54,USD,Target
TXN0000015111,2024-11-14T08:51:17,ACC00000321,Payment,439.88,-1069091.42,GBP,Online Store
TXN0000015112,2024-09-23T00:53:07,ACC00008523,Debit,255.27,-1069346.69,USD,Shell
TXN0000015113,2024-06-02T22:13:59,ACC00009664,Payment,1207.27,-1070553.96,EUR,Online Store
TXN0000015114,2024-04-04T20:35:17,ACC00008083,Payment,909.04,-1071463.0,USD,Starbucks
TXN0000015115,2024-04-03T02:32:43,ACC00006225,Credit,605.29,-1070857.71,USD,Restaurant
TXN0000015116,2024-08-05T01:50:40,ACC00006405,Transfer,1957.74,-1068899.97,EUR,Target
TXN0000015117,2024-01-09T23:58:30,ACC00002798,Payment,1367.04,-1070267.01,EUR,Walmart
TXN0000015118,2024-08-28T02:57:35,ACC00008379,ATM,69.62,-1070336.63,EUR,Online Store
TXN0000015119,2024-12-08T01:44:30,ACC00000206,Debit,37.02,-1070373.65,EUR,Restaurant
TXN0000015120,2024-09-28T07:36:13,ACC00002859,ATM,1782.31,-1072155.96,USD,Shell
TXN0000015121,2024-07-01T23:55:08,ACC00003465,Transfer,1666.03,-1070489.93,JPY,Target
TXN0000015122,2024-01-02T15:08:38,ACC00002261,ATM,1483.86,-1071973.79,GBP,Online Store
TXN0000015123,2024-01-23T22:08:52,ACC00000858,ATM,683.05,-1072656.84,GBP,Amazon
TXN0000015124,2024-09-14T03:43:13,ACC00005941,Transfer,1071.56,-1071585.28,JPY,Grocery
TXN0000015125,2024-08-18T15:12:48,ACC00007200,Transfer,584.48,-1071000.8,JPY,Starbucks
TXN0000015126,2024-01-13T16:31:53,ACC00009316,Credit,1541.72,-1069459.08,JPY,Shell
TXN0000015127,2024-11-19T00:01:24,ACC00000828,Debit,980.46,-1070439.54,USD,Amazon
TXN0000015128,2024-03-18T15:05:35,ACC00001253,Payment,1459.23,-1071898.77,USD,Restaurant
TXN0000015129,2024-08-18T18:38:24,ACC00004830,Credit,694.82,-1071203.95,JPY,Online Store
TXN0000015130,2024-06-07T06:13:46,ACC00008737,Credit,1815.15,-1069388.8,USD,Amazon
TXN0000015131,2024-04-25T11:57:23,ACC00005804,Payment,1986.85,-1071375.65,USD,Restaurant
TXN0000015132,2024-12-21T19:42:24,ACC00007342,Credit,550.95,-1070824.7,GBP,Shell
TXN0000015133,2024-09-28T12:17:50,ACC00005474,ATM,1893.95,-1072718.65,EUR,Restaurant
TXN0000015134,2024-12-26T19:43:35,ACC00007629,Debit,1618.71,-1074337.36,JPY,Starbucks
TXN0000015135,2024-05-21T17:35:41,ACC00009536,Transfer,1449.16,-1072888.2,EUR,Restaurant
TXN0000015136,2024-08-25T02:39:10,ACC00002017,ATM,1956.8,-1074845.0,USD,Starbucks
TXN0000015137,2024-03-08T02:21:04,ACC00005846,Payment,815.87,-1075660.87,GBP,Grocery
TXN0000015138,2024-10-17T18:21:18,ACC00007546,Debit,993.67,-1076654.54,GBP,Grocery
TXN0000015139,2024-02-02T20:37:47,ACC00005534,Payment,1461.55,-1078116.09,USD,Target
TXN0000015140,2024-07-08T12:19:38,ACC00001948,Payment,427.05,-1078543.14,JPY,Shell
TXN0000015141,2024-02-14T07:54:08,ACC00009576,Credit,441.45,-1078101.69,USD,Restaurant
TXN0000015142,2024-02-11T04:06:47,ACC00004466,Debit,656.72,-1078758.41,GBP,Walmart
TXN0000015143,2024-04-13T13:19:49,ACC00008010,Credit,864.21,-1077894.2,GBP,Shell
TXN0000015144,2024-01-19T01:22:21,ACC00000117,ATM,1886.64,-1079780.84,USD,Walmart
TXN0000015145,2024-02-04T04:38:30,ACC00007729,Transfer,1188.55,-1078592.29,GBP,Amazon
TXN0000015146,2024-04-07T12:56:00,ACC00008306,Credit,723.91,-1077868.38,EUR,Walmart
TXN0000015147,2024-09-18T08:21:58,ACC00006327,Payment,169.32,-1078037.7,GBP,Target
TXN0000015148,2024-07-23T10:07:04,ACC00009329,Payment,684.77,-1078722.47,JPY,Starbucks
TXN0000015149,2024-09-23T15:04:10,ACC00004831,Credit,1003.05,-1077719.42,USD,Grocery
TXN0000015150,2024-06-17T21:24:14,ACC00008019,Debit,1093.79,-1078813.21,EUR,Starbucks
TXN0000015151,2024-09-30T14:09:04,ACC00004866,ATM,503.75,-1079316.96,GBP,Shell
TXN0000015152,2024-03-02T06:45:29,ACC00007950,Transfer,1738.91,-1077578.05,GBP,Grocery
TXN0000015153,2024-10-06T11:47:18,ACC00005424,ATM,1407.24,-1078985.29,USD,Starbucks
TXN0000015154,2024-03-04T05:08:22,ACC00001417,Payment,192.32,-1079177.61,GBP,Shell
TXN0000015155,2024-12-24T16:34:03,ACC00000445,Credit,542.8,-1078634.81,GBP,Online Store
TXN0000015156,2024-11-05T05:28:01,ACC00006798,ATM,880.46,-1079515.27,EUR,Grocery
TXN0000015157,2024-09-07T20:18:17,ACC00005467,Transfer,1261.76,-1078253.51,EUR,Grocery
TXN0000015158,2024-05-25T14:31:34,ACC00003062,Credit,1195.49,-1077058.02,JPY,Online Store
TXN0000015159,2024-01-26T03:06:07,ACC00003433,Credit,620.77,-1076437.25,USD,Restaurant
TXN0000015160,2024-10-18T14:51:31,ACC00003618,Transfer,505.03,-1075932.22,JPY,Amazon
TXN0000015161,2024-03-05T08:47:02,ACC00001574,ATM,1738.67,-1077670.89,JPY,Target
TXN0000015162,2024-06-14T16:23:13,ACC00007251,ATM,1200.04,-1078870.93,GBP,Target
TXN0000015163,2024-04-14T19:52:05,ACC00000739,Transfer,245.57,-1078625.36,EUR,Shell
TXN0000015164,2024-07-06T12:57:28,ACC00004398,Credit,1091.88,-1077533.48,GBP,Grocery
TXN0000015165,2024-12-10T07:03:11,ACC00007420,ATM,50.97,-1077584.45,GBP,Restaurant
TXN0000015166,2024-08-17T21:16:48,ACC00000217,Payment,877.49,-1078461.94,GBP,Online Store
TXN0000015167,2024-11-20T09:38:00,ACC00009669,ATM,1865.18,-1080327.12,EUR,Starbucks
TXN0000015168,2024-02-02T17:01:25,ACC00006235,Payment,477.57,-1080804.69,USD,Shell
TXN0000015169,2024-01-28T21:08:23,ACC00008833,Credit,177.85,-1080626.84,JPY,Online Store
TXN0000015170,2024-07-27T11:59:45,ACC00003103,Credit,1977.14,-1078649.7,EUR,Online Store
TXN0000015171,2024-04-24T17:05:13,ACC00000617,Debit,275.87,-1078925.57,JPY,Walmart
TXN0000015172,2024-10-24T04:16:35,ACC00005703,Debit,356.85,-1079282.42,EUR,Walmart
TXN0000015173,2024-06-16T13:18:58,ACC00009864,Debit,1866.68,-1081149.1,EUR,Starbucks
TXN0000015174,2024-08-21T09:50:01,ACC00001538,Transfer,1294.11,-1079854.99,GBP,Amazon
TXN0000015175,2024-11-05T00:36:17,ACC00007525,Debit,185.41,-1080040.4,EUR,Online Store
TXN0000015176,2024-03-12T18:17:09,ACC00009499,Payment,1345.76,-1081386.16,GBP,Walmart
TXN0000015177,2024-04-09T19:10:59,ACC00009043,ATM,975.63,-1082361.79,USD,Grocery
TXN0000015178,2024-01-06T15:25:51,ACC00005368,Transfer,1822.67,-1080539.12,EUR,Target
TXN0000015179,2024-06-30T01:05:15,ACC00001272,Debit,385.74,-1080924.86,GBP,Target
TXN0000015180,2024-06-28T22:56:11,ACC00008329,ATM,1321.3,-1082246.16,GBP,Target
TXN0000015181,2024-10-01T14:23:49,ACC00008117,Payment,1536.34,-1083782.5,EUR,Starbucks
TXN0000015182,2024-04-15T13:03:07,ACC00003447,Credit,679.86,-1083102.64,USD,Grocery
TXN0000015183,2024-05-26T05:57:36,ACC00001434,Debit,567.39,-1083670.03,JPY,Walmart
TXN0000015184,2024-06-15T16:57:22,ACC00007390,Payment,1236.84,-1084906.87,JPY,Restaurant
TXN0000015185,2024-05-01T16:14:55,ACC00000737,Credit,1519.79,-1083387.08,USD,Starbucks
TXN0000015186,2024-09-14T14:35:19,ACC00009972,ATM,913.07,-1084300.15,JPY,Starbucks
TXN0000015187,2024-03-26T14:25:11,ACC00009547,Transfer,971.82,-1083328.33,EUR,Restaurant
TXN0000015188,2024-08-22T01:00:44,ACC00008074,ATM,1834.83,-1085163.16,GBP,Shell
TXN0000015189,2024-02-04T12:42:49,ACC00001679,Credit,220.71,-1084942.45,USD,Target
TXN0000015190,2024-05-30T00:21:01,ACC00001567,Debit,1591.23,-1086533.68,GBP,Amazon
TXN0000015191,2024-04-08T15:40:28,ACC00007600,Transfer,1976.18,-1084557.5,GBP,Amazon
TXN0000015192,2024-04-19T09:08:17,ACC00004166,Transfer,558.32,-1083999.18,GBP,Grocery
TXN0000015193,2024-03-14T08:35:33,ACC00006559,Debit,1660.64,-1085659.82,JPY,Shell
TXN0000015194,2024-02-20T07:29:17,ACC00007403,ATM,1784.62,-1087444.44,GBP,Target
TXN0000015195,2024-08-18T13:10:54,ACC00007862,Payment,1351.55,-1088795.99,EUR,Shell
TXN0000015196,2024-09-08T18:02:49,ACC00009360,Transfer,873.78,-1087922.21,EUR,Amazon
TXN0000015197,2024-08-31T09:50:20,ACC00004117,ATM,625.86,-1088548.07,USD,Restaurant
TXN0000015198,2024-11-06T10:45:13,ACC00004382,Transfer,386.23,-1088161.84,GBP,Online Store
TXN0000015199,2024-04-17T21:36:07,ACC00006800,Payment,272.94,-1088434.78,JPY,Target
TXN0000015200,2024-04-15T23:57:02,ACC00008797,Payment,896.49,-1089331.27,GBP,Shell
TXN0000015201,2024-03-14T04:09:51,ACC00000141,Debit,1650.43,-1090981.7,EUR,Shell
TXN0000015202,2024-09-23T13:35:53,ACC00005401,Debit,901.57,-1091883.27,GBP,Amazon
TXN0000015203,2024-09-02T00:13:19,ACC00006568,Transfer,133.32,-1091749.95,GBP,Restaurant
TXN0000015204,2024-04-04T13:22:37,ACC00004718,Debit,1931.32,-1093681.27,USD,Restaurant
TXN0000015205,2024-11-14T05:20:33,ACC00007047,Debit,1293.42,-1094974.69,GBP,Target
TXN0000015206,2024-06-08T14:56:44,ACC00007130,Payment,1948.06,-1096922.75,GBP,Amazon
TXN0000015207,2024-05-01T16:34:10,ACC00006844,Credit,1056.41,-1095866.34,GBP,Starbucks
TXN0000015208,2024-12-25T22:27:19,ACC00008422,Credit,441.13,-1095425.21,GBP,Walmart
TXN0000015209,2024-12-29T08:41:46,ACC00008168,Credit,1510.78,-1093914.43,USD,Target
TXN0000015210,2024-11-24T20:06:48,ACC00007992,ATM,1627.29,-1095541.72,EUR,Target
TXN0000015211,2024-09-23T15:40:51,ACC00005980,Payment,636.0,-1096177.72,JPY,Target
TXN0000015212,2024-01-03T05:40:31,ACC00001059,Debit,1056.43,-1097234.15,EUR,Restaurant
TXN0000015213,2024-05-07T19:31:07,ACC00006381,Credit,626.79,-1096607.36,USD,Online Store
TXN0000015214,2024-03-04T00:02:54,ACC00001285,Debit,594.66,-1097202.02,USD,Grocery
TXN0000015215,2024-02-10T10:48:49,ACC00005426,ATM,826.55,-1098028.57,EUR,Target
TXN0000015216,2024-11-04T10:58:36,ACC00003449,Transfer,1773.6,-1096254.97,USD,Starbucks
TXN0000015217,2024-09-11T08:45:18,ACC00004397,Debit,22.94,-1096277.91,USD,Target
TXN0000015218,2024-04-23T14:28:02,ACC00001560,Credit,599.65,-1095678.26,USD,Starbucks
TXN0000015219,2024-08-08T03:06:05,ACC00002109,Credit,186.48,-1095491.78,JPY,Grocery
TXN0000015220,2024-06-29T05:59:10,ACC00003270,ATM,419.3,-1095911.08,USD,Amazon
TXN0000015221,2024-10-13T14:12:10,ACC00005127,Credit,589.32,-1095321.76,JPY,Starbucks
TXN0000015222,2024-07-08T18:37:35,ACC00007313,Debit,1491.82,-1096813.58,USD,Target
TXN0000015223,2024-07-17T04:52:05,ACC00005130,Credit,628.35,-1096185.23,EUR,Restaurant
TXN0000015224,2024-11-21T23:43:26,ACC00005941,ATM,651.21,-1096836.44,EUR,Shell
TXN0000015225,2024-07-19T02:30:54,ACC00005490,Credit,175.91,-1096660.53,USD,Shell
TXN0000015226,2024-11-29T19:45:33,ACC00002103,ATM,765.61,-1097426.14,JPY,Walmart
TXN0000015227,2024-12-27T06:56:30,ACC00004791,ATM,584.59,-1098010.73,JPY,Target
TXN0000015228,2024-04-16T21:31:02,ACC00001910,Credit,1873.8,-1096136.93,GBP,Walmart
TXN0000015229,2024-04-24T21:12:23,ACC00006252,Payment,672.51,-1096809.44,GBP,Target
TXN0000015230,2024-08-13T06:42:56,ACC00000909,Transfer,605.04,-1096204.4,EUR,Target
TXN0000015231,2024-09-16T08:04:22,ACC00005551,Transfer,1897.09,-1094307.31,EUR,Amazon
TXN0000015232,2024-11-13T00:53:32,ACC00000712,Debit,871.29,-1095178.6,USD,Target
TXN0000015233,2024-04-26T03:58:32,ACC00005919,Payment,840.86,-1096019.46,GBP,Shell
TXN0000015234,2024-10-01T11:44:52,ACC00008069,Debit,1052.65,-1097072.11,JPY,Restaurant
TXN0000015235,2024-08-22T21:15:44,ACC00005119,Credit,1281.57,-1095790.54,GBP,Online Store
TXN0000015236,2024-12-18T14:23:50,ACC00003628,Debit,104.02,-1095894.56,USD,Restaurant
TXN0000015237,2024-04-15T21:33:19,ACC00002843,Credit,99.42,-1095795.14,USD,Online Store
TXN0000015238,2024-03-30T04:31:40,ACC00002395,Transfer,1879.96,-1093915.18,EUR,Walmart
TXN0000015239,2024-05-15T10:15:00,ACC00008758,ATM,842.27,-1094757.45,JPY,Target
TXN0000015240,2024-03-26T13:14:58,ACC00009009,Debit,15.76,-1094773.21,JPY,Restaurant
TXN0000015241,2024-03-02T21:23:29,ACC00008086,ATM,1802.33,-1096575.54,JPY,Starbucks
TXN0000015242,2024-03-27T11:05:45,ACC00009119,ATM,905.74,-1097481.28,JPY,Shell
TXN0000015243,2024-06-11T23:44:57,ACC00000841,Transfer,473.12,-1097008.16,EUR,Restaurant
TXN0000015244,2024-10-11T03:02:39,ACC00005644,Transfer,811.96,-1096196.2,GBP,Amazon
TXN0000015245,2024-10-07T22:57:29,ACC00009009,Debit,221.36,-1096417.56,USD,Target
TXN0000015246,2024-02-08T13:43:23,ACC00002630,Payment,428.63,-1096846.19,GBP,Restaurant
TXN0000015247,2024-02-23T20:16:54,ACC00003411,Payment,1858.22,-1098704.41,JPY,Walmart
TXN0000015248,2024-09-13T10:41:16,ACC00001610,ATM,1946.99,-1100651.4,GBP,Amazon
TXN0000015249,2024-03-08T06:09:01,ACC00007464,Transfer,1349.65,-1099301.75,USD,Walmart
TXN0000015250,2024-10-30T14:48:32,ACC00002220,Payment,804.16,-1100105.91,EUR,Amazon
TXN0000015251,2024-03-19T19:41:21,ACC00009320,Debit,32.15,-1100138.06,USD,Shell
TXN0000015252,2024-07-25T13:00:07,ACC00007159,Credit,537.31,-1099600.75,JPY,Walmart
TXN0000015253,2024-09-01T08:56:02,ACC00004492,Payment,204.7,-1099805.45,JPY,Walmart
TXN0000015254,2024-12-05T08:26:49,ACC00007102,Transfer,266.88,-1099538.57,EUR,Walmart
TXN0000015255,2024-09-10T00:02:37,ACC00002707,Payment,1597.65,-1101136.22,USD,Shell
TXN0000015256,2024-12-07T12:41:36,ACC00005775,Debit,738.1,-1101874.32,GBP,Restaurant
TXN0000015257,2024-12-06T05:19:11,ACC00006284,Payment,408.78,-1102283.1,EUR,Online Store
TXN0000015258,2024-10-05T09:35:29,ACC00006032,Debit,1627.31,-1103910.41,EUR,Amazon
TXN0000015259,2024-04-15T04:58:41,ACC00005945,Debit,1853.68,-1105764.09,EUR,Grocery
TXN0000015260,2024-11-14T05:47:37,ACC00008725,Payment,1932.11,-1107696.2,GBP,Target
TXN0000015261,2024-06-06T18:25:02,ACC00002447,Debit,1689.95,-1109386.15,GBP,Starbucks
TXN0000015262,2024-03-25T09:38:13,ACC00003516,Payment,1752.18,-1111138.33,USD,Walmart
TXN0000015263,2024-02-25T01:57:18,ACC00006789,Transfer,556.53,-1110581.8,JPY,Restaurant
TXN0000015264,2024-11-29T09:58:50,ACC00007841,Payment,1326.5,-1111908.3,USD,Restaurant
TXN0000015265,2024-07-11T15:17:27,ACC00008486,Credit,149.92,-1111758.38,JPY,Starbucks
TXN0000015266,2024-05-20T15:08:35,ACC00004406,ATM,1385.27,-1113143.65,JPY,Grocery
TXN0000015267,2024-03-31T16:05:02,ACC00002733,Credit,1985.04,-1111158.61,GBP,Walmart
TXN0000015268,2024-08-24T14:25:46,ACC00001621,Transfer,1398.46,-1109760.15,USD,Grocery
TXN0000015269,2024-12-04T00:50:29,ACC00003359,Payment,547.49,-1110307.64,USD,Restaurant
TXN0000015270,2024-02-10T14:01:47,ACC00009921,ATM,459.93,-1110767.57,GBP,Online Store
TXN0000015271,2024-08-21T12:48:21,ACC00009376,ATM,991.82,-1111759.39,EUR,Amazon
TXN0000015272,2024-12-20T05:18:22,ACC00005245,Credit,636.28,-1111123.11,GBP,Amazon
TXN0000015273,2024-09-27T07:05:16,ACC00002207,ATM,858.98,-1111982.09,EUR,Online Store
TXN0000015274,2024-01-14T11:52:53,ACC00003233,Credit,1291.61,-1110690.48,JPY,Online Store
TXN0000015275,2024-08-30T15:15:48,ACC00003477,Debit,373.56,-1111064.04,EUR,Walmart
TXN0000015276,2024-08-23T02:18:34,ACC00004198,Payment,115.49,-1111179.53,USD,Grocery
TXN0000015277,2024-08-13T10:31:35,ACC00000130,Transfer,1862.87,-1109316.66,USD,Restaurant
TXN0000015278,2024-04-01T00:36:36,ACC00005619,Debit,1367.13,-1110683.79,JPY,Target
TXN0000015279,2024-10-26T16:04:53,ACC00004207,Debit,759.39,-1111443.18,JPY,Shell
TXN0000015280,2024-04-11T17:18:11,ACC00001428,Payment,1166.7,-1112609.88,EUR,Target
TXN0000015281,2024-03-08T01:28:22,ACC00007616,Transfer,1569.96,-1111039.92,EUR,Target
TXN0000015282,2024-06-21T05:28:53,ACC00006959,Payment,141.98,-1111181.9,EUR,Grocery
TXN0000015283,2024-12-11T17:40:23,ACC00002781,Credit,1905.91,-1109275.99,USD,Target
TXN0000015284,2024-05-03T01:13:35,ACC00006591,Payment,1442.85,-1110718.84,USD,Amazon
TXN0000015285,2024-08-14T08:19:56,ACC00002606,Transfer,1294.95,-1109423.89,JPY,Starbucks
TXN0000015286,2024-06-20T19:02:56,ACC00006555,Credit,1032.74,-1108391.15,EUR,Target
TXN0000015287,2024-08-10T10:53:30,ACC00007629,Payment,46.4,-1108437.55,EUR,Online Store
TXN0000015288,2024-08-26T07:58:14,ACC00007907,Transfer,986.67,-1107450.88,GBP,Walmart
TXN0000015289,2024-08-13T18:44:19,ACC00001562,Debit,1216.15,-1108667.03,GBP,Grocery
TXN0000015290,2024-07-03T22:02:20,ACC00009904,ATM,1111.87,-1109778.9,JPY,Online Store
TXN0000015291,2024-10-28T10:34:53,ACC00004874,Transfer,168.82,-1109610.08,JPY,Target
TXN0000015292,2024-07-22T12:32:03,ACC00004936,ATM,712.49,-1110322.57,EUR,Starbucks
TXN0000015293,2024-08-07T13:55:32,ACC00003613,Transfer,1733.69,-1108588.88,JPY,Grocery
TXN0000015294,2024-05-20T03:20:01,ACC00008529,Credit,1369.04,-1107219.84,USD,Grocery
TXN0000015295,2024-04-12T05:33:51,ACC00005886,Credit,1847.2,-1105372.64,JPY,Restaurant
TXN0000015296,2024-02-20T14:22:16,ACC00001920,Transfer,1361.54,-1104011.1,EUR,Target
TXN0000015297,2024-01-22T06:57:36,ACC00001200,Debit,1938.43,-1105949.53,EUR,Amazon
TXN0000015298,2024-08-15T22:22:22,ACC00006628,Debit,1101.5,-1107051.03,USD,Walmart
TXN0000015299,2024-01-21T03:55:53,ACC00003685,Transfer,977.17,-1106073.86,USD,Grocery
TXN0000015300,2024-11-02T07:56:50,ACC00006508,ATM,1929.1,-1108002.96,JPY,Restaurant
TXN0000015301,2024-09-16T04:16:42,ACC00003740,Debit,1701.16,-1109704.12,USD,Amazon
TXN0000015302,2024-04-18T15:54:24,ACC00003066,Debit,448.15,-1110152.27,EUR,Starbucks
TXN0000015303,2024-11-30T07:19:06,ACC00008029,Payment,1748.85,-1111901.12,USD,Shell
TXN0000015304,2024-04-11T07:59:25,ACC00004602,Debit,418.52,-1112319.64,JPY,Walmart
TXN0000015305,2024-11-04T12:31:29,ACC00003967,ATM,657.25,-1112976.89,EUR,Grocery
TXN0000015306,2024-12-15T06:45:29,ACC00000510,ATM,854.23,-1113831.12,GBP,Restaurant
TXN0000015307,2024-03-23T12:32:09,ACC00001097,Payment,133.88,-1113965.0,JPY,Target
TXN0000015308,2024-09-15T15:48:55,ACC00004244,ATM,39.43,-1114004.43,USD,Amazon
TXN0000015309,2024-12-12T21:20:01,ACC00008507,Debit,924.27,-1114928.7,GBP,Restaurant
TXN0000015310,2024-07-31T01:04:30,ACC00002850,Credit,1541.77,-1113386.93,USD,Restaurant
TXN0000015311,2024-04-30T15:36:00,ACC00004769,Payment,325.56,-1113712.49,EUR,Online Store
TXN0000015312,2024-04-16T16:07:36,ACC00005314,Transfer,401.39,-1113311.1,EUR,Shell
TXN0000015313,2024-07-22T10:08:01,ACC00005588,Payment,1252.02,-1114563.12,GBP,Starbucks
TXN0000015314,2024-08-20T11:05:43,ACC00006394,Transfer,978.12,-1113585.0,USD,Starbucks
TXN0000015315,2024-04-14T06:43:01,ACC00005461,ATM,1870.26,-1115455.26,JPY,Online Store
TXN0000015316,2024-05-05T17:15:13,ACC00005215,ATM,297.13,-1115752.39,GBP,Online Store
TXN0000015317,2024-10-03T18:21:04,ACC00007188,Payment,142.59,-1115894.98,JPY,Shell
TXN0000015318,2024-06-02T05:06:50,ACC00003165,Payment,1501.0,-1117395.98,JPY,Shell
TXN0000015319,2024-09-29T06:19:36,ACC00003970,Transfer,711.52,-1116684.46,EUR,Grocery
TXN0000015320,2024-05-21T12:18:59,ACC00005956,Payment,1736.33,-1118420.79,USD,Grocery
TXN0000015321,2024-10-26T07:51:09,ACC00007783,Debit,1015.13,-1119435.92,EUR,Online Store
TXN0000015322,2024-09-02T09:47:19,ACC00002070,Credit,938.35,-1118497.57,JPY,Online Store
TXN0000015323,2024-11-21T02:14:52,ACC00006727,Payment,1070.88,-1119568.45,USD,Restaurant
TXN0000015324,2024-02-27T02:31:15,ACC00001413,Transfer,622.96,-1118945.49,EUR,Shell
TXN0000015325,2024-06-23T13:43:36,ACC00006877,Payment,1982.77,-1120928.26,JPY,Shell
TXN0000015326,2024-08-29T10:13:20,ACC00000501,Debit,1462.35,-1122390.61,EUR,Target
TXN0000015327,2024-12-26T20:11:47,ACC00003647,Debit,970.33,-1123360.94,JPY,Grocery
TXN0000015328,2024-02-17T01:37:00,ACC00007252,Transfer,1501.85,-1121859.09,GBP,Starbucks
TXN0000015329,2024-07-19T20:06:08,ACC00007196,Transfer,568.39,-1121290.7,JPY,Target
TXN0000015330,2024-12-05T07:30:29,ACC00002910,Credit,1189.52,-1120101.18,USD,Amazon
TXN0000015331,2024-08-06T13:18:06,ACC00003982,Credit,947.32,-1119153.86,USD,Restaurant
TXN0000015332,2024-09-19T18:15:21,ACC00000595,ATM,1487.62,-1120641.48,USD,Shell
TXN0000015333,2024-01-14T10:56:20,ACC00000196,Payment,526.86,-1121168.34,GBP,Amazon
TXN0000015334,2024-04-20T18:08:48,ACC00007422,Payment,1703.54,-1122871.88,GBP,Shell
TXN0000015335,2024-11-26T12:48:01,ACC00003461,Transfer,1610.22,-1121261.66,USD,Grocery
TXN0000015336,2024-05-30T22:50:48,ACC00007174,ATM,224.54,-1121486.2,USD,Target
TXN0000015337,2024-02-12T14:02:45,ACC00003972,Debit,1046.42,-1122532.62,GBP,Shell
TXN0000015338,2024-01-16T19:56:05,ACC00009615,Debit,1627.57,-1124160.19,GBP,Target
TXN0000015339,2024-12-13T05:29:41,ACC00007067,Debit,457.68,-1124617.87,USD,Amazon
TXN0000015340,2024-09-20T12:56:23,ACC00009931,Transfer,423.36,-1124194.51,EUR,Shell
TXN0000015341,2024-04-18T03:15:06,ACC00003861,Payment,180.18,-1124374.69,USD,Target
TXN0000015342,2024-06-16T09:07:04,ACC00006421,Payment,339.53,-1124714.22,GBP,Walmart
TXN0000015343,2024-08-29T04:44:08,ACC00000938,Payment,1525.3,-1126239.52,GBP,Restaurant
TXN0000015344,2024-10-29T22:25:26,ACC00007843,Payment,513.85,-1126753.37,GBP,Grocery
TXN0000015345,2024-11-03T18:49:21,ACC00009125,Credit,282.9,-1126470.47,EUR,Amazon
TXN0000015346,2024-02-18T17:13:58,ACC00004477,Credit,1642.67,-1124827.8,EUR,Restaurant
TXN0000015347,2024-12-02T14:50:37,ACC00001672,Credit,367.31,-1124460.49,EUR,Restaurant
TXN0000015348,2024-06-25T04:07:54,ACC00006821,Debit,356.44,-1124816.93,JPY,Target
TXN0000015349,2024-10-30T20:24:14,ACC00007023,Transfer,87.55,-1124729.38,GBP,Starbucks
TXN0000015350,2024-07-25T17:02:31,ACC00003036,Credit,1798.44,-1122930.94,JPY,Walmart
TXN0000015351,2024-11-18T14:15:35,ACC00002364,Debit,1187.15,-1124118.09,GBP,Target
TXN0000015352,2024-05-19T05:14:06,ACC00001289,Credit,1217.57,-1122900.52,USD,Online Store
TXN0000015353,2024-07-04T17:11:44,ACC00009203,Payment,1792.44,-1124692.96,GBP,Target
TXN0000015354,2024-10-24T20:45:01,ACC00003388,Payment,1653.9,-1126346.86,GBP,Starbucks
TXN0000015355,2024-11-29T12:01:07,ACC00009958,Payment,184.77,-1126531.63,JPY,Starbucks
TXN0000015356,2024-10-05T10:12:55,ACC00007350,Transfer,131.47,-1126400.16,JPY,Restaurant
TXN0000015357,2024-10-22T20:27:13,ACC00001516,ATM,187.24,-1126587.4,GBP,Online Store
TXN0000015358,2024-07-29T16:24:45,ACC00008113,ATM,1470.85,-1128058.25,GBP,Restaurant
TXN0000015359,2024-11-20T19:45:17,ACC00006734,Credit,286.57,-1127771.68,EUR,Walmart
TXN0000015360,2024-01-27T16:36:56,ACC00007129,Credit,1253.33,-1126518.35,EUR,Walmart
TXN0000015361,2024-01-20T17:34:17,ACC00003058,ATM,1397.48,-1127915.83,EUR,Online Store
TXN0000015362,2024-05-26T03:41:07,ACC00004526,Transfer,166.91,-1127748.92,USD,Online Store
TXN0000015363,2024-12-04T07:06:37,ACC00001237,ATM,1986.15,-1129735.07,USD,Shell
TXN0000015364,2024-02-01T00:52:35,ACC00000977,ATM,1446.06,-1131181.13,EUR,Restaurant
TXN0000015365,2024-10-06T05:28:11,ACC00000981,Payment,1950.11,-1133131.24,EUR,Target
TXN0000015366,2024-04-10T18:45:21,ACC00001524,Payment,1575.3,-1134706.54,GBP,Online Store
TXN0000015367,2024-09-18T15:23:01,ACC00004161,Transfer,867.32,-1133839.22,USD,Walmart
TXN0000015368,2024-10-17T16:28:47,ACC00008738,Credit,862.75,-1132976.47,EUR,Target
TXN0000015369,2024-10-10T16:50:37,ACC00000025,Credit,440.3,-1132536.17,GBP,Starbucks
TXN0000015370,2024-09-13T09:04:42,ACC00004948,ATM,19.9,-1132556.07,EUR,Restaurant
TXN0000015371,2024-05-18T15:58:07,ACC00000231,ATM,1465.28,-1134021.35,JPY,Amazon
TXN0000015372,2024-11-18T04:58:55,ACC00005754,Credit,82.56,-1133938.79,GBP,Starbucks
TXN0000015373,2024-09-23T19:34:55,ACC00008919,Transfer,607.62,-1133331.17,JPY,Walmart
TXN0000015374,2024-10-06T07:26:53,ACC00009995,ATM,882.34,-1134213.51,USD,Shell
TXN0000015375,2024-04-24T19:52:29,ACC00000039,Credit,1211.4,-1133002.11,GBP,Online Store
TXN0000015376,2024-12-08T20:27:37,ACC00001609,Credit,1325.48,-1131676.63,USD,Walmart
TXN0000015377,2024-01-02T04:29:51,ACC00001421,Transfer,422.03,-1131254.6,EUR,Restaurant
TXN0000015378,2024-12-08T06:23:08,ACC00009320,ATM,1680.66,-1132935.26,JPY,Walmart
TXN0000015379,2024-01-28T15:50:55,ACC00004458,Debit,268.99,-1133204.25,USD,Restaurant
TXN0000015380,2024-04-28T19:30:23,ACC00006836,Transfer,1531.99,-1131672.26,EUR,Shell
TXN0000015381,2024-01-03T00:27:12,ACC00007356,ATM,1543.09,-1133215.35,JPY,Target
TXN0000015382,2024-11-26T02:26:55,ACC00009365,Credit,344.75,-1132870.6,JPY,Amazon
TXN0000015383,2024-06-10T16:00:16,ACC00005267,Credit,553.22,-1132317.38,EUR,Grocery
TXN0000015384,2024-12-12T19:38:15,ACC00001270,Transfer,1983.39,-1130333.99,JPY,Grocery
TXN0000015385,2024-10-27T13:09:34,ACC00009056,Credit,1125.39,-1129208.6,JPY,Grocery
TXN0000015386,2024-12-19T22:13:20,ACC00003215,ATM,731.51,-1129940.11,JPY,Grocery
TXN0000015387,2024-07-29T04:27:01,ACC00002695,Payment,723.15,-1130663.26,EUR,Shell
TXN0000015388,2024-10-04T19:58:28,ACC00006584,ATM,1423.83,-1132087.09,EUR,Restaurant
TXN0000015389,2024-03-30T22:04:35,ACC00000946,ATM,1943.34,-1134030.43,EUR,Target
TXN0000015390,2024-12-28T21:04:29,ACC00007492,Payment,142.39,-1134172.82,GBP,Restaurant
TXN0000015391,2024-03-04T13:22:53,ACC00009022,Credit,649.37,-1133523.45,USD,Online Store
TXN0000015392,2024-08-25T04:22:05,ACC00009032,Payment,809.23,-1134332.68,EUR,Target
TXN0000015393,2024-10-21T22:58:05,ACC00004909,ATM,1557.76,-1135890.44,JPY,Target
TXN0000015394,2024-02-11T03:02:03,ACC00007361,ATM,636.36,-1136526.8,JPY,Amazon
TXN0000015395,2024-05-08T00:18:54,ACC00005032,Debit,1401.48,-1137928.28,GBP,Shell
TXN0000015396,2024-06-13T19:23:39,ACC00007584,Credit,1613.99,-1136314.29,GBP,Target
TXN0000015397,2024-08-16T23:04:26,ACC00001308,ATM,1400.0,-1137714.29,GBP,Amazon
TXN0000015398,2024-07-13T13:46:40,ACC00009525,Credit,837.88,-1136876.41,USD,Walmart
TXN0000015399,2024-04-07T18:48:35,ACC00004674,Credit,16.96,-1136859.45,EUR,Starbucks
TXN0000015400,2024-05-14T18:55:11,ACC00003996,Payment,190.13,-1137049.58,EUR,Shell
TXN0000015401,2024-07-29T19:46:01,ACC00002956,Transfer,121.16,-1136928.42,GBP,Walmart
TXN0000015402,2024-03-24T08:55:48,ACC00008732,ATM,95.75,-1137024.17,EUR,Shell
TXN0000015403,2024-08-15T04:30:42,ACC00003342,Payment,1044.53,-1138068.7,GBP,Shell
TXN0000015404,2024-12-25T17:53:43,ACC00008252,Debit,1771.15,-1139839.85,USD,Target
TXN0000015405,2024-04-15T17:29:55,ACC00004503,ATM,1702.16,-1141542.01,JPY,Online Store
TXN0000015406,2024-06-21T08:04:56,ACC00005003,Credit,57.28,-1141484.73,USD,Amazon
TXN0000015407,2024-01-14T06:39:49,ACC00006574,Payment,420.77,-1141905.5,GBP,Online Store
TXN0000015408,2024-10-08T03:33:43,ACC00007330,Payment,808.24,-1142713.74,EUR,Amazon
TXN0000015409,2024-09-07T20:22:15,ACC00008182,Debit,548.99,-1143262.73,USD,Walmart
TXN0000015410,2024-08-17T05:05:44,ACC00003307,Credit,1965.17,-1141297.56,USD,Walmart
TXN0000015411,2024-04-28T06:42:28,ACC00004359,ATM,391.11,-1141688.67,USD,Shell
TXN0000015412,2024-07-02T18:21:09,ACC00004326,ATM,699.13,-1142387.8,GBP,Grocery
TXN0000015413,2024-08-21T05:04:20,ACC00008865,Credit,1759.15,-1140628.65,USD,Restaurant
TXN0000015414,2024-02-15T10:10:30,ACC00002162,Payment,268.58,-1140897.23,GBP,Grocery
TXN0000015415,2024-11-01T02:25:40,ACC00000097,ATM,778.76,-1141675.99,USD,Grocery
TXN0000015416,2024-09-17T01:29:17,ACC00006661,Payment,708.63,-1142384.62,GBP,Starbucks
TXN0000015417,2024-02-17T01:45:04,ACC00006891,ATM,737.39,-1143122.01,GBP,Amazon
TXN0000015418,2024-12-26T10:07:07,ACC00008669,Payment,1381.13,-1144503.14,EUR,Shell
TXN0000015419,2024-07-19T15:07:48,ACC00008141,Debit,562.55,-1145065.69,EUR,Shell
TXN0000015420,2024-03-28T20:43:11,ACC00007522,ATM,936.81,-1146002.5,GBP,Online Store
TXN0000015421,2024-10-01T09:59:36,ACC00008881,Credit,1989.83,-1144012.67,EUR,Grocery
TXN0000015422,2024-07-04T12:48:10,ACC00001952,Payment,734.15,-1144746.82,JPY,Grocery
TXN0000015423,2024-03-07T05:38:37,ACC00008610,Payment,1548.57,-1146295.39,USD,Starbucks
TXN0000015424,2024-11-22T20:51:51,ACC00009010,ATM,1347.91,-1147643.3,USD,Amazon
TXN0000015425,2024-12-04T23:25:00,ACC00006021,Debit,784.68,-1148427.98,GBP,Starbucks
TXN0000015426,2024-02-27T23:30:22,ACC00002129,Transfer,360.76,-1148067.22,JPY,Amazon
TXN0000015427,2024-12-16T15:15:14,ACC00008371,Credit,60.89,-1148006.33,USD,Shell
TXN0000015428,2024-05-18T02:18:20,ACC00005362,Credit,1520.64,-1146485.69,GBP,Amazon
TXN0000015429,2024-10-14T08:38:43,ACC00009003,Debit,1064.03,-1147549.72,USD,Restaurant
TXN0000015430,2024-05-12T02:20:04,ACC00001653,Payment,1786.46,-1149336.18,USD,Restaurant
TXN0000015431,2024-01-17T15:11:40,ACC00008482,Payment,751.13,-1150087.31,GBP,Online Store
TXN0000015432,2024-05-30T06:42:09,ACC00008385,Transfer,1242.26,-1148845.05,EUR,Restaurant
TXN0000015433,2024-12-20T23:37:26,ACC00000740,Credit,131.59,-1148713.46,EUR,Shell
TXN0000015434,2024-08-10T07:24:44,ACC00009345,Debit,1641.76,-1150355.22,GBP,Shell
TXN0000015435,2024-05-17T03:06:07,ACC00007909,Credit,407.58,-1149947.64,GBP,Walmart
TXN0000015436,2024-04-05T13:24:22,ACC00002806,Credit,1354.29,-1148593.35,USD,Amazon
TXN0000015437,2024-05-31T15:47:29,ACC00000117,Payment,505.84,-1149099.19,USD,Starbucks
TXN0000015438,2024-02-03T22:59:09,ACC00003820,Debit,1873.19,-1150972.38,USD,Online Store
TXN0000015439,2024-09-29T06:48:26,ACC00003108,Debit,1101.23,-1152073.61,JPY,Walmart
TXN0000015440,2024-03-02T19:09:49,ACC00007067,Credit,843.41,-1151230.2,GBP,Amazon
TXN0000015441,2024-09-20T10:10:45,ACC00009515,Transfer,1145.2,-1150085.0,EUR,Target
TXN0000015442,2024-01-12T09:06:14,ACC00008555,Transfer,980.55,-1149104.45,USD,Amazon
TXN0000015443,2024-08-08T08:06:40,ACC00000588,Credit,1488.11,-1147616.34,JPY,Restaurant
TXN0000015444,2024-06-02T01:03:53,ACC00002324,ATM,146.85,-1147763.19,USD,Starbucks
TXN0000015445,2024-08-19T15:33:42,ACC00003044,ATM,163.53,-1147926.72,USD,Online Store
TXN0000015446,2024-08-21T19:23:08,ACC00005103,Credit,929.93,-1146996.79,EUR,Amazon
TXN0000015447,2024-07-04T08:08:03,ACC00008808,Debit,1782.43,-1148779.22,EUR,Target
TXN0000015448,2024-06-18T13:39:30,ACC00004328,Debit,1723.06,-1150502.28,JPY,Online Store
TXN0000015449,2024-10-25T05:04:52,ACC00007466,ATM,1115.82,-1151618.1,USD,Target
TXN0000015450,2024-12-11T23:46:15,ACC00008241,Credit,1069.25,-1150548.85,GBP,Restaurant
TXN0000015451,2024-03-11T03:25:10,ACC00006407,Debit,1336.55,-1151885.4,JPY,Restaurant
TXN0000015452,2024-05-02T17:09:45,ACC00006279,Payment,1791.47,-1153676.87,JPY,Amazon
TXN0000015453,2024-04-21T22:44:36,ACC00006704,ATM,1637.44,-1155314.31,JPY,Starbucks
TXN0000015454,2024-11-09T03:43:04,ACC00003015,ATM,210.93,-1155525.24,GBP,Online Store
TXN0000015455,2024-02-14T07:54:21,ACC00007436,Credit,1939.93,-1153585.31,USD,Online Store
TXN0000015456,2024-02-20T15:41:52,ACC00003644,Debit,497.8,-1154083.11,USD,Amazon
TXN0000015457,2024-04-13T19:38:00,ACC00001224,Debit,1999.31,-1156082.42,EUR,Starbucks
TXN0000015458,2024-01-30T13:20:23,ACC00007521,ATM,899.3,-1156981.72,JPY,Starbucks
TXN0000015459,2024-11-11T13:07:56,ACC00000037,Payment,1747.31,-1158729.03,JPY,Online Store
TXN0000015460,2024-06-09T05:01:57,ACC00009563,Payment,65.56,-1158794.59,USD,Grocery
TXN0000015461,2024-08-16T12:43:17,ACC00003076,ATM,958.77,-1159753.36,JPY,Walmart
TXN0000015462,2024-08-25T05:03:50,ACC00002822,Transfer,1547.07,-1158206.29,GBP,Online Store
TXN0000015463,2024-02-24T12:16:24,ACC00001869,Debit,1230.2,-1159436.49,GBP,Shell
TXN0000015464,2024-06-10T14:56:52,ACC00008444,Transfer,884.15,-1158552.34,GBP,Target
TXN0000015465,2024-07-28T06:39:16,ACC00003355,Payment,1240.15,-1159792.49,JPY,Restaurant
TXN0000015466,2024-11-04T19:03:02,ACC00005572,Credit,952.72,-1158839.77,USD,Shell
TXN0000015467,2024-02-08T17:29:36,ACC00007808,Debit,1168.55,-1160008.32,GBP,Shell
TXN0000015468,2024-06-08T14:38:11,ACC00001920,Debit,841.48,-1160849.8,USD,Starbucks
TXN0000015469,2024-07-03T12:08:56,ACC00000924,Credit,1413.49,-1159436.31,EUR,Online Store
TXN0000015470,2024-07-16T15:11:49,ACC00001245,Credit,500.03,-1158936.28,GBP,Grocery
TXN0000015471,2024-04-27T10:07:09,ACC00002158,ATM,1250.44,-1160186.72,JPY,Target
TXN0000015472,2024-06-07T19:18:43,ACC00005696,Payment,289.44,-1160476.16,EUR,Shell
TXN0000015473,2024-10-17T14:36:11,ACC00008260,ATM,1923.08,-1162399.24,JPY,Online Store
TXN0000015474,2024-02-01T04:04:03,ACC00002745,Transfer,305.12,-1162094.12,GBP,Amazon
TXN0000015475,2024-07-09T16:51:22,ACC00000626,Transfer,804.93,-1161289.19,EUR,Target
TXN0000015476,2024-11-05T18:47:32,ACC00004491,Payment,436.06,-1161725.25,USD,Online Store
TXN0000015477,2024-03-22T21:48:52,ACC00000809,Credit,1591.76,-1160133.49,GBP,Grocery
TXN0000015478,2024-02-18T01:28:41,ACC00000745,Credit,684.08,-1159449.41,EUR,Walmart
TXN0000015479,2024-01-08T01:00:39,ACC00000044,Payment,1952.3,-1161401.71,GBP,Starbucks
TXN0000015480,2024-10-13T22:27:15,ACC00004498,Credit,178.83,-1161222.88,USD,Grocery
TXN0000015481,2024-04-25T07:51:51,ACC00003818,Payment,1048.99,-1162271.87,EUR,Restaurant
TXN0000015482,2024-05-21T15:07:06,ACC00008209,ATM,1474.18,-1163746.05,USD,Shell
TXN0000015483,2024-01-18T03:52:47,ACC00008501,Payment,701.88,-1164447.93,EUR,Shell
TXN0000015484,2024-11-23T09:40:20,ACC00006427,Credit,744.54,-1163703.39,EUR,Restaurant
TXN0000015485,2024-03-01T23:05:54,ACC00006168,Credit,1206.97,-1162496.42,GBP,Shell
TXN0000015486,2024-08-21T00:23:08,ACC00006840,Transfer,36.03,-1162460.39,JPY,Target
TXN0000015487,2024-04-24T01:20:45,ACC00005229,Debit,1940.43,-1164400.82,GBP,Amazon
TXN0000015488,2024-10-20T15:42:58,ACC00006686,Payment,1515.35,-1165916.17,JPY,Target
TXN0000015489,2024-02-07T18:44:42,ACC00001533,Credit,698.84,-1165217.33,USD,Amazon
TXN0000015490,2024-12-24T06:57:44,ACC00002576,Transfer,92.09,-1165125.24,EUR,Grocery
TXN0000015491,2024-09-22T18:23:38,ACC00000330,ATM,68.08,-1165193.32,EUR,Grocery
TXN0000015492,2024-09-28T06:00:53,ACC00004397,ATM,185.6,-1165378.92,JPY,Shell
TXN0000015493,2024-08-25T11:04:52,ACC00006283,Credit,241.91,-1165137.01,EUR,Walmart
TXN0000015494,2024-09-07T04:38:35,ACC00003776,Debit,1770.34,-1166907.35,EUR,Shell
TXN0000015495,2024-06-30T20:28:22,ACC00009306,ATM,1814.63,-1168721.98,JPY,Amazon
TXN0000015496,2024-07-03T10:53:35,ACC00007666,ATM,1617.49,-1170339.47,USD,Restaurant
TXN0000015497,2024-10-03T18:41:05,ACC00006006,Transfer,1737.57,-1168601.9,EUR,Walmart
TXN0000015498,2024-09-01T11:42:51,ACC00003398,Credit,1955.83,-1166646.07,EUR,Online Store
TXN0000015499,2024-09-04T22:25:25,ACC00007602,Credit,35.07,-1166611.0,USD,Grocery
TXN0000015500,2024-02-26T14:12:02,ACC00009175,Credit,1057.29,-1165553.71,USD,Starbucks
TXN0000015501,2024-10-12T15:48:18,ACC00006115,Transfer,877.15,-1164676.56,USD,Shell
TXN0000015502,2024-06-19T00:04:43,ACC00008146,Payment,927.72,-1165604.28,USD,Target
TXN0000015503,2024-09-29T08:03:48,ACC00006090,Transfer,1115.41,-1164488.87,JPY,Walmart
TXN0000015504,2024-02-21T18:09:04,ACC00005472,Transfer,287.28,-1164201.59,JPY,Amazon
TXN0000015505,2024-08-10T01:10:12,ACC00005706,Credit,1592.24,-1162609.35,GBP,Target
TXN0000015506,2024-06-22T17:40:58,ACC00005020,Credit,1669.51,-1160939.84,USD,Shell
TXN0000015507,2024-03-05T10:02:24,ACC00001538,Debit,265.67,-1161205.51,GBP,Target
TXN0000015508,2024-01-14T00:13:56,ACC00001531,Payment,245.82,-1161451.33,EUR,Starbucks
TXN0000015509,2024-12-02T10:36:28,ACC00004481,Debit,88.83,-1161540.16,USD,Shell
TXN0000015510,2024-08-10T12:49:17,ACC00001180,Debit,219.84,-1161760.0,GBP,Walmart
TXN0000015511,2024-08-14T14:34:46,ACC00007013,Payment,1432.56,-1163192.56,GBP,Walmart
TXN0000015512,2024-11-12T21:30:28,ACC00006915,Transfer,1579.73,-1161612.83,GBP,Walmart
TXN0000015513,2024-04-26T16:30:25,ACC00002537,Credit,357.07,-1161255.76,USD,Grocery
TXN0000015514,2024-01-30T21:54:59,ACC00003586,Debit,483.22,-1161738.98,JPY,Walmart
TXN0000015515,2024-02-27T00:09:42,ACC00003235,Debit,1870.43,-1163609.41,JPY,Grocery
TXN0000015516,2024-03-02T01:08:08,ACC00005173,Payment,1271.36,-1164880.77,GBP,Walmart
TXN0000015517,2024-07-25T18:06:14,ACC00002805,ATM,630.7,-1165511.47,GBP,Online Store
TXN0000015518,2024-10-03T08:07:39,ACC00000382,ATM,1310.4,-1166821.87,GBP,Starbucks
TXN0000015519,2024-11-04T15:05:47,ACC00007044,Debit,356.19,-1167178.06,JPY,Walmart
TXN0000015520,2024-11-23T17:28:19,ACC00008344,Payment,1513.78,-1168691.84,USD,Walmart
TXN0000015521,2024-04-25T06:33:13,ACC00009850,Transfer,1728.87,-1166962.97,EUR,Grocery
TXN0000015522,2024-02-13T19:09:22,ACC00007168,Payment,651.24,-1167614.21,JPY,Online Store
TXN0000015523,2024-04-12T13:20:44,ACC00008299,Credit,166.2,-1167448.01,USD,Starbucks
TXN0000015524,2024-10-30T11:59:42,ACC00004599,Debit,1713.49,-1169161.5,EUR,Starbucks
TXN0000015525,2024-01-05T12:46:30,ACC00009618,Debit,1285.76,-1170447.26,EUR,Restaurant
TXN0000015526,2024-10-11T19:48:41,ACC00002571,Transfer,366.42,-1170080.84,EUR,Grocery
TXN0000015527,2024-05-18T16:13:52,ACC00009710,Debit,1407.81,-1171488.65,JPY,Restaurant
TXN0000015528,2024-12-08T13:18:05,ACC00005175,Payment,1396.47,-1172885.12,JPY,Walmart
TXN0000015529,2024-10-29T06:35:03,ACC00006629,Payment,170.57,-1173055.69,GBP,Amazon
TXN0000015530,2024-07-30T02:59:56,ACC00001220,ATM,288.62,-1173344.31,GBP,Walmart
TXN0000015531,2024-05-10T02:12:36,ACC00006342,Payment,390.26,-1173734.57,GBP,Online Store
TXN0000015532,2024-07-28T06:25:24,ACC00005674,Transfer,524.61,-1173209.96,USD,Walmart
TXN0000015533,2024-04-09T06:21:27,ACC00006150,ATM,381.93,-1173591.89,EUR,Walmart
TXN0000015534,2024-05-13T09:19:12,ACC00001689,Debit,1766.38,-1175358.27,USD,Walmart
TXN0000015535,2024-11-19T08:50:00,ACC00006585,Transfer,1434.48,-1173923.79,EUR,Online Store
TXN0000015536,2024-11-23T05:57:05,ACC00006745,Debit,1563.97,-1175487.76,GBP,Walmart
TXN0000015537,2024-02-23T13:30:15,ACC00008943,Credit,576.28,-1174911.48,JPY,Shell
TXN0000015538,2024-05-19T17:52:27,ACC00008793,ATM,1432.12,-1176343.6,EUR,Grocery
TXN0000015539,2024-02-03T15:56:20,ACC00007206,ATM,456.03,-1176799.63,GBP,Online Store
TXN0000015540,2024-07-07T02:16:57,ACC00009196,Payment,70.63,-1176870.26,USD,Starbucks
TXN0000015541,2024-01-23T12:41:02,ACC00009613,ATM,1070.85,-1177941.11,EUR,Grocery
TXN0000015542,2024-02-12T19:07:49,ACC00003071,Transfer,478.97,-1177462.14,GBP,Restaurant
TXN0000015543,2024-06-14T18:12:15,ACC00000664,Payment,311.45,-1177773.59,GBP,Online Store
TXN0000015544,2024-11-09T07:02:43,ACC00006627,Credit,181.05,-1177592.54,EUR,Amazon
TXN0000015545,2024-11-29T20:27:13,ACC00007686,Transfer,1319.18,-1176273.36,GBP,Starbucks
TXN0000015546,2024-02-13T06:23:56,ACC00002691,ATM,1687.4,-1177960.76,USD,Restaurant
TXN0000015547,2024-01-30T08:13:24,ACC00005673,Transfer,1135.51,-1176825.25,JPY,Online Store
TXN0000015548,2024-03-29T02:04:08,ACC00005368,Transfer,19.13,-1176806.12,JPY,Restaurant
TXN0000015549,2024-12-24T12:06:10,ACC00003432,Debit,191.63,-1176997.75,JPY,Restaurant
TXN0000015550,2024-12-26T15:44:40,ACC00000289,Credit,1763.25,-1175234.5,JPY,Target
TXN0000015551,2024-05-07T09:33:53,ACC00003043,Transfer,1001.52,-1174232.98,EUR,Grocery
TXN0000015552,2024-05-11T03:34:55,ACC00003789,Debit,1332.07,-1175565.05,GBP,Amazon
TXN0000015553,2024-12-23T17:32:12,ACC00002210,ATM,849.05,-1176414.1,USD,Restaurant
TXN0000015554,2024-10-29T21:47:39,ACC00007979,Credit,389.12,-1176024.98,JPY,Amazon
TXN0000015555,2024-02-10T13:43:07,ACC00004597,ATM,766.97,-1176791.95,EUR,Amazon
TXN0000015556,2024-05-11T23:12:06,ACC00009901,Credit,869.51,-1175922.44,EUR,Shell
TXN0000015557,2024-08-27T04:47:23,ACC00001999,ATM,617.17,-1176539.61,JPY,Amazon
TXN0000015558,2024-08-18T08:54:02,ACC00005400,Transfer,1881.65,-1174657.96,USD,Shell
TXN0000015559,2024-02-09T14:11:25,ACC00001479,Credit,226.25,-1174431.71,JPY,Target
TXN0000015560,2024-11-02T02:14:56,ACC00001081,Payment,1109.8,-1175541.51,GBP,Shell
TXN0000015561,2024-12-22T08:55:40,ACC00004532,ATM,1276.87,-1176818.38,EUR,Restaurant
TXN0000015562,2024-03-14T01:30:15,ACC00008863,Debit,759.46,-1177577.84,USD,Target
TXN0000015563,2024-11-26T23:28:56,ACC00003745,Transfer,1428.82,-1176149.02,EUR,Online Store
TXN0000015564,2024-12-07T21:47:08,ACC00005848,Credit,969.7,-1175179.32,USD,Walmart
TXN0000015565,2024-04-25T09:59:32,ACC00005963,Credit,1752.31,-1173427.01,GBP,Online Store
TXN0000015566,2024-08-30T11:54:16,ACC00007406,Transfer,1522.88,-1171904.13,GBP,Walmart
TXN0000015567,2024-05-20T17:35:49,ACC00008699,Credit,751.63,-1171152.5,GBP,Restaurant
TXN0000015568,2024-04-10T15:29:11,ACC00009658,ATM,1284.04,-1172436.54,USD,Grocery
TXN0000015569,2024-01-06T03:43:47,ACC00009961,Transfer,991.84,-1171444.7,JPY,Walmart
TXN0000015570,2024-01-20T19:54:58,ACC00006029,ATM,1643.98,-1173088.68,GBP,Starbucks
TXN0000015571,2024-07-19T10:25:29,ACC00007257,Credit,132.45,-1172956.23,GBP,Starbucks
TXN0000015572,2024-05-31T08:49:27,ACC00009573,ATM,1913.15,-1174869.38,GBP,Restaurant
TXN0000015573,2024-08-15T16:55:28,ACC00008364,Credit,1189.72,-1173679.66,EUR,Walmart
TXN0000015574,2024-07-02T10:16:48,ACC00009518,ATM,412.62,-1174092.28,GBP,Starbucks
TXN0000015575,2024-06-18T18:27:22,ACC00006798,Debit,355.05,-1174447.33,EUR,Online Store
TXN0000015576,2024-10-04T10:57:53,ACC00001818,Payment,322.9,-1174770.23,EUR,Online Store
TXN0000015577,2024-04-03T05:56:31,ACC00009248,Transfer,440.38,-1174329.85,EUR,Restaurant
TXN0000015578,2024-08-18T02:19:45,ACC00006918,Credit,1556.71,-1172773.14,JPY,Starbucks
TXN0000015579,2024-11-30T23:07:24,ACC00008422,Transfer,1279.7,-1171493.44,USD,Shell
TXN0000015580,2024-02-10T02:44:36,ACC00002609,ATM,114.85,-1171608.29,USD,Starbucks
TXN0000015581,2024-06-14T04:30:55,ACC00007724,Payment,686.24,-1172294.53,USD,Amazon
TXN0000015582,2024-10-03T19:26:57,ACC00009950,Credit,1529.43,-1170765.1,GBP,Grocery
TXN0000015583,2024-10-23T09:38:23,ACC00000078,Transfer,151.15,-1170613.95,GBP,Target
TXN0000015584,2024-01-03T20:08:54,ACC00006736,Credit,1938.16,-1168675.79,EUR,Shell
TXN0000015585,2024-10-28T00:38:46,ACC00006332,ATM,777.59,-1169453.38,JPY,Amazon
TXN0000015586,2024-04-17T22:36:38,ACC00006261,Payment,1999.85,-1171453.23,USD,Starbucks
TXN0000015587,2024-07-04T04:00:49,ACC00003486,Credit,774.68,-1170678.55,GBP,Target
TXN0000015588,2024-09-24T11:01:35,ACC00004199,Debit,215.65,-1170894.2,GBP,Online Store
TXN0000015589,2024-10-23T04:47:34,ACC00009917,Debit,964.6,-1171858.8,USD,Shell
TXN0000015590,2024-10-24T11:47:02,ACC00004123,Transfer,1691.55,-1170167.25,EUR,Starbucks
TXN0000015591,2024-03-26T02:33:39,ACC00009774,ATM,1337.77,-1171505.02,EUR,Starbucks
TXN0000015592,2024-12-22T06:25:09,ACC00002581,Payment,1419.62,-1172924.64,GBP,Restaurant
TXN0000015593,2024-07-02T08:52:32,ACC00004958,Debit,60.76,-1172985.4,EUR,Grocery
TXN0000015594,2024-09-11T17:16:02,ACC00006251,Payment,173.72,-1173159.12,EUR,Target
TXN0000015595,2024-03-01T09:09:37,ACC00002598,Debit,1141.28,-1174300.4,EUR,Grocery
TXN0000015596,2024-06-22T22:35:31,ACC00000542,Credit,1454.07,-1172846.33,JPY,Shell
TXN0000015597,2024-10-03T03:10:59,ACC00004373,Debit,1088.41,-1173934.74,USD,Walmart
TXN0000015598,2024-08-14T18:00:48,ACC00005835,Transfer,1716.24,-1172218.5,EUR,Starbucks
TXN0000015599,2024-02-22T02:54:55,ACC00003751,Payment,982.5,-1173201.0,EUR,Amazon
TXN0000015600,2024-08-01T22:28:50,ACC00002965,ATM,1055.83,-1174256.83,GBP,Walmart
TXN0000015601,2024-09-24T08:22:04,ACC00008335,Debit,1733.65,-1175990.48,USD,Online Store
TXN0000015602,2024-08-02T10:13:17,ACC00006406,Transfer,1760.51,-1174229.97,JPY,Starbucks
TXN0000015603,2024-02-10T01:35:36,ACC00009260,ATM,666.26,-1174896.23,GBP,Target
TXN0000015604,2024-02-13T23:37:52,ACC00007567,Transfer,1947.04,-1172949.19,GBP,Restaurant
TXN0000015605,2024-08-09T07:24:48,ACC00001102,Credit,704.99,-1172244.2,USD,Online Store
TXN0000015606,2024-05-05T19:18:15,ACC00001612,Payment,1402.43,-1173646.63,GBP,Shell
TXN0000015607,2024-01-20T09:44:35,ACC00005508,Credit,970.71,-1172675.92,EUR,Starbucks
TXN0000015608,2024-12-07T07:55:22,ACC00005550,Transfer,957.3,-1171718.62,JPY,Amazon
TXN0000015609,2024-08-14T15:03:44,ACC00001580,Transfer,1142.46,-1170576.16,JPY,Amazon
TXN0000015610,2024-07-20T11:55:11,ACC00002471,Debit,1800.57,-1172376.73,GBP,Online Store
TXN0000015611,2024-01-13T19:20:54,ACC00006911,Debit,1359.04,-1173735.77,GBP,Target
TXN0000015612,2024-05-02T04:45:50,ACC00006065,Payment,425.32,-1174161.09,USD,Grocery
TXN0000015613,2024-02-06T01:32:18,ACC00004263,Credit,1745.41,-1172415.68,JPY,Walmart
TXN0000015614,2024-11-25T01:23:58,ACC00003144,ATM,753.98,-1173169.66,GBP,Starbucks
TXN0000015615,2024-11-01T01:12:37,ACC00000086,Debit,399.85,-1173569.51,USD,Shell
TXN0000015616,2024-10-22T06:27:25,ACC00002706,Transfer,359.57,-1173209.94,JPY,Online Store
TXN0000015617,2024-09-22T16:27:24,ACC00002449,Transfer,1546.42,-1171663.52,JPY,Amazon
TXN0000015618,2024-06-20T21:46:56,ACC00003067,Payment,764.53,-1172428.05,GBP,Restaurant
TXN0000015619,2024-04-05T20:09:40,ACC00009298,Credit,579.73,-1171848.32,USD,Amazon
TXN0000015620,2024-06-18T14:05:09,ACC00005928,Debit,291.14,-1172139.46,EUR,Restaurant
TXN0000015621,2024-04-19T05:02:28,ACC00007180,Debit,546.37,-1172685.83,EUR,Shell
TXN0000015622,2024-02-08T15:55:09,ACC00005758,Payment,776.32,-1173462.15,USD,Restaurant
TXN0000015623,2024-01-19T03:27:41,ACC00009336,ATM,188.95,-1173651.1,JPY,Walmart
TXN0000015624,2024-07-13T03:35:45,ACC00000597,Transfer,1498.58,-1172152.52,EUR,Starbucks
TXN0000015625,2024-04-26T19:49:50,ACC00001127,Payment,497.98,-1172650.5,JPY,Walmart
TXN0000015626,2024-07-26T07:37:55,ACC00005184,Transfer,1226.57,-1171423.93,GBP,Shell
TXN0000015627,2024-04-02T17:43:01,ACC00004380,Debit,973.07,-1172397.0,GBP,Target
TXN0000015628,2024-10-15T17:25:34,ACC00008612,Payment,407.44,-1172804.44,USD,Grocery
TXN0000015629,2024-04-22T14:23:09,ACC00002597,ATM,1006.81,-1173811.25,USD,Grocery
TXN0000015630,2024-10-20T03:44:33,ACC00007464,ATM,295.89,-1174107.14,EUR,Walmart
TXN0000015631,2024-09-16T01:17:12,ACC00006099,ATM,915.14,-1175022.28,GBP,Target
TXN0000015632,2024-03-01T21:46:37,ACC00009342,Credit,1924.93,-1173097.35,GBP,Walmart
TXN0000015633,2024-10-28T11:12:21,ACC00007087,Credit,1789.94,-1171307.41,GBP,Target
TXN0000015634,2024-04-16T03:20:45,ACC00002413,Transfer,937.12,-1170370.29,EUR,Walmart
TXN0000015635,2024-06-26T06:19:38,ACC00001983,Debit,1553.94,-1171924.23,GBP,Shell
TXN0000015636,2024-07-20T01:15:37,ACC00008702,Debit,1863.03,-1173787.26,USD,Amazon
TXN0000015637,2024-12-02T01:57:41,ACC00001063,Debit,953.59,-1174740.85,EUR,Amazon
TXN0000015638,2024-12-04T06:25:36,ACC00001634,Transfer,468.83,-1174272.02,GBP,Amazon
TXN0000015639,2024-09-10T08:44:06,ACC00003388,Debit,227.67,-1174499.69,USD,Walmart
TXN0000015640,2024-04-06T07:58:14,ACC00006174,Debit,604.29,-1175103.98,USD,Starbucks
TXN0000015641,2024-03-14T01:25:07,ACC00001455,Transfer,1557.34,-1173546.64,GBP,Starbucks
TXN0000015642,2024-09-24T04:52:12,ACC00005036,Payment,31.31,-1173577.95,JPY,Walmart
TXN0000015643,2024-01-07T05:19:17,ACC00003884,Debit,192.14,-1173770.09,EUR,Shell
TXN0000015644,2024-12-03T21:57:38,ACC00007260,ATM,1206.78,-1174976.87,JPY,Shell
TXN0000015645,2024-12-10T20:15:59,ACC00003679,Credit,113.39,-1174863.48,EUR,Amazon
TXN0000015646,2024-06-05T18:42:58,ACC00009001,Transfer,601.01,-1174262.47,GBP,Shell
TXN0000015647,2024-07-28T14:07:49,ACC00006146,Transfer,627.91,-1173634.56,EUR,Starbucks
TXN0000015648,2024-09-29T23:52:06,ACC00002925,Debit,160.04,-1173794.6,GBP,Restaurant
TXN0000015649,2024-07-16T03:55:19,ACC00004732,Debit,287.54,-1174082.14,GBP,Target
TXN0000015650,2024-05-30T09:11:25,ACC00000636,Debit,611.74,-1174693.88,EUR,Grocery
TXN0000015651,2024-09-15T02:30:00,ACC00007459,Debit,1014.45,-1175708.33,EUR,Shell
TXN0000015652,2024-12-19T23:00:11,ACC00004671,Credit,482.43,-1175225.9,GBP,Starbucks
TXN0000015653,2024-03-26T17:28:59,ACC00000172,Payment,1881.87,-1177107.77,EUR,Shell
TXN0000015654,2024-06-26T08:15:09,ACC00007212,Debit,1415.5,-1178523.27,GBP,Amazon
TXN0000015655,2024-10-29T14:11:23,ACC00004007,Payment,869.96,-1179393.23,GBP,Restaurant
TXN0000015656,2024-08-14T21:39:52,ACC00000611,Transfer,1141.48,-1178251.75,JPY,Walmart
TXN0000015657,2024-03-09T04:22:20,ACC00007084,Transfer,1280.93,-1176970.82,EUR,Restaurant
TXN0000015658,2024-09-29T10:14:59,ACC00001273,Payment,1874.99,-1178845.81,JPY,Shell
TXN0000015659,2024-09-09T16:46:12,ACC00009815,Debit,1734.71,-1180580.52,JPY,Grocery
TXN0000015660,2024-09-28T21:31:25,ACC00009809,Debit,1817.41,-1182397.93,GBP,Shell
TXN0000015661,2024-05-03T01:16:44,ACC00009812,Payment,338.42,-1182736.35,USD,Walmart
TXN0000015662,2024-11-01T13:09:15,ACC00005098,Debit,564.72,-1183301.07,USD,Starbucks
TXN0000015663,2024-05-14T18:56:50,ACC00007189,Payment,300.71,-1183601.78,USD,Grocery
TXN0000015664,2024-09-27T07:06:35,ACC00006492,Credit,17.8,-1183583.98,USD,Target
TXN0000015665,2024-02-29T00:24:36,ACC00006076,Debit,592.07,-1184176.05,GBP,Online Store
TXN0000015666,2024-08-31T06:08:21,ACC00001972,Debit,1467.02,-1185643.07,EUR,Target
TXN0000015667,2024-07-23T10:26:45,ACC00000444,ATM,596.87,-1186239.94,USD,Online Store
TXN0000015668,2024-01-14T08:09:23,ACC00001067,ATM,249.04,-1186488.98,USD,Starbucks
TXN0000015669,2024-11-20T05:16:20,ACC00007325,ATM,1451.11,-1187940.09,EUR,Walmart
TXN0000015670,2024-07-25T06:32:26,ACC00001635,Credit,1939.92,-1186000.17,USD,Starbucks
TXN0000015671,2024-09-18T08:23:23,ACC00002551,Transfer,402.57,-1185597.6,EUR,Walmart
TXN0000015672,2024-03-11T07:49:04,ACC00008482,ATM,1762.71,-1187360.31,GBP,Amazon
TXN0000015673,2024-10-27T07:11:27,ACC00004949,ATM,1825.42,-1189185.73,JPY,Starbucks
TXN0000015674,2024-03-01T05:31:41,ACC00003493,Payment,430.88,-1189616.61,USD,Target
TXN0000015675,2024-07-18T13:10:12,ACC00009795,Payment,1047.15,-1190663.76,USD,Target
TXN0000015676,2024-08-30T11:40:02,ACC00005205,Credit,513.41,-1190150.35,GBP,Walmart
TXN0000015677,2024-12-25T22:43:39,ACC00008934,Payment,1233.66,-1191384.01,EUR,Online Store
TXN0000015678,2024-08-30T14:27:24,ACC00005508,Payment,498.58,-1191882.59,GBP,Shell
TXN0000015679,2024-07-04T15:52:45,ACC00000403,Transfer,1318.92,-1190563.67,JPY,Amazon
TXN0000015680,2024-12-19T07:52:34,ACC00000069,Payment,1849.44,-1192413.11,USD,Grocery
TXN0000015681,2024-08-10T13:48:19,ACC00008721,ATM,1650.34,-1194063.45,JPY,Restaurant
TXN0000015682,2024-03-11T16:27:59,ACC00004065,Transfer,122.6,-1193940.85,GBP,Shell
TXN0000015683,2024-12-17T09:40:52,ACC00008816,Transfer,1765.24,-1192175.61,GBP,Grocery
TXN0000015684,2024-07-23T09:03:21,ACC00001047,Credit,1429.63,-1190745.98,USD,Online Store
TXN0000015685,2024-11-02T13:01:28,ACC00001360,Payment,569.14,-1191315.12,JPY,Target
TXN0000015686,2024-12-08T07:01:34,ACC00004686,Debit,490.39,-1191805.51,USD,Target
TXN0000015687,2024-02-08T10:00:15,ACC00002242,Transfer,1718.48,-1190087.03,GBP,Grocery
TXN0000015688,2024-04-19T12:26:29,ACC00009007,Credit,552.07,-1189534.96,USD,Target
TXN0000015689,2024-04-30T14:13:35,ACC00000685,Debit,1409.41,-1190944.37,EUR,Online Store
TXN0000015690,2024-02-10T00:16:56,ACC00004277,ATM,700.05,-1191644.42,USD,Walmart
TXN0000015691,2024-09-10T10:44:55,ACC00004573,Credit,1017.2,-1190627.22,JPY,Online Store
TXN0000015692,2024-02-22T18:16:15,ACC00002712,Credit,1543.35,-1189083.87,GBP,Starbucks
TXN0000015693,2024-07-02T20:36:29,ACC00008819,ATM,301.21,-1189385.08,JPY,Starbucks
TXN0000015694,2024-06-27T01:48:26,ACC00009267,Payment,818.62,-1190203.7,USD,Walmart
TXN0000015695,2024-04-23T16:18:30,ACC00003229,Payment,1379.55,-1191583.25,EUR,Grocery
TXN0000015696,2024-07-20T17:21:14,ACC00006718,Debit,108.76,-1191692.01,EUR,Target
TXN0000015697,2024-06-20T23:59:17,ACC00002639,ATM,1429.83,-1193121.84,JPY,Starbucks
TXN0000015698,2024-07-13T23:35:20,ACC00008363,ATM,255.2,-1193377.04,JPY,Amazon
TXN0000015699,2024-09-24T18:52:35,ACC00000335,Transfer,401.5,-1192975.54,GBP,Shell
TXN0000015700,2024-01-26T16:17:15,ACC00009876,ATM,1769.94,-1194745.48,JPY,Amazon
TXN0000015701,2024-10-05T07:14:03,ACC00009809,Payment,517.84,-1195263.32,EUR,Restaurant
TXN0000015702,2024-03-11T04:45:26,ACC00009543,Transfer,50.2,-1195213.12,GBP,Amazon
TXN0000015703,2024-07-07T04:01:25,ACC00004536,Payment,130.03,-1195343.15,USD,Target
TXN0000015704,2024-06-22T17:44:30,ACC00004872,Payment,1331.08,-1196674.23,EUR,Target
TXN0000015705,2024-06-24T23:47:17,ACC00005933,ATM,597.53,-1197271.76,JPY,Walmart
TXN0000015706,2024-03-06T19:56:44,ACC00004407,Credit,1421.74,-1195850.02,JPY,Online Store
TXN0000015707,2024-03-06T03:37:07,ACC00004271,Payment,1002.82,-1196852.84,EUR,Shell
TXN0000015708,2024-07-15T15:16:10,ACC00009205,ATM,1763.03,-1198615.87,JPY,Shell
TXN0000015709,2024-06-02T08:54:59,ACC00002661,Transfer,893.22,-1197722.65,EUR,Restaurant
TXN0000015710,2024-05-03T17:31:01,ACC00005808,Payment,1034.94,-1198757.59,EUR,Online Store
TXN0000015711,2024-02-15T04:30:29,ACC00006343,Payment,1610.77,-1200368.36,USD,Amazon
TXN0000015712,2024-03-15T15:54:35,ACC00005629,Transfer,1960.47,-1198407.89,EUR,Grocery
TXN0000015713,2024-02-26T18:43:52,ACC00007824,ATM,258.46,-1198666.35,EUR,Amazon
TXN0000015714,2024-03-01T02:24:00,ACC00005242,Debit,1729.33,-1200395.68,GBP,Grocery
TXN0000015715,2024-08-10T17:30:30,ACC00004508,Debit,1123.31,-1201518.99,USD,Starbucks
TXN0000015716,2024-04-02T09:10:52,ACC00009324,Debit,970.9,-1202489.89,EUR,Walmart
TXN0000015717,2024-06-27T15:05:19,ACC00006994,Credit,1895.07,-1200594.82,USD,Amazon
TXN0000015718,2024-04-20T14:25:35,ACC00001948,Credit,748.15,-1199846.67,GBP,Shell
TXN0000015719,2024-04-04T00:45:44,ACC00005195,ATM,431.7,-1200278.37,JPY,Online Store
TXN0000015720,2024-12-27T14:01:41,ACC00003690,Debit,942.23,-1201220.6,EUR,Walmart
TXN0000015721,2024-06-13T22:58:06,ACC00004582,ATM,1360.75,-1202581.35,GBP,Shell
TXN0000015722,2024-05-05T05:09:37,ACC00002531,Debit,1489.48,-1204070.83,USD,Amazon
TXN0000015723,2024-11-20T01:12:01,ACC00000133,Transfer,1733.2,-1202337.63,GBP,Online Store
TXN0000015724,2024-11-20T22:06:49,ACC00003014,ATM,1658.26,-1203995.89,JPY,Starbucks
TXN0000015725,2024-03-07T08:34:52,ACC00001900,Credit,1586.77,-1202409.12,USD,Starbucks
TXN0000015726,2024-09-18T18:01:38,ACC00008051,Payment,434.76,-1202843.88,JPY,Target
TXN0000015727,2024-03-01T07:24:04,ACC00005921,ATM,1826.47,-1204670.35,GBP,Shell
TXN0000015728,2024-01-22T04:38:52,ACC00008579,Credit,1123.11,-1203547.24,GBP,Restaurant
TXN0000015729,2024-03-20T12:59:33,ACC00003409,Debit,720.61,-1204267.85,USD,Starbucks
TXN0000015730,2024-12-02T22:54:46,ACC00003055,Debit,1345.92,-1205613.77,GBP,Grocery
TXN0000015731,2024-10-15T21:42:02,ACC00002693,Payment,430.58,-1206044.35,EUR,Restaurant
TXN0000015732,2024-02-07T02:44:21,ACC00003530,Credit,1885.58,-1204158.77,GBP,Walmart
TXN0000015733,2024-04-07T19:32:47,ACC00004382,ATM,1289.25,-1205448.02,EUR,Starbucks
TXN0000015734,2024-01-14T07:45:49,ACC00005950,ATM,191.14,-1205639.16,USD,Shell
TXN0000015735,2024-02-09T11:09:11,ACC00000418,Transfer,417.68,-1205221.48,GBP,Grocery
TXN0000015736,2024-12-23T10:56:37,ACC00005534,Credit,1430.88,-1203790.6,USD,Amazon
TXN0000015737,2024-04-04T21:58:36,ACC00002727,Credit,170.01,-1203620.59,GBP,Starbucks
TXN0000015738,2024-07-08T22:09:29,ACC00004380,Transfer,64.62,-1203555.97,GBP,Shell
TXN0000015739,2024-02-05T22:19:27,ACC00003435,ATM,944.62,-1204500.59,EUR,Online Store
TXN0000015740,2024-12-03T22:31:24,ACC00006067,Credit,941.2,-1203559.39,EUR,Walmart
TXN0000015741,2024-07-09T14:23:04,ACC00002919,Credit,1309.6,-1202249.79,JPY,Restaurant
TXN0000015742,2024-04-27T12:33:19,ACC00002881,ATM,640.55,-1202890.34,GBP,Target
TXN0000015743,2024-08-27T17:08:29,ACC00002963,Transfer,388.85,-1202501.49,GBP,Walmart
TXN0000015744,2024-05-22T07:18:34,ACC00006100,Payment,312.04,-1202813.53,JPY,Starbucks
TXN0000015745,2024-10-17T23:38:59,ACC00006313,ATM,293.09,-1203106.62,USD,Restaurant
TXN0000015746,2024-08-12T18:40:10,ACC00003076,Credit,1075.4,-1202031.22,EUR,Starbucks
TXN0000015747,2024-12-23T23:41:35,ACC00007651,Payment,1517.98,-1203549.2,USD,Target
TXN0000015748,2024-06-24T02:25:15,ACC00001359,Payment,106.81,-1203656.01,JPY,Amazon
TXN0000015749,2024-05-28T05:43:12,ACC00009938,Transfer,411.82,-1203244.19,GBP,Amazon
TXN0000015750,2024-03-18T08:49:31,ACC00008971,Payment,1351.46,-1204595.65,USD,Shell
TXN0000015751,2024-12-27T17:44:37,ACC00004817,ATM,1738.08,-1206333.73,JPY,Target
TXN0000015752,2024-12-06T19:59:04,ACC00003656,ATM,1536.24,-1207869.97,USD,Online Store
TXN0000015753,2024-12-22T08:08:02,ACC00005355,Payment,1206.26,-1209076.23,GBP,Online Store
TXN0000015754,2024-02-14T09:24:34,ACC00004165,Transfer,1908.12,-1207168.11,EUR,Restaurant
TXN0000015755,2024-01-25T19:06:03,ACC00003622,Credit,1232.13,-1205935.98,USD,Starbucks
TXN0000015756,2024-12-19T23:45:16,ACC00000601,Transfer,1592.02,-1204343.96,USD,Grocery
TXN0000015757,2024-02-02T08:43:29,ACC00004728,ATM,925.24,-1205269.2,JPY,Walmart
TXN0000015758,2024-08-24T18:35:37,ACC00002271,Payment,1485.48,-1206754.68,USD,Online Store
TXN0000015759,2024-08-19T00:18:55,ACC00009460,Payment,1429.7,-1208184.38,USD,Shell
TXN0000015760,2024-04-16T15:18:37,ACC00007464,Debit,1941.43,-1210125.81,JPY,Online Store
TXN0000015761,2024-11-13T08:53:42,ACC00002925,Credit,814.41,-1209311.4,USD,Online Store
TXN0000015762,2024-02-24T10:18:23,ACC00000085,Payment,1668.42,-1210979.82,EUR,Online Store
TXN0000015763,2024-05-07T17:08:51,ACC00009794,Debit,77.81,-1211057.63,GBP,Restaurant
TXN0000015764,2024-06-24T15:13:32,ACC00004272,Debit,18.79,-1211076.42,EUR,Walmart
TXN0000015765,2024-04-19T15:53:37,ACC00007413,ATM,774.04,-1211850.46,USD,Starbucks
TXN0000015766,2024-03-02T17:53:45,ACC00007605,Payment,962.03,-1212812.49,GBP,Shell
TXN0000015767,2024-06-17T20:38:44,ACC00000022,ATM,90.55,-1212903.04,JPY,Target
TXN0000015768,2024-05-16T02:54:21,ACC00007696,Credit,802.63,-1212100.41,USD,Online Store
TXN0000015769,2024-10-31T18:46:50,ACC00002530,Debit,1360.01,-1213460.42,JPY,Walmart
TXN0000015770,2024-01-02T07:19:31,ACC00006648,Payment,1894.84,-1215355.26,USD,Starbucks
TXN0000015771,2024-07-04T10:56:27,ACC00007223,Transfer,413.43,-1214941.83,EUR,Target
TXN0000015772,2024-05-06T10:57:52,ACC00006849,Payment,36.57,-1214978.4,USD,Grocery
TXN0000015773,2024-06-08T06:35:31,ACC00009885,Payment,945.11,-1215923.51,JPY,Restaurant
TXN0000015774,2024-03-20T15:52:09,ACC00001051,Credit,48.87,-1215874.64,GBP,Grocery
TXN0000015775,2024-09-20T11:06:24,ACC00004306,Credit,1767.55,-1214107.09,GBP,Restaurant
TXN0000015776,2024-10-11T02:41:15,ACC00005041,Credit,619.08,-1213488.01,GBP,Online Store
TXN0000015777,2024-07-14T02:25:41,ACC00002440,Debit,1132.8,-1214620.81,USD,Target
TXN0000015778,2024-07-28T22:48:42,ACC00006439,Payment,1920.16,-1216540.97,USD,Restaurant
TXN0000015779,2024-08-14T03:38:37,ACC00008214,Transfer,33.96,-1216507.01,JPY,Starbucks
TXN0000015780,2024-01-17T06:19:54,ACC00005634,Transfer,1351.33,-1215155.68,USD,Shell
TXN0000015781,2024-02-03T04:28:37,ACC00002689,Payment,169.56,-1215325.24,EUR,Walmart
TXN0000015782,2024-04-27T06:20:54,ACC00006292,ATM,830.2,-1216155.44,GBP,Online Store
TXN0000015783,2024-04-19T18:31:25,ACC00001566,Payment,1369.03,-1217524.47,GBP,Grocery
TXN0000015784,2024-08-12T05:20:48,ACC00006955,Debit,1669.01,-1219193.48,USD,Amazon
TXN0000015785,2024-08-06T08:03:55,ACC00002020,ATM,1970.09,-1221163.57,USD,Online Store
TXN0000015786,2024-10-29T21:59:45,ACC00003213,Credit,1803.18,-1219360.39,EUR,Grocery
TXN0000015787,2024-10-23T10:46:50,ACC00005727,Transfer,1187.69,-1218172.7,GBP,Walmart
TXN0000015788,2024-06-25T05:10:10,ACC00005720,Transfer,402.68,-1217770.02,JPY,Restaurant
TXN0000015789,2024-05-26T06:58:20,ACC00007279,Payment,768.74,-1218538.76,EUR,Amazon
TXN0000015790,2024-11-30T07:03:59,ACC00005762,Transfer,1538.55,-1217000.21,GBP,Shell
TXN0000015791,2024-02-16T06:01:21,ACC00001431,Debit,1270.68,-1218270.89,USD,Starbucks
TXN0000015792,2024-11-30T01:08:24,ACC00007396,ATM,1962.86,-1220233.75,USD,Amazon
TXN0000015793,2024-12-09T18:49:34,ACC00008593,Payment,1421.88,-1221655.63,JPY,Online Store
TXN0000015794,2024-12-03T20:25:32,ACC00003004,Payment,117.59,-1221773.22,JPY,Walmart
TXN0000015795,2024-07-12T07:49:59,ACC00005394,Debit,163.42,-1221936.64,GBP,Walmart
TXN0000015796,2024-01-23T13:07:07,ACC00005851,Payment,1594.51,-1223531.15,EUR,Starbucks
TXN0000015797,2024-03-25T23:44:15,ACC00008711,Payment,1967.82,-1225498.97,JPY,Online Store
TXN0000015798,2024-02-29T18:24:08,ACC00005491,Credit,1624.96,-1223874.01,JPY,Restaurant
TXN0000015799,2024-05-04T19:29:48,ACC00007378,ATM,532.37,-1224406.38,EUR,Walmart
TXN0000015800,2024-07-30T03:00:17,ACC00006536,Payment,1561.75,-1225968.13,EUR,Grocery
TXN0000015801,2024-05-02T14:24:12,ACC00001178,Credit,168.01,-1225800.12,GBP,Shell
TXN0000015802,2024-06-19T23:18:48,ACC00008276,Transfer,1643.56,-1224156.56,EUR,Restaurant
TXN0000015803,2024-02-13T04:45:49,ACC00001847,Credit,1682.6,-1222473.96,EUR,Restaurant
TXN0000015804,2024-06-19T02:43:05,ACC00005973,ATM,1032.07,-1223506.03,GBP,Grocery
TXN0000015805,2024-06-25T15:32:28,ACC00002351,Transfer,1723.97,-1221782.06,USD,Restaurant
TXN0000015806,2024-11-06T06:32:08,ACC00000320,ATM,1211.14,-1222993.2,EUR,Walmart
TXN0000015807,2024-01-10T14:35:07,ACC00003353,ATM,1558.68,-1224551.88,JPY,Target
TXN0000015808,2024-06-28T14:14:00,ACC00007991,Credit,497.73,-1224054.15,USD,Restaurant
TXN0000015809,2024-05-02T09:26:32,ACC00008856,Payment,790.81,-1224844.96,JPY,Online Store
TXN0000015810,2024-04-28T07:55:43,ACC00007780,Transfer,1269.49,-1223575.47,EUR,Online Store
TXN0000015811,2024-01-27T20:17:47,ACC00000704,Payment,969.3,-1224544.77,USD,Restaurant
TXN0000015812,2024-06-25T04:48:01,ACC00001138,ATM,1016.46,-1225561.23,JPY,Starbucks
TXN0000015813,2024-10-13T19:15:25,ACC00002643,Debit,1736.98,-1227298.21,JPY,Shell
TXN0000015814,2024-08-02T12:30:52,ACC00007765,Credit,1674.81,-1225623.4,JPY,Restaurant
TXN0000015815,2024-01-29T03:32:25,ACC00002932,Payment,1420.39,-1227043.79,JPY,Amazon
TXN0000015816,2024-03-23T20:33:36,ACC00007513,Transfer,1733.6,-1225310.19,JPY,Grocery
TXN0000015817,2024-07-15T06:44:34,ACC00003795,ATM,799.96,-1226110.15,USD,Restaurant
TXN0000015818,2024-03-25T14:43:32,ACC00008004,Transfer,1859.12,-1224251.03,JPY,Grocery
TXN0000015819,2024-07-26T05:09:21,ACC00001364,Credit,215.8,-1224035.23,EUR,Online Store
TXN0000015820,2024-07-31T12:02:30,ACC00003403,Credit,1992.71,-1222042.52,JPY,Target
TXN0000015821,2024-11-10T21:22:31,ACC00003608,Debit,792.73,-1222835.25,USD,Shell
TXN0000015822,2024-08-29T08:31:16,ACC00008450,Transfer,519.16,-1222316.09,GBP,Grocery
TXN0000015823,2024-01-02T17:10:28,ACC00008914,Transfer,963.48,-1221352.61,EUR,Restaurant
TXN0000015824,2024-11-12T10:19:23,ACC00007694,Debit,472.8,-1221825.41,GBP,Grocery
TXN0000015825,2024-11-18T05:30:28,ACC00006053,Debit,1954.28,-1223779.69,USD,Amazon
TXN0000015826,2024-02-20T13:13:25,ACC00005856,Transfer,497.82,-1223281.87,JPY,Walmart
TXN0000015827,2024-03-03T21:20:16,ACC00001284,Payment,1887.2,-1225169.07,JPY,Restaurant
TXN0000015828,2024-12-10T03:34:32,ACC00002646,Transfer,450.94,-1224718.13,JPY,Starbucks
TXN0000015829,2024-12-18T11:28:19,ACC00004160,Debit,1780.07,-1226498.2,GBP,Amazon
TXN0000015830,2024-11-03T23:54:08,ACC00002039,Payment,1697.2,-1228195.4,GBP,Target
TXN0000015831,2024-04-14T02:27:55,ACC00007365,Debit,1619.62,-1229815.02,USD,Shell
TXN0000015832,2024-11-05T10:06:44,ACC00000006,Debit,1948.37,-1231763.39,JPY,Shell
TXN0000015833,2024-06-17T12:02:18,ACC00005907,Credit,77.7,-1231685.69,GBP,Grocery
TXN0000015834,2024-08-24T12:25:22,ACC00000010,Debit,1614.2,-1233299.89,GBP,Shell
TXN0000015835,2024-07-07T00:32:01,ACC00009091,Transfer,1022.11,-1232277.78,EUR,Restaurant
TXN0000015836,2024-11-24T21:57:39,ACC00002313,Debit,168.99,-1232446.77,USD,Restaurant
TXN0000015837,2024-11-13T13:27:35,ACC00008548,ATM,996.5,-1233443.27,EUR,Grocery
TXN0000015838,2024-07-24T05:42:03,ACC00000584,Credit,1345.49,-1232097.78,EUR,Starbucks
TXN0000015839,2024-09-18T17:16:10,ACC00006048,Transfer,1225.08,-1230872.7,GBP,Shell
TXN0000015840,2024-07-23T12:37:30,ACC00009753,Transfer,1848.17,-1229024.53,USD,Amazon
TXN0000015841,2024-03-31T14:29:49,ACC00000586,Debit,1317.97,-1230342.5,GBP,Online Store
TXN0000015842,2024-12-17T21:58:57,ACC00004412,ATM,875.97,-1231218.47,JPY,Grocery
TXN0000015843,2024-02-29T07:12:06,ACC00008709,Debit,1771.44,-1232989.91,USD,Starbucks
TXN0000015844,2024-11-07T04:48:02,ACC00008394,Transfer,1286.59,-1231703.32,GBP,Grocery
TXN0000015845,2024-08-26T17:36:21,ACC00005875,Debit,1702.87,-1233406.19,JPY,Shell
TXN0000015846,2024-01-09T01:23:58,ACC00005787,Transfer,899.57,-1232506.62,JPY,Online Store
TXN0000015847,2024-11-20T14:29:58,ACC00003290,ATM,1105.79,-1233612.41,EUR,Walmart
TXN0000015848,2024-02-11T06:01:15,ACC00002150,Credit,658.1,-1232954.31,JPY,Walmart
TXN0000015849,2024-01-06T16:52:54,ACC00003912,ATM,933.19,-1233887.5,EUR,Walmart
TXN0000015850,2024-08-22T16:24:28,ACC00008290,ATM,1561.12,-1235448.62,JPY,Walmart
TXN0000015851,2024-07-09T05:40:24,ACC00002917,Payment,1705.18,-1237153.8,JPY,Starbucks
TXN0000015852,2024-01-05T22:52:08,ACC00002817,Debit,1842.23,-1238996.03,USD,Amazon
TXN0000015853,2024-08-27T21:39:42,ACC00006968,Debit,1364.22,-1240360.25,JPY,Amazon
TXN0000015854,2024-05-26T02:17:28,ACC00008578,Debit,1802.14,-1242162.39,EUR,Amazon
TXN0000015855,2024-05-29T10:31:42,ACC00008745,Debit,430.46,-1242592.85,USD,Grocery
TXN0000015856,2024-01-24T00:41:03,ACC00000013,Payment,1595.55,-1244188.4,GBP,Grocery
TXN0000015857,2024-05-22T20:03:07,ACC00008850,ATM,194.35,-1244382.75,USD,Restaurant
TXN0000015858,2024-05-17T15:04:18,ACC00005375,Debit,1937.72,-1246320.47,JPY,Restaurant
TXN0000015859,2024-01-24T13:15:08,ACC00001523,Transfer,318.86,-1246001.61,EUR,Starbucks
TXN0000015860,2024-11-07T04:53:34,ACC00006905,Credit,880.01,-1245121.6,USD,Walmart
TXN0000015861,2024-01-12T19:01:01,ACC00002160,Debit,593.77,-1245715.37,USD,Walmart
TXN0000015862,2024-06-14T16:42:26,ACC00003077,Payment,745.17,-1246460.54,EUR,Walmart
TXN0000015863,2024-08-18T09:48:08,ACC00003084,Credit,727.06,-1245733.48,JPY,Walmart
TXN0000015864,2024-04-04T12:07:37,ACC00007869,ATM,1259.2,-1246992.68,GBP,Online Store
TXN0000015865,2024-01-13T13:16:30,ACC00008209,Payment,868.71,-1247861.39,USD,Target
TXN0000015866,2024-10-11T04:04:35,ACC00001052,Transfer,1796.82,-1246064.57,JPY,Amazon
TXN0000015867,2024-01-27T23:08:29,ACC00009265,Credit,640.24,-1245424.33,GBP,Starbucks
TXN0000015868,2024-03-02T20:03:46,ACC00003551,Transfer,503.39,-1244920.94,GBP,Restaurant
TXN0000015869,2024-05-16T05:55:10,ACC00002329,Credit,973.82,-1243947.12,EUR,Grocery
TXN0000015870,2024-04-28T04:34:12,ACC00003168,Payment,1740.52,-1245687.64,EUR,Target
TXN0000015871,2024-11-01T09:45:54,ACC00004748,Transfer,1051.68,-1244635.96,GBP,Shell
TXN0000015872,2024-03-23T15:04:45,ACC00007099,Credit,1434.37,-1243201.59,EUR,Walmart
TXN0000015873,2024-01-28T07:16:44,ACC00009432,Credit,714.75,-1242486.84,GBP,Grocery
TXN0000015874,2024-12-01T19:42:42,ACC00007745,Transfer,156.51,-1242330.33,JPY,Shell
TXN0000015875,2024-08-06T10:20:35,ACC00005160,Debit,1585.18,-1243915.51,JPY,Amazon
TXN0000015876,2024-07-06T05:35:52,ACC00007731,Payment,68.19,-1243983.7,JPY,Target
TXN0000015877,2024-04-22T07:30:02,ACC00009262,Payment,183.06,-1244166.76,USD,Online Store
TXN0000015878,2024-07-31T11:34:55,ACC00005081,ATM,1204.72,-1245371.48,USD,Walmart
TXN0000015879,2024-11-14T07:17:44,ACC00007148,Credit,228.03,-1245143.45,EUR,Shell
TXN0000015880,2024-09-22T14:44:34,ACC00007106,Debit,442.74,-1245586.19,EUR,Restaurant
TXN0000015881,2024-10-17T06:11:55,ACC00008958,Transfer,1521.79,-1244064.4,JPY,Online Store
TXN0000015882,2024-02-23T15:48:37,ACC00008845,Transfer,1065.78,-1242998.62,USD,Restaurant
TXN0000015883,2024-02-07T22:52:53,ACC00008161,Transfer,997.94,-1242000.68,GBP,Shell
TXN0000015884,2024-06-20T11:50:48,ACC00005903,Payment,126.75,-1242127.43,USD,Shell
TXN0000015885,2024-08-06T21:10:07,ACC00009926,ATM,1580.17,-1243707.6,JPY,Online Store
TXN0000015886,2024-03-08T01:43:18,ACC00006464,Debit,497.8,-1244205.4,JPY,Starbucks
TXN0000015887,2024-11-23T10:12:55,ACC00008655,Transfer,949.57,-1243255.83,JPY,Online Store
TXN0000015888,2024-06-15T21:34:43,ACC00008084,Payment,1622.39,-1244878.22,GBP,Restaurant
TXN0000015889,2024-10-08T20:30:24,ACC00000795,ATM,1580.56,-1246458.78,GBP,Target
TXN0000015890,2024-10-11T02:23:12,ACC00002414,Transfer,990.84,-1245467.94,JPY,Starbucks
TXN0000015891,2024-05-02T15:58:06,ACC00002894,Payment,478.0,-1245945.94,USD,Grocery
TXN0000015892,2024-12-06T18:22:48,ACC00003386,ATM,168.96,-1246114.9,GBP,Starbucks
TXN0000015893,2024-10-09T07:09:10,ACC00006417,ATM,513.5,-1246628.4,EUR,Restaurant
TXN0000015894,2024-06-24T22:27:17,ACC00006185,Debit,55.8,-1246684.2,USD,Target
TXN0000015895,2024-02-07T20:46:56,ACC00001367,Debit,277.42,-1246961.62,GBP,Walmart
TXN0000015896,2024-05-20T06:05:40,ACC00003566,ATM,1720.78,-1248682.4,EUR,Amazon
TXN0000015897,2024-12-07T10:27:51,ACC00001053,ATM,1950.89,-1250633.29,EUR,Starbucks
TXN0000015898,2024-06-01T16:27:42,ACC00002288,ATM,238.51,-1250871.8,GBP,Starbucks
TXN0000015899,2024-05-21T08:59:29,ACC00007417,Debit,612.74,-1251484.54,EUR,Starbucks
TXN0000015900,2024-06-20T19:44:55,ACC00008809,ATM,511.97,-1251996.51,EUR,Online Store
TXN0000015901,2024-12-26T21:58:46,ACC00004489,Credit,1712.79,-1250283.72,JPY,Restaurant
TXN0000015902,2024-01-09T15:59:49,ACC00004423,Credit,521.93,-1249761.79,EUR,Online Store
TXN0000015903,2024-06-15T21:25:46,ACC00008691,Transfer,1349.73,-1248412.06,USD,Walmart
TXN0000015904,2024-12-08T14:26:16,ACC00002542,Credit,1550.74,-1246861.32,JPY,Online Store
TXN0000015905,2024-05-09T03:22:57,ACC00004580,Credit,286.23,-1246575.09,EUR,Shell
TXN0000015906,2024-11-07T00:17:17,ACC00008992,Transfer,1425.18,-1245149.91,USD,Online Store
TXN0000015907,2024-12-06T17:16:39,ACC00006940,Transfer,1736.76,-1243413.15,JPY,Shell
TXN0000015908,2024-11-22T13:07:17,ACC00009337,Transfer,64.35,-1243348.8,USD,Restaurant
TXN0000015909,2024-09-08T14:53:06,ACC00005362,Transfer,82.6,-1243266.2,EUR,Online Store
TXN0000015910,2024-11-13T05:40:46,ACC00009710,Payment,1953.74,-1245219.94,JPY,Restaurant
TXN0000015911,2024-01-20T00:46:33,ACC00007838,Debit,637.93,-1245857.87,USD,Online Store
TXN0000015912,2024-05-24T03:43:48,ACC00008958,Payment,1414.64,-1247272.51,EUR,Online Store
TXN0000015913,2024-04-11T05:46:22,ACC00005981,Transfer,464.75,-1246807.76,JPY,Walmart
TXN0000015914,2024-11-27T11:10:42,ACC00004319,Debit,1353.27,-1248161.03,EUR,Grocery
TXN0000015915,2024-08-29T18:15:28,ACC00005105,Transfer,327.9,-1247833.13,USD,Shell
TXN0000015916,2024-10-01T13:46:01,ACC00008050,Payment,1404.38,-1249237.51,JPY,Target
TXN0000015917,2024-05-03T12:09:24,ACC00001854,Credit,1984.62,-1247252.89,USD,Starbucks
TXN0000015918,2024-06-22T02:04:56,ACC00003372,ATM,1745.4,-1248998.29,JPY,Target
TXN0000015919,2024-12-04T03:08:38,ACC00006457,Transfer,681.44,-1248316.85,GBP,Target
TXN0000015920,2024-07-23T01:18:19,ACC00001465,Transfer,1610.65,-1246706.2,GBP,Grocery
TXN0000015921,2024-02-20T15:36:49,ACC00005916,Payment,686.51,-1247392.71,GBP,Shell
TXN0000015922,2024-08-12T03:53:36,ACC00000259,Credit,287.52,-1247105.19,USD,Starbucks
TXN0000015923,2024-04-27T02:55:51,ACC00008571,Credit,369.14,-1246736.05,JPY,Grocery
TXN0000015924,2024-12-24T21:49:19,ACC00001639,Credit,961.21,-1245774.84,EUR,Restaurant
TXN0000015925,2024-06-28T15:22:28,ACC00000962,Credit,798.88,-1244975.96,EUR,Shell
TXN0000015926,2024-09-26T04:17:52,ACC00005934,Credit,879.27,-1244096.69,GBP,Grocery
TXN0000015927,2024-11-14T22:14:41,ACC00002966,Transfer,1737.87,-1242358.82,JPY,Shell
TXN0000015928,2024-11-06T05:31:33,ACC00009589,Payment,17.81,-1242376.63,EUR,Online Store
TXN0000015929,2024-05-05T00:59:53,ACC00005548,Debit,325.34,-1242701.97,EUR,Shell
TXN0000015930,2024-05-24T02:35:39,ACC00004553,Transfer,1255.05,-1241446.92,USD,Starbucks
TXN0000015931,2024-06-17T09:32:24,ACC00002352,ATM,1152.77,-1242599.69,GBP,Starbucks
TXN0000015932,2024-11-13T08:19:27,ACC00007218,Credit,1325.77,-1241273.92,USD,Target
TXN0000015933,2024-09-02T17:10:06,ACC00003919,Transfer,241.17,-1241032.75,GBP,Starbucks
TXN0000015934,2024-09-26T00:58:24,ACC00006239,Credit,1162.34,-1239870.41,EUR,Starbucks
TXN0000015935,2024-07-03T04:15:08,ACC00001752,ATM,1519.4,-1241389.81,EUR,Target
TXN0000015936,2024-10-10T01:17:40,ACC00002842,ATM,962.06,-1242351.87,JPY,Restaurant
TXN0000015937,2024-03-19T09:58:22,ACC00008109,Transfer,1329.86,-1241022.01,GBP,Restaurant
TXN0000015938,2024-11-23T17:23:42,ACC00000741,Payment,1672.55,-1242694.56,JPY,Restaurant
TXN0000015939,2024-10-29T23:53:25,ACC00008434,Debit,1680.15,-1244374.71,GBP,Target
TXN0000015940,2024-03-07T08:47:13,ACC00000124,Transfer,1442.2,-1242932.51,JPY,Restaurant
TXN0000015941,2024-02-08T18:27:30,ACC00007950,Payment,1594.02,-1244526.53,EUR,Target
TXN0000015942,2024-02-29T00:41:31,ACC00008762,Payment,935.68,-1245462.21,GBP,Online Store
TXN0000015943,2024-05-20T00:53:43,ACC00001960,Payment,1268.34,-1246730.55,EUR,Walmart
TXN0000015944,2024-05-02T04:15:24,ACC00007833,ATM,89.98,-1246820.53,JPY,Amazon
TXN0000015945,2024-06-05T20:37:39,ACC00007797,Credit,136.66,-1246683.87,GBP,Walmart
TXN0000015946,2024-04-23T08:32:21,ACC00009610,ATM,253.09,-1246936.96,EUR,Shell
TXN0000015947,2024-02-17T14:27:21,ACC00003221,Credit,1226.85,-1245710.11,GBP,Amazon
TXN0000015948,2024-12-16T11:19:56,ACC00002968,ATM,843.46,-1246553.57,JPY,Starbucks
TXN0000015949,2024-08-08T04:42:51,ACC00008621,Credit,527.46,-1246026.11,GBP,Shell
TXN0000015950,2024-08-01T10:53:50,ACC00005449,Payment,681.46,-1246707.57,EUR,Online Store
TXN0000015951,2024-04-13T06:53:37,ACC00005087,Debit,1956.46,-1248664.03,GBP,Amazon
TXN0000015952,2024-01-04T23:17:26,ACC00006276,Transfer,557.8,-1248106.23,GBP,Walmart
TXN0000015953,2024-08-14T08:40:52,ACC00007667,ATM,509.67,-1248615.9,EUR,Target
TXN0000015954,2024-09-06T20:06:19,ACC00008952,Debit,1131.16,-1249747.06,USD,Shell
TXN0000015955,2024-09-25T12:11:23,ACC00003585,Credit,95.74,-1249651.32,USD,Shell
TXN0000015956,2024-08-16T03:11:27,ACC00007421,Payment,1398.27,-1251049.59,GBP,Online Store
TXN0000015957,2024-03-20T05:19:43,ACC00000751,Credit,1038.04,-1250011.55,EUR,Amazon
TXN0000015958,2024-05-13T23:00:11,ACC00001459,Transfer,1551.03,-1248460.52,GBP,Online Store
TXN0000015959,2024-10-26T14:21:28,ACC00000878,Debit,1588.15,-1250048.67,GBP,Amazon
TXN0000015960,2024-11-06T11:19:00,ACC00009545,Credit,1489.19,-1248559.48,JPY,Target
TXN0000015961,2024-02-26T21:39:31,ACC00004655,Transfer,162.74,-1248396.74,JPY,Starbucks
TXN0000015962,2024-12-11T10:28:43,ACC00009803,Debit,828.54,-1249225.28,USD,Online Store
TXN0000015963,2024-03-07T19:46:01,ACC00004452,Debit,913.61,-1250138.89,USD,Grocery
TXN0000015964,2024-12-20T07:55:12,ACC00002205,Payment,1087.69,-1251226.58,JPY,Grocery
TXN0000015965,2024-03-05T10:08:18,ACC00001831,ATM,1317.42,-1252544.0,EUR,Shell
TXN0000015966,2024-05-09T13:15:45,ACC00004281,Payment,1417.57,-1253961.57,USD,Shell
TXN0000015967,2024-12-14T04:54:04,ACC00007889,Debit,1456.9,-1255418.47,USD,Walmart
TXN0000015968,2024-07-20T15:02:28,ACC00007004,Credit,1984.9,-1253433.57,USD,Restaurant
TXN0000015969,2024-10-01T08:01:32,ACC00006316,ATM,469.9,-1253903.47,USD,Grocery
TXN0000015970,2024-10-02T19:28:58,ACC00009958,Payment,627.91,-1254531.38,GBP,Walmart
TXN0000015971,2024-03-27T15:33:21,ACC00009188,Transfer,1732.72,-1252798.66,JPY,Shell
TXN0000015972,2024-01-06T15:44:49,ACC00004268,Transfer,153.56,-1252645.1,GBP,Shell
TXN0000015973,2024-10-17T18:50:22,ACC00000594,Transfer,884.89,-1251760.21,JPY,Starbucks
TXN0000015974,2024-03-31T15:23:37,ACC00006477,Transfer,1187.53,-1250572.68,EUR,Shell
TXN0000015975,2024-10-18T17:09:05,ACC00004505,ATM,1292.99,-1251865.67,GBP,Grocery
TXN0000015976,2024-01-17T14:33:42,ACC00009644,Transfer,275.15,-1251590.52,JPY,Grocery
TXN0000015977,2024-12-23T05:23:07,ACC00000613,Debit,1223.29,-1252813.81,EUR,Shell
TXN0000015978,2024-07-21T17:52:32,ACC00009530,Credit,1773.82,-1251039.99,EUR,Shell
TXN0000015979,2024-06-19T09:12:11,ACC00002362,Debit,1723.36,-1252763.35,JPY,Restaurant
TXN0000015980,2024-02-17T20:16:32,ACC00007918,Debit,1308.09,-1254071.44,GBP,Starbucks
TXN0000015981,2024-08-11T21:31:40,ACC00009142,Debit,888.85,-1254960.29,JPY,Walmart
TXN0000015982,2024-02-25T12:29:10,ACC00009847,ATM,800.11,-1255760.4,EUR,Grocery
TXN0000015983,2024-11-06T09:36:05,ACC00001154,Credit,1247.92,-1254512.48,GBP,Walmart
TXN0000015984,2024-01-20T03:18:32,ACC00000212,Debit,937.41,-1255449.89,EUR,Target
TXN0000015985,2024-11-16T11:35:23,ACC00008417,Debit,1898.79,-1257348.68,USD,Starbucks
TXN0000015986,2024-06-08T06:03:45,ACC00004450,Debit,177.7,-1257526.38,JPY,Amazon
TXN0000015987,2024-07-04T18:39:41,ACC00006354,Debit,703.48,-1258229.86,USD,Online Store
TXN0000015988,2024-10-22T07:45:12,ACC00009739,ATM,1659.71,-1259889.57,USD,Starbucks
TXN0000015989,2024-11-11T22:56:18,ACC00000696,ATM,355.13,-1260244.7,USD,Target
TXN0000015990,2024-07-07T13:47:05,ACC00001026,Payment,203.14,-1260447.84,EUR,Online Store
TXN0000015991,2024-04-18T06:16:41,ACC00001721,Debit,1157.09,-1261604.93,GBP,Online Store
TXN0000015992,2024-10-04T23:16:49,ACC00007263,Payment,180.43,-1261785.36,USD,Grocery
TXN0000015993,2024-02-18T10:12:33,ACC00007974,Payment,1256.03,-1263041.39,JPY,Amazon
TXN0000015994,2024-01-11T04:43:43,ACC00003234,Transfer,390.52,-1262650.87,GBP,Grocery
TXN0000015995,2024-05-18T02:52:31,ACC00001683,Transfer,1396.94,-1261253.93,USD,Target
TXN0000015996,2024-07-15T02:19:57,ACC00009689,ATM,1238.63,-1262492.56,GBP,Walmart
TXN0000015997,2024-06-27T05:08:09,ACC00003775,Payment,1835.3,-1264327.86,USD,Grocery
TXN0000015998,2024-06-08T05:04:19,ACC00003065,Credit,737.27,-1263590.59,JPY,Shell
TXN0000015999,2024-06-23T21:25:14,ACC00001349,Debit,607.48,-1264198.07,JPY,Walmart
TXN0000016000,2024-12-24T12:38:22,ACC00002233,Transfer,1347.41,-1262850.66,GBP,Shell
TXN0000016001,2024-10-18T21:02:30,ACC00004570,Transfer,1791.38,-1261059.28,USD,Target
TXN0000016002,2024-09-08T12:00:10,ACC00009347,Debit,121.07,-1261180.35,USD,Starbucks
TXN0000016003,2024-05-23T09:04:50,ACC00004558,Payment,1745.92,-1262926.27,JPY,Starbucks
TXN0000016004,2024-12-06T19:50:12,ACC00007795,Transfer,1369.57,-1261556.7,EUR,Starbucks
TXN0000016005,2024-10-28T05:24:51,ACC00000800,ATM,679.57,-1262236.27,USD,Grocery
TXN0000016006,2024-07-23T07:22:15,ACC00003801,Credit,1722.86,-1260513.41,JPY,Amazon
TXN0000016007,2024-08-15T20:49:44,ACC00008053,Transfer,19.06,-1260494.35,GBP,Online Store
TXN0000016008,2024-05-06T18:29:35,ACC00009242,Payment,928.62,-1261422.97,EUR,Online Store
TXN0000016009,2024-12-25T04:54:15,ACC00005687,Debit,366.05,-1261789.02,GBP,Target
TXN0000016010,2024-05-10T05:56:53,ACC00004365,Credit,1630.12,-1260158.9,GBP,Walmart
TXN0000016011,2024-01-13T13:06:59,ACC00001725,Credit,399.48,-1259759.42,GBP,Restaurant
TXN0000016012,2024-07-07T08:35:18,ACC00004665,Transfer,846.17,-1258913.25,USD,Restaurant
TXN0000016013,2024-01-11T05:44:31,ACC00002426,Payment,809.07,-1259722.32,JPY,Walmart
TXN0000016014,2024-09-20T23:56:13,ACC00007178,Credit,1146.78,-1258575.54,USD,Grocery
TXN0000016015,2024-03-29T14:34:52,ACC00004282,Transfer,224.46,-1258351.08,USD,Walmart
TXN0000016016,2024-10-21T11:07:48,ACC00001830,Credit,624.37,-1257726.71,EUR,Grocery
TXN0000016017,2024-04-25T15:12:10,ACC00009512,ATM,106.21,-1257832.92,JPY,Amazon
TXN0000016018,2024-10-10T07:13:21,ACC00008801,Credit,1249.75,-1256583.17,EUR,Amazon
TXN0000016019,2024-11-17T19:48:23,ACC00004132,Debit,1908.33,-1258491.5,USD,Restaurant
TXN0000016020,2024-04-04T05:39:02,ACC00001781,Payment,327.25,-1258818.75,JPY,Grocery
TXN0000016021,2024-04-12T17:30:23,ACC00002076,ATM,559.8,-1259378.55,JPY,Restaurant
TXN0000016022,2024-04-15T14:00:54,ACC00009468,Transfer,1196.55,-1258182.0,USD,Online Store
TXN0000016023,2024-02-06T23:55:22,ACC00007286,Transfer,898.11,-1257283.89,USD,Restaurant
TXN0000016024,2024-04-19T18:05:09,ACC00006509,ATM,902.91,-1258186.8,USD,Grocery
TXN0000016025,2024-01-20T23:38:54,ACC00003725,ATM,1503.95,-1259690.75,USD,Grocery
TXN0000016026,2024-05-05T17:35:28,ACC00007542,Payment,751.82,-1260442.57,USD,Grocery
TXN0000016027,2024-07-22T13:04:48,ACC00003179,ATM,907.73,-1261350.3,JPY,Grocery
TXN0000016028,2024-03-16T07:35:22,ACC00009388,Credit,1461.94,-1259888.36,USD,Starbucks
TXN0000016029,2024-04-24T20:05:35,ACC00009302,ATM,1515.87,-1261404.23,EUR,Walmart
TXN0000016030,2024-07-23T21:23:23,ACC00002684,Payment,933.97,-1262338.2,JPY,Shell
TXN0000016031,2024-06-19T08:00:02,ACC00003861,Credit,1026.48,-1261311.72,GBP,Online Store
TXN0000016032,2024-05-10T14:41:53,ACC00007327,ATM,652.31,-1261964.03,EUR,Online Store
TXN0000016033,2024-08-09T16:05:41,ACC00005337,Payment,759.03,-1262723.06,USD,Walmart
TXN0000016034,2024-03-05T15:18:14,ACC00004086,Debit,893.16,-1263616.22,JPY,Online Store
TXN0000016035,2024-12-27T21:33:59,ACC00000117,Credit,1316.45,-1262299.77,JPY,Starbucks
TXN0000016036,2024-10-18T19:57:07,ACC00009125,Payment,1858.42,-1264158.19,JPY,Grocery
TXN0000016037,2024-03-05T22:06:55,ACC00006340,Payment,226.68,-1264384.87,JPY,Target
TXN0000016038,2024-06-30T09:14:36,ACC00002075,Debit,142.76,-1264527.63,GBP,Online Store
TXN0000016039,2024-11-23T12:58:45,ACC00002951,Credit,1553.46,-1262974.17,JPY,Target
TXN0000016040,2024-07-15T13:55:38,ACC00006941,Credit,819.49,-1262154.68,GBP,Starbucks
TXN0000016041,2024-09-25T12:31:54,ACC00000010,Transfer,857.79,-1261296.89,USD,Grocery
TXN0000016042,2024-03-14T19:11:18,ACC00004173,Transfer,660.25,-1260636.64,JPY,Online Store
TXN0000016043,2024-02-29T01:46:31,ACC00004987,Transfer,420.45,-1260216.19,USD,Target
TXN0000016044,2024-10-18T20:20:55,ACC00001387,Credit,407.39,-1259808.8,USD,Walmart
TXN0000016045,2024-02-11T00:44:13,ACC00007435,Debit,839.33,-1260648.13,USD,Target
TXN0000016046,2024-06-20T04:04:55,ACC00003902,Credit,633.51,-1260014.62,GBP,Online Store
TXN0000016047,2024-06-06T17:01:28,ACC00003729,ATM,1231.86,-1261246.48,JPY,Online Store
TXN0000016048,2024-04-26T21:01:46,ACC00005166,Debit,1496.45,-1262742.93,EUR,Starbucks
TXN0000016049,2024-10-05T14:45:22,ACC00007316,Credit,1097.35,-1261645.58,EUR,Starbucks
TXN0000016050,2024-06-26T18:00:20,ACC00005392,Payment,1712.28,-1263357.86,USD,Starbucks
TXN0000016051,2024-08-26T07:31:55,ACC00004064,Credit,1464.5,-1261893.36,EUR,Restaurant
TXN0000016052,2024-11-28T19:43:58,ACC00005151,Transfer,1981.15,-1259912.21,JPY,Online Store
TXN0000016053,2024-06-05T02:31:40,ACC00006930,Credit,998.31,-1258913.9,USD,Grocery
TXN0000016054,2024-03-05T20:40:06,ACC00006189,Credit,1709.44,-1257204.46,USD,Amazon
TXN0000016055,2024-02-19T14:31:26,ACC00002863,Transfer,640.93,-1256563.53,USD,Starbucks
TXN0000016056,2024-12-17T16:16:00,ACC00009235,Payment,1773.54,-1258337.07,GBP,Amazon
TXN0000016057,2024-06-16T02:22:34,ACC00000579,Transfer,1236.32,-1257100.75,EUR,Target
TXN0000016058,2024-03-04T03:35:12,ACC00007630,Transfer,542.53,-1256558.22,EUR,Online Store
TXN0000016059,2024-06-18T06:21:29,ACC00002809,Credit,69.77,-1256488.45,GBP,Shell
TXN0000016060,2024-09-07T12:10:00,ACC00007821,Credit,24.05,-1256464.4,EUR,Restaurant
TXN0000016061,2024-11-13T09:01:52,ACC00004774,Credit,1503.28,-1254961.12,GBP,Grocery
TXN0000016062,2024-01-02T09:39:32,ACC00009064,Transfer,1251.69,-1253709.43,USD,Starbucks
TXN0000016063,2024-11-07T23:21:52,ACC00003673,Payment,414.21,-1254123.64,EUR,Target
TXN0000016064,2024-07-06T05:26:09,ACC00002893,Transfer,1517.59,-1252606.05,EUR,Walmart
TXN0000016065,2024-12-15T17:49:29,ACC00008823,Debit,1224.99,-1253831.04,JPY,Amazon
TXN0000016066,2024-12-19T05:09:07,ACC00006252,Payment,867.19,-1254698.23,JPY,Restaurant
TXN0000016067,2024-08-30T12:27:29,ACC00003348,Payment,196.62,-1254894.85,GBP,Online Store
TXN0000016068,2024-09-28T04:11:56,ACC00001938,Credit,877.39,-1254017.46,JPY,Grocery
TXN0000016069,2024-11-15T22:01:22,ACC00001697,Debit,698.08,-1254715.54,EUR,Grocery
TXN0000016070,2024-02-07T05:01:10,ACC00008323,Credit,1357.42,-1253358.12,JPY,Walmart
TXN0000016071,2024-11-30T09:50:14,ACC00002957,Payment,1737.17,-1255095.29,JPY,Online Store
TXN0000016072,2024-08-13T21:20:55,ACC00007695,Transfer,1066.73,-1254028.56,USD,Starbucks
TXN0000016073,2024-09-30T11:54:10,ACC00008854,Payment,868.34,-1254896.9,GBP,Restaurant
TXN0000016074,2024-08-03T00:51:43,ACC00008710,Transfer,137.33,-1254759.57,USD,Walmart
TXN0000016075,2024-01-05T12:00:42,ACC00002281,Credit,1139.87,-1253619.7,JPY,Online Store
TXN0000016076,2024-01-15T09:58:20,ACC00005471,ATM,1391.08,-1255010.78,JPY,Online Store
TXN0000016077,2024-04-29T05:32:15,ACC00008368,Debit,1319.82,-1256330.6,EUR,Starbucks
TXN0000016078,2024-12-27T23:57:28,ACC00000168,ATM,628.62,-1256959.22,EUR,Target
TXN0000016079,2024-11-12T01:30:14,ACC00002469,Debit,1812.52,-1258771.74,USD,Restaurant
TXN0000016080,2024-12-29T14:00:53,ACC00000465,Payment,679.2,-1259450.94,USD,Shell
TXN0000016081,2024-07-26T14:14:45,ACC00008976,Credit,1129.84,-1258321.1,EUR,Grocery
TXN0000016082,2024-11-05T19:39:06,ACC00008036,Debit,762.9,-1259084.0,USD,Shell
TXN0000016083,2024-11-01T09:07:45,ACC00001417,Transfer,309.43,-1258774.57,EUR,Shell
TXN0000016084,2024-03-14T03:28:20,ACC00006773,Transfer,623.91,-1258150.66,USD,Grocery
TXN0000016085,2024-05-31T04:27:52,ACC00000269,Payment,373.7,-1258524.36,USD,Starbucks
TXN0000016086,2024-10-29T15:47:07,ACC00005721,Credit,1758.96,-1256765.4,USD,Amazon
TXN0000016087,2024-09-27T13:51:14,ACC00008041,ATM,362.15,-1257127.55,GBP,Amazon
TXN0000016088,2024-05-02T02:09:04,ACC00004584,Debit,355.05,-1257482.6,GBP,Grocery
TXN0000016089,2024-02-10T23:23:15,ACC00004758,Transfer,1925.52,-1255557.08,EUR,Amazon
TXN0000016090,2024-03-03T10:46:25,ACC00002986,Debit,1527.29,-1257084.37,EUR,Walmart
TXN0000016091,2024-07-11T07:34:23,ACC00003819,ATM,550.92,-1257635.29,USD,Shell
TXN0000016092,2024-07-08T18:36:31,ACC00008597,ATM,1136.32,-1258771.61,GBP,Target
TXN0000016093,2024-10-31T19:31:33,ACC00008345,ATM,1597.74,-1260369.35,EUR,Walmart
TXN0000016094,2024-11-18T15:47:32,ACC00004728,Credit,1439.85,-1258929.5,JPY,Restaurant
TXN0000016095,2024-05-11T21:53:59,ACC00007373,Debit,1502.1,-1260431.6,GBP,Online Store
TXN0000016096,2024-12-20T11:59:25,ACC00004615,Debit,1493.19,-1261924.79,GBP,Grocery
TXN0000016097,2024-11-23T02:03:52,ACC00005691,ATM,1870.36,-1263795.15,EUR,Online Store
TXN0000016098,2024-03-19T17:45:29,ACC00004871,Credit,1802.53,-1261992.62,GBP,Grocery
TXN0000016099,2024-03-07T08:13:26,ACC00006529,ATM,1623.82,-1263616.44,USD,Shell
TXN0000016100,2024-10-05T01:48:33,ACC00006254,Credit,1243.47,-1262372.97,EUR,Shell
TXN0000016101,2024-12-21T18:45:19,ACC00002420,Debit,755.74,-1263128.71,GBP,Grocery
TXN0000016102,2024-02-25T10:46:19,ACC00005985,Debit,1424.32,-1264553.03,GBP,Walmart
TXN0000016103,2024-07-04T23:48:32,ACC00007713,Credit,171.43,-1264381.6,JPY,Restaurant
TXN0000016104,2024-03-01T06:32:56,ACC00002281,ATM,879.69,-1265261.29,JPY,Online Store
TXN0000016105,2024-09-27T09:43:26,ACC00004600,Credit,518.05,-1264743.24,GBP,Target
TXN0000016106,2024-05-13T01:25:36,ACC00002647,Payment,944.05,-1265687.29,GBP,Target
TXN0000016107,2024-05-12T12:13:42,ACC00007189,Credit,1989.31,-1263697.98,JPY,Walmart
TXN0000016108,2024-09-18T09:31:25,ACC00008065,Credit,210.61,-1263487.37,USD,Target
TXN0000016109,2024-01-27T08:46:07,ACC00005667,Credit,1759.0,-1261728.37,EUR,Target
TXN0000016110,2024-11-05T13:22:01,ACC00003179,Debit,1213.32,-1262941.69,JPY,Shell
TXN0000016111,2024-04-21T01:31:51,ACC00005679,Payment,401.8,-1263343.49,USD,Online Store
TXN0000016112,2024-09-26T16:59:14,ACC00005104,Payment,373.36,-1263716.85,GBP,Starbucks
TXN0000016113,2024-04-16T19:00:26,ACC00002341,Debit,1804.46,-1265521.31,GBP,Shell
TXN0000016114,2024-01-14T21:01:41,ACC00009733,Payment,1016.75,-1266538.06,JPY,Online Store
TXN0000016115,2024-06-15T21:23:25,ACC00001302,Payment,636.93,-1267174.99,JPY,Online Store
TXN0000016116,2024-09-25T10:27:30,ACC00004405,Debit,400.84,-1267575.83,EUR,Restaurant
TXN0000016117,2024-01-11T03:26:31,ACC00001787,Transfer,185.2,-1267390.63,USD,Restaurant
TXN0000016118,2024-01-13T00:21:44,ACC00000963,Payment,665.33,-1268055.96,USD,Online Store
TXN0000016119,2024-03-14T18:01:06,ACC00009728,Credit,1936.81,-1266119.15,JPY,Restaurant
TXN0000016120,2024-07-05T12:58:51,ACC00003341,Payment,1926.52,-1268045.67,GBP,Amazon
TXN0000016121,2024-08-07T17:49:01,ACC00007967,Credit,1370.58,-1266675.09,EUR,Online Store
TXN0000016122,2024-06-29T01:56:16,ACC00004601,ATM,955.48,-1267630.57,JPY,Restaurant
TXN0000016123,2024-10-19T01:57:23,ACC00009507,Debit,610.78,-1268241.35,USD,Walmart
TXN0000016124,2024-03-08T04:48:44,ACC00000493,Payment,529.84,-1268771.19,EUR,Walmart
TXN0000016125,2024-10-23T00:29:03,ACC00006696,Credit,1801.1,-1266970.09,USD,Target
TXN0000016126,2024-09-02T17:18:37,ACC00000805,ATM,796.89,-1267766.98,GBP,Walmart
TXN0000016127,2024-09-26T17:38:36,ACC00007597,ATM,1457.16,-1269224.14,GBP,Restaurant
TXN0000016128,2024-09-07T08:21:08,ACC00002161,Transfer,1753.02,-1267471.12,USD,Walmart
TXN0000016129,2024-11-03T14:53:22,ACC00006955,Transfer,1591.79,-1265879.33,EUR,Online Store
TXN0000016130,2024-01-28T03:34:32,ACC00001860,Payment,710.91,-1266590.24,JPY,Walmart
TXN0000016131,2024-06-18T22:29:42,ACC00002817,Debit,713.99,-1267304.23,USD,Restaurant
TXN0000016132,2024-06-18T07:47:12,ACC00009557,Credit,1810.2,-1265494.03,EUR,Online Store
TXN0000016133,2024-12-20T21:09:26,ACC00002821,Transfer,105.42,-1265388.61,JPY,Shell
TXN0000016134,2024-11-26T01:48:16,ACC00007843,Payment,1905.83,-1267294.44,EUR,Target
TXN0000016135,2024-12-19T19:24:17,ACC00003662,ATM,881.51,-1268175.95,GBP,Amazon
TXN0000016136,2024-10-09T16:44:38,ACC00003818,ATM,516.33,-1268692.28,EUR,Online Store
TXN0000016137,2024-04-24T18:00:37,ACC00001472,ATM,842.99,-1269535.27,JPY,Walmart
TXN0000016138,2024-02-28T19:57:59,ACC00007657,Transfer,1081.47,-1268453.8,USD,Grocery
TXN0000016139,2024-12-12T00:59:41,ACC00004202,Credit,1138.19,-1267315.61,JPY,Grocery
TXN0000016140,2024-06-28T12:25:46,ACC00002116,ATM,230.38,-1267545.99,USD,Restaurant
TXN0000016141,2024-08-20T13:20:39,ACC00005903,Debit,1546.42,-1269092.41,USD,Online Store
TXN0000016142,2024-05-21T15:21:45,ACC00001121,Transfer,236.95,-1268855.46,JPY,Amazon
TXN0000016143,2024-02-03T20:33:02,ACC00003042,Credit,737.5,-1268117.96,EUR,Amazon
TXN0000016144,2024-05-03T14:21:19,ACC00007349,Debit,739.44,-1268857.4,GBP,Shell
TXN0000016145,2024-04-12T22:16:54,ACC00009189,Credit,1975.77,-1266881.63,USD,Shell
TXN0000016146,2024-02-02T09:47:43,ACC00003194,Credit,1710.06,-1265171.57,JPY,Amazon
TXN0000016147,2024-03-02T23:14:11,ACC00002921,Credit,825.54,-1264346.03,EUR,Starbucks
TXN0000016148,2024-01-22T16:43:00,ACC00009420,Debit,1675.3,-1266021.33,JPY,Shell
TXN0000016149,2024-05-03T16:34:14,ACC00003834,Debit,1675.25,-1267696.58,JPY,Walmart
TXN0000016150,2024-07-10T12:43:35,ACC00001139,ATM,1531.5,-1269228.08,USD,Restaurant
TXN0000016151,2024-11-02T21:00:07,ACC00006980,Transfer,375.07,-1268853.01,EUR,Shell
TXN0000016152,2024-10-07T04:19:58,ACC00000382,Transfer,1346.67,-1267506.34,GBP,Shell
TXN0000016153,2024-01-08T15:57:25,ACC00009965,Debit,881.98,-1268388.32,EUR,Grocery
TXN0000016154,2024-11-18T06:54:12,ACC00005379,Transfer,789.83,-1267598.49,USD,Amazon
TXN0000016155,2024-03-18T02:04:35,ACC00001684,Payment,1672.38,-1269270.87,JPY,Shell
TXN0000016156,2024-08-23T10:47:00,ACC00003237,Debit,1356.82,-1270627.69,JPY,Walmart
TXN0000016157,2024-01-23T02:11:06,ACC00002139,Payment,121.65,-1270749.34,USD,Target
TXN0000016158,2024-09-27T05:23:30,ACC00001903,Payment,1222.12,-1271971.46,USD,Restaurant
TXN0000016159,2024-12-28T12:56:19,ACC00000355,Debit,828.95,-1272800.41,GBP,Grocery
TXN0000016160,2024-08-15T04:19:26,ACC00000694,ATM,712.35,-1273512.76,GBP,Amazon
TXN0000016161,2024-10-05T22:23:30,ACC00002816,Transfer,1958.12,-1271554.64,USD,Online Store
TXN0000016162,2024-04-04T11:46:18,ACC00008970,Debit,1656.34,-1273210.98,JPY,Starbucks
TXN0000016163,2024-06-19T12:57:58,ACC00003972,Debit,1373.72,-1274584.7,JPY,Restaurant
TXN0000016164,2024-04-22T06:17:11,ACC00006692,Credit,496.52,-1274088.18,EUR,Amazon
TXN0000016165,2024-05-16T04:51:38,ACC00002875,Transfer,269.37,-1273818.81,USD,Amazon
TXN0000016166,2024-09-03T07:48:23,ACC00007918,Debit,1725.5,-1275544.31,USD,Shell
TXN0000016167,2024-05-16T19:20:29,ACC00001750,Payment,264.97,-1275809.28,JPY,Target
TXN0000016168,2024-09-29T00:28:58,ACC00004320,Credit,1552.54,-1274256.74,EUR,Grocery
TXN0000016169,2024-03-10T23:33:46,ACC00000445,Credit,128.05,-1274128.69,JPY,Amazon
TXN0000016170,2024-09-14T12:04:53,ACC00003040,Transfer,1235.98,-1272892.71,USD,Grocery
TXN0000016171,2024-09-26T01:35:40,ACC00004430,Debit,1852.24,-1274744.95,JPY,Target
TXN0000016172,2024-01-29T12:48:22,ACC00005979,ATM,1412.18,-1276157.13,JPY,Online Store
TXN0000016173,2024-09-25T02:07:21,ACC00009830,Transfer,1957.08,-1274200.05,GBP,Shell
TXN0000016174,2024-10-10T08:20:58,ACC00000645,Payment,1534.43,-1275734.48,EUR,Amazon
TXN0000016175,2024-08-26T14:04:04,ACC00000589,Transfer,87.17,-1275647.31,USD,Grocery
TXN0000016176,2024-08-02T07:27:06,ACC00008756,Payment,253.05,-1275900.36,USD,Amazon
TXN0000016177,2024-01-25T02:35:28,ACC00000354,Debit,859.01,-1276759.37,GBP,Shell
TXN0000016178,2024-11-08T00:10:09,ACC00009350,ATM,1230.01,-1277989.38,USD,Starbucks
TXN0000016179,2024-10-15T03:26:18,ACC00004165,Transfer,193.75,-1277795.63,JPY,Online Store
TXN0000016180,2024-12-22T22:55:12,ACC00004460,Credit,944.53,-1276851.1,GBP,Shell
TXN0000016181,2024-05-27T02:12:01,ACC00000251,Debit,1890.22,-1278741.32,JPY,Grocery
TXN0000016182,2024-08-08T01:08:37,ACC00001338,Transfer,1762.91,-1276978.41,GBP,Starbucks
TXN0000016183,2024-09-23T04:03:57,ACC00008467,Payment,1592.81,-1278571.22,EUR,Shell
TXN0000016184,2024-01-01T12:10:48,ACC00008385,ATM,666.7,-1279237.92,USD,Amazon
TXN0000016185,2024-11-04T11:42:14,ACC00005102,Debit,1571.38,-1280809.3,USD,Shell
TXN0000016186,2024-02-19T22:54:13,ACC00006613,Debit,1973.29,-1282782.59,EUR,Amazon
TXN0000016187,2024-08-19T06:23:36,ACC00008078,Transfer,855.39,-1281927.2,JPY,Grocery
TXN0000016188,2024-03-18T21:11:08,ACC00002153,Transfer,1012.11,-1280915.09,GBP,Target
TXN0000016189,2024-01-20T12:38:33,ACC00009017,Debit,1581.72,-1282496.81,USD,Restaurant
TXN0000016190,2024-10-03T03:32:12,ACC00001205,ATM,1859.44,-1284356.25,EUR,Target
TXN0000016191,2024-04-23T05:38:39,ACC00006049,Credit,298.81,-1284057.44,USD,Amazon
TXN0000016192,2024-09-16T12:27:43,ACC00003744,Payment,1940.08,-1285997.52,EUR,Starbucks
TXN0000016193,2024-11-27T05:25:27,ACC00002774,Credit,254.74,-1285742.78,JPY,Restaurant
TXN0000016194,2024-07-22T14:28:07,ACC00008166,Payment,320.38,-1286063.16,EUR,Amazon
TXN0000016195,2024-04-24T22:13:42,ACC00004488,Transfer,1703.76,-1284359.4,GBP,Restaurant
TXN0000016196,2024-12-23T19:11:44,ACC00002462,Payment,1633.31,-1285992.71,EUR,Shell
TXN0000016197,2024-05-30T12:32:11,ACC00002006,Credit,1996.01,-1283996.7,USD,Starbucks
TXN0000016198,2024-08-04T21:36:52,ACC00008958,Transfer,716.08,-1283280.62,GBP,Online Store
TXN0000016199,2024-12-11T11:42:09,ACC00003341,Credit,40.74,-1283239.88,JPY,Shell
TXN0000016200,2024-09-13T04:04:28,ACC00007935,Transfer,1490.28,-1281749.6,GBP,Restaurant
TXN0000016201,2024-08-14T16:05:29,ACC00000334,Transfer,1551.28,-1280198.32,JPY,Restaurant
TXN0000016202,2024-11-08T14:59:02,ACC00007125,Transfer,641.41,-1279556.91,JPY,Online Store
TXN0000016203,2024-01-10T23:21:51,ACC00002674,Credit,528.83,-1279028.08,GBP,Shell
TXN0000016204,2024-06-17T22:53:50,ACC00001921,ATM,1771.82,-1280799.9,GBP,Starbucks
TXN0000016205,2024-06-19T15:03:12,ACC00007165,Debit,1369.67,-1282169.57,EUR,Grocery
TXN0000016206,2024-05-19T11:11:00,ACC00006925,Debit,280.11,-1282449.68,JPY,Shell
TXN0000016207,2024-04-13T23:16:28,ACC00004204,Payment,1258.95,-1283708.63,JPY,Online Store
TXN0000016208,2024-10-11T05:49:26,ACC00004849,ATM,52.02,-1283760.65,GBP,Grocery
TXN0000016209,2024-12-04T14:57:31,ACC00003133,Debit,58.41,-1283819.06,JPY,Target
TXN0000016210,2024-06-21T13:34:08,ACC00001769,Transfer,1260.24,-1282558.82,JPY,Amazon
TXN0000016211,2024-06-11T23:42:36,ACC00009366,Credit,487.26,-1282071.56,USD,Target
TXN0000016212,2024-06-01T19:44:58,ACC00007537,Payment,1203.88,-1283275.44,JPY,Restaurant
TXN0000016213,2024-08-09T12:06:34,ACC00004937,Credit,344.02,-1282931.42,EUR,Target
TXN0000016214,2024-07-15T03:33:30,ACC00000573,Transfer,644.06,-1282287.36,JPY,Online Store
TXN0000016215,2024-04-24T15:05:39,ACC00008608,Debit,687.48,-1282974.84,JPY,Starbucks
TXN0000016216,2024-02-27T10:19:14,ACC00004161,Transfer,636.94,-1282337.9,EUR,Amazon
TXN0000016217,2024-08-26T06:14:10,ACC00001871,ATM,1624.46,-1283962.36,JPY,Amazon
TXN0000016218,2024-09-12T07:26:09,ACC00001683,Payment,1369.46,-1285331.82,USD,Shell
TXN0000016219,2024-03-06T03:41:15,ACC00002431,Debit,1221.73,-1286553.55,EUR,Starbucks
TXN0000016220,2024-06-22T05:25:34,ACC00006570,Transfer,1815.84,-1284737.71,JPY,Starbucks
TXN0000016221,2024-10-21T23:51:46,ACC00002403,Payment,591.01,-1285328.72,JPY,Grocery
TXN0000016222,2024-05-14T00:39:33,ACC00002145,Payment,1324.09,-1286652.81,JPY,Restaurant
TXN0000016223,2024-07-19T08:05:05,ACC00009720,Transfer,568.64,-1286084.17,GBP,Grocery
TXN0000016224,2024-03-27T10:01:38,ACC00007515,Debit,842.3,-1286926.47,JPY,Shell
TXN0000016225,2024-07-22T12:19:48,ACC00002117,Payment,616.77,-1287543.24,USD,Shell
TXN0000016226,2024-01-30T18:57:50,ACC00001449,Credit,1225.24,-1286318.0,EUR,Shell
TXN0000016227,2024-05-25T04:25:24,ACC00000631,Payment,701.49,-1287019.49,USD,Online Store
TXN0000016228,2024-03-25T12:50:43,ACC00005695,Payment,282.39,-1287301.88,USD,Target
TXN0000016229,2024-11-09T11:02:52,ACC00002477,Transfer,1486.1,-1285815.78,JPY,Amazon
TXN0000016230,2024-12-03T23:28:06,ACC00006857,Transfer,659.83,-1285155.95,USD,Restaurant
TXN0000016231,2024-10-24T03:00:50,ACC00007552,Credit,417.89,-1284738.06,USD,Starbucks
TXN0000016232,2024-03-10T11:25:34,ACC00007619,Credit,1864.82,-1282873.24,GBP,Online Store
TXN0000016233,2024-06-11T10:12:21,ACC00001458,Debit,1394.36,-1284267.6,EUR,Walmart
TXN0000016234,2024-12-15T12:21:31,ACC00000615,ATM,1759.77,-1286027.37,USD,Amazon
TXN0000016235,2024-10-28T05:49:39,ACC00002412,Transfer,669.08,-1285358.29,JPY,Walmart
TXN0000016236,2024-04-09T00:46:40,ACC00007620,Transfer,791.14,-1284567.15,USD,Shell
TXN0000016237,2024-04-22T14:57:20,ACC00007887,ATM,514.23,-1285081.38,EUR,Amazon
TXN0000016238,2024-02-15T01:38:01,ACC00009076,Transfer,812.05,-1284269.33,USD,Target
TXN0000016239,2024-04-05T02:08:01,ACC00005602,ATM,628.48,-1284897.81,USD,Amazon
TXN0000016240,2024-01-21T20:24:53,ACC00008776,Credit,1321.99,-1283575.82,JPY,Grocery
TXN0000016241,2024-02-11T17:15:56,ACC00000851,Debit,200.63,-1283776.45,GBP,Walmart
TXN0000016242,2024-07-01T11:43:50,ACC00007218,ATM,729.43,-1284505.88,JPY,Grocery
TXN0000016243,2024-11-12T05:13:23,ACC00009811,Credit,947.73,-1283558.15,GBP,Restaurant
TXN0000016244,2024-11-25T06:55:54,ACC00008682,Credit,1785.7,-1281772.45,EUR,Shell
TXN0000016245,2024-02-04T03:19:01,ACC00009953,Debit,1661.84,-1283434.29,USD,Shell
TXN0000016246,2024-08-06T09:40:48,ACC00004953,Payment,741.62,-1284175.91,JPY,Grocery
TXN0000016247,2024-01-02T02:13:02,ACC00004474,ATM,534.43,-1284710.34,GBP,Amazon
TXN0000016248,2024-07-10T15:02:30,ACC00008598,Debit,598.28,-1285308.62,GBP,Walmart
TXN0000016249,2024-09-24T17:37:24,ACC00005666,Credit,1855.09,-1283453.53,EUR,Walmart
TXN0000016250,2024-01-06T10:23:06,ACC00006660,ATM,828.44,-1284281.97,USD,Walmart
TXN0000016251,2024-07-08T19:42:59,ACC00009780,Credit,1672.03,-1282609.94,GBP,Amazon
TXN0000016252,2024-05-31T10:09:46,ACC00007118,Payment,623.78,-1283233.72,JPY,Restaurant
TXN0000016253,2024-09-08T04:02:47,ACC00002614,Payment,1870.78,-1285104.5,JPY,Starbucks
TXN0000016254,2024-08-25T05:24:52,ACC00004104,Payment,1156.61,-1286261.11,GBP,Starbucks
TXN0000016255,2024-02-11T04:53:09,ACC00000622,Credit,1877.91,-1284383.2,GBP,Grocery
TXN0000016256,2024-01-26T06:20:52,ACC00007507,ATM,1992.38,-1286375.58,JPY,Restaurant
TXN0000016257,2024-03-10T10:34:31,ACC00004989,ATM,1915.97,-1288291.55,EUR,Shell
TXN0000016258,2024-05-16T23:31:27,ACC00005898,Payment,744.98,-1289036.53,JPY,Amazon
TXN0000016259,2024-10-07T21:23:28,ACC00001123,Payment,1414.07,-1290450.6,EUR,Grocery
TXN0000016260,2024-01-24T04:16:17,ACC00003733,Debit,761.16,-1291211.76,EUR,Grocery
TXN0000016261,2024-11-08T05:16:09,ACC00005606,ATM,1342.36,-1292554.12,JPY,Amazon
TXN0000016262,2024-08-30T02:40:35,ACC00007312,Transfer,145.58,-1292408.54,EUR,Online Store
TXN0000016263,2024-03-28T04:57:17,ACC00006877,ATM,1546.52,-1293955.06,GBP,Walmart
TXN0000016264,2024-08-05T01:17:39,ACC00002219,Debit,698.49,-1294653.55,GBP,Amazon
TXN0000016265,2024-09-18T06:52:57,ACC00008391,ATM,779.31,-1295432.86,JPY,Restaurant
TXN0000016266,2024-11-01T07:04:44,ACC00003464,Debit,118.81,-1295551.67,USD,Starbucks
TXN0000016267,2024-06-07T20:02:41,ACC00008453,Transfer,1630.97,-1293920.7,JPY,Amazon
TXN0000016268,2024-08-04T20:13:12,ACC00009194,Transfer,1256.32,-1292664.38,JPY,Starbucks
TXN0000016269,2024-07-24T04:34:41,ACC00005965,Credit,1718.11,-1290946.27,EUR,Grocery
TXN0000016270,2024-05-17T07:02:42,ACC00000580,Transfer,639.38,-1290306.89,GBP,Target
TXN0000016271,2024-02-22T01:58:38,ACC00007021,Credit,594.72,-1289712.17,USD,Amazon
TXN0000016272,2024-12-11T08:33:30,ACC00000051,Credit,1765.27,-1287946.9,USD,Restaurant
TXN0000016273,2024-09-02T08:56:26,ACC00004919,Transfer,789.17,-1287157.73,USD,Online Store
TXN0000016274,2024-12-03T07:10:24,ACC00001105,Transfer,513.18,-1286644.55,USD,Target
TXN0000016275,2024-01-19T03:39:19,ACC00006093,Credit,1064.19,-1285580.36,JPY,Target
TXN0000016276,2024-09-01T01:19:58,ACC00005161,Debit,1712.76,-1287293.12,EUR,Walmart
TXN0000016277,2024-03-06T22:15:55,ACC00000677,Debit,752.98,-1288046.1,USD,Target
TXN0000016278,2024-12-22T20:17:03,ACC00007301,Debit,175.89,-1288221.99,JPY,Target
TXN0000016279,2024-05-16T00:01:20,ACC00004541,Transfer,335.36,-1287886.63,EUR,Starbucks
TXN0000016280,2024-01-07T20:48:16,ACC00002725,ATM,1582.16,-1289468.79,JPY,Walmart
TXN0000016281,2024-05-28T22:55:33,ACC00007715,Transfer,1838.91,-1287629.88,EUR,Walmart
TXN0000016282,2024-12-14T06:53:39,ACC00003604,Payment,825.79,-1288455.67,GBP,Shell
TXN0000016283,2024-08-12T04:41:32,ACC00002227,ATM,1230.49,-1289686.16,GBP,Online Store
TXN0000016284,2024-01-24T12:25:24,ACC00000703,Debit,384.22,-1290070.38,USD,Online Store
TXN0000016285,2024-05-31T07:14:30,ACC00004028,ATM,769.47,-1290839.85,EUR,Walmart
TXN0000016286,2024-07-14T18:32:05,ACC00003616,ATM,1243.48,-1292083.33,USD,Restaurant
TXN0000016287,2024-07-11T14:34:36,ACC00002189,Credit,1304.82,-1290778.51,GBP,Walmart
TXN0000016288,2024-01-29T13:30:20,ACC00000918,Transfer,95.08,-1290683.43,USD,Grocery
TXN0000016289,2024-05-14T11:34:15,ACC00000366,Debit,212.6,-1290896.03,EUR,Grocery
TXN0000016290,2024-02-17T17:26:54,ACC00006836,ATM,1414.13,-1292310.16,EUR,Online Store
TXN0000016291,2024-12-09T09:32:08,ACC00005918,ATM,1026.39,-1293336.55,USD,Amazon
TXN0000016292,2024-03-26T05:37:22,ACC00009052,Credit,1375.18,-1291961.37,USD,Grocery
TXN0000016293,2024-08-27T07:06:08,ACC00007047,Credit,46.97,-1291914.4,EUR,Starbucks
TXN0000016294,2024-04-29T17:25:00,ACC00001861,ATM,1791.12,-1293705.52,JPY,Online Store
TXN0000016295,2024-07-06T21:57:47,ACC00001722,Credit,293.73,-1293411.79,EUR,Amazon
TXN0000016296,2024-09-22T16:20:40,ACC00008252,Debit,1277.46,-1294689.25,JPY,Online Store
TXN0000016297,2024-03-17T08:16:50,ACC00004023,Credit,1788.82,-1292900.43,USD,Restaurant
TXN0000016298,2024-02-27T07:58:51,ACC00003335,Transfer,12.27,-1292888.16,JPY,Grocery
TXN0000016299,2024-12-07T05:31:31,ACC00006986,Debit,314.18,-1293202.34,EUR,Restaurant
TXN0000016300,2024-10-23T10:30:55,ACC00002909,Credit,1810.1,-1291392.24,GBP,Shell
TXN0000016301,2024-07-08T06:26:52,ACC00006363,Payment,981.24,-1292373.48,JPY,Restaurant
TXN0000016302,2024-11-21T04:15:35,ACC00007183,Credit,1236.58,-1291136.9,EUR,Target
TXN0000016303,2024-05-28T14:23:42,ACC00006034,ATM,1878.33,-1293015.23,USD,Restaurant
TXN0000016304,2024-11-04T15:03:17,ACC00002548,ATM,523.35,-1293538.58,GBP,Walmart
TXN0000016305,2024-09-25T07:51:31,ACC00001659,Payment,318.12,-1293856.7,JPY,Walmart
TXN0000016306,2024-06-14T15:42:26,ACC00005210,Debit,1236.21,-1295092.91,JPY,Grocery
TXN0000016307,2024-11-13T12:12:56,ACC00000256,Credit,572.54,-1294520.37,EUR,Restaurant
TXN0000016308,2024-04-26T11:15:09,ACC00004186,Transfer,1692.42,-1292827.95,GBP,Online Store
TXN0000016309,2024-07-16T06:09:57,ACC00007612,Credit,1783.94,-1291044.01,GBP,Restaurant
TXN0000016310,2024-08-24T16:02:15,ACC00004224,Credit,407.72,-1290636.29,EUR,Shell
TXN0000016311,2024-07-25T05:38:41,ACC00003380,Transfer,1413.49,-1289222.8,EUR,Restaurant
TXN0000016312,2024-11-14T19:34:55,ACC00006973,Transfer,1418.81,-1287803.99,JPY,Restaurant
TXN0000016313,2024-08-16T13:12:50,ACC00000640,Debit,1462.64,-1289266.63,GBP,Grocery
TXN0000016314,2024-07-06T05:13:56,ACC00006899,Payment,816.82,-1290083.45,JPY,Online Store
TXN0000016315,2024-09-10T11:36:29,ACC00009290,Payment,34.39,-1290117.84,JPY,Amazon
TXN0000016316,2024-02-25T22:05:32,ACC00005030,Payment,730.6,-1290848.44,EUR,Starbucks
TXN0000016317,2024-12-24T12:31:46,ACC00008052,Debit,1423.88,-1292272.32,EUR,Restaurant
TXN0000016318,2024-09-07T00:15:47,ACC00008375,Debit,1141.52,-1293413.84,JPY,Restaurant
TXN0000016319,2024-08-26T00:40:38,ACC00000752,Transfer,1836.01,-1291577.83,JPY,Starbucks
TXN0000016320,2024-01-13T10:07:47,ACC00006833,Transfer,499.04,-1291078.79,GBP,Walmart
TXN0000016321,2024-10-11T21:08:05,ACC00009135,Payment,597.71,-1291676.5,GBP,Amazon
TXN0000016322,2024-11-27T10:36:28,ACC00001014,Payment,281.85,-1291958.35,EUR,Starbucks
TXN0000016323,2024-12-12T22:05:22,ACC00000100,Debit,615.26,-1292573.61,JPY,Amazon
TXN0000016324,2024-01-22T07:48:23,ACC00005560,Transfer,1888.18,-1290685.43,USD,Online Store
TXN0000016325,2024-01-19T11:38:58,ACC00004195,ATM,241.61,-1290927.04,GBP,Starbucks
TXN0000016326,2024-09-03T07:01:33,ACC00004675,Transfer,1718.42,-1289208.62,JPY,Walmart
TXN0000016327,2024-05-29T06:58:03,ACC00001615,Credit,1680.04,-1287528.58,JPY,Amazon
TXN0000016328,2024-07-05T12:34:23,ACC00007193,ATM,1887.78,-1289416.36,GBP,Target
TXN0000016329,2024-09-09T07:17:47,ACC00009971,Transfer,1845.11,-1287571.25,USD,Walmart
TXN0000016330,2024-09-22T11:28:57,ACC00006307,Debit,1548.32,-1289119.57,GBP,Target
TXN0000016331,2024-08-14T10:51:31,ACC00000870,Payment,1676.73,-1290796.3,GBP,Starbucks
TXN0000016332,2024-12-09T21:18:57,ACC00003280,Debit,390.53,-1291186.83,EUR,Restaurant
TXN0000016333,2024-06-03T12:06:42,ACC00002651,Transfer,10.98,-1291175.85,JPY,Restaurant
TXN0000016334,2024-09-08T12:30:14,ACC00000520,Transfer,750.21,-1290425.64,GBP,Walmart
TXN0000016335,2024-08-30T16:22:59,ACC00000594,Transfer,842.43,-1289583.21,EUR,Restaurant
TXN0000016336,2024-03-11T12:38:19,ACC00008907,Payment,1862.36,-1291445.57,USD,Target
TXN0000016337,2024-12-10T09:34:29,ACC00008190,Payment,1102.8,-1292548.37,EUR,Amazon
TXN0000016338,2024-09-23T04:11:39,ACC00001979,Payment,327.7,-1292876.07,USD,Shell
TXN0000016339,2024-06-12T03:33:30,ACC00005195,Credit,380.48,-1292495.59,GBP,Shell
TXN0000016340,2024-03-02T11:26:22,ACC00006297,ATM,1754.36,-1294249.95,JPY,Amazon
TXN0000016341,2024-07-19T02:33:11,ACC00005955,Payment,1389.59,-1295639.54,JPY,Target
TXN0000016342,2024-03-16T00:15:12,ACC00001592,ATM,1981.76,-1297621.3,EUR,Target
TXN0000016343,2024-10-25T15:14:22,ACC00003166,Transfer,372.5,-1297248.8,USD,Grocery
TXN0000016344,2024-11-03T08:16:27,ACC00004663,Payment,550.1,-1297798.9,EUR,Starbucks
TXN0000016345,2024-09-20T19:27:12,ACC00009010,Payment,237.03,-1298035.93,USD,Grocery
TXN0000016346,2024-11-05T02:54:52,ACC00002212,ATM,1263.22,-1299299.15,GBP,Restaurant
TXN0000016347,2024-03-07T18:01:24,ACC00000896,Debit,594.26,-1299893.41,EUR,Walmart
TXN0000016348,2024-06-01T20:16:57,ACC00004884,Credit,1748.37,-1298145.04,JPY,Starbucks
TXN0000016349,2024-03-03T00:58:49,ACC00009538,Payment,1384.59,-1299529.63,EUR,Restaurant
TXN0000016350,2024-02-01T11:31:16,ACC00008555,Credit,424.75,-1299104.88,GBP,Walmart
TXN0000016351,2024-12-03T03:18:04,ACC00004726,Payment,1654.05,-1300758.93,JPY,Amazon
TXN0000016352,2024-08-19T21:09:38,ACC00001458,ATM,640.79,-1301399.72,USD,Target
TXN0000016353,2024-05-09T12:33:20,ACC00006553,Debit,434.88,-1301834.6,GBP,Shell
TXN0000016354,2024-02-08T15:55:18,ACC00003755,Transfer,620.71,-1301213.89,EUR,Starbucks
TXN0000016355,2024-09-02T01:47:12,ACC00005121,ATM,1341.53,-1302555.42,JPY,Target
TXN0000016356,2024-07-15T11:38:57,ACC00007952,Transfer,496.51,-1302058.91,GBP,Online Store
TXN0000016357,2024-11-07T01:11:42,ACC00005168,Payment,130.61,-1302189.52,GBP,Restaurant
TXN0000016358,2024-10-27T00:25:48,ACC00009687,Credit,681.35,-1301508.17,JPY,Starbucks
TXN0000016359,2024-01-16T23:57:46,ACC00008117,Credit,1945.09,-1299563.08,GBP,Amazon
TXN0000016360,2024-04-17T20:06:24,ACC00004767,Debit,1753.13,-1301316.21,JPY,Shell
TXN0000016361,2024-12-02T01:39:29,ACC00008358,ATM,666.97,-1301983.18,GBP,Shell
TXN0000016362,2024-03-02T06:40:48,ACC00007607,Credit,1686.12,-1300297.06,JPY,Amazon
TXN0000016363,2024-10-13T10:08:22,ACC00008876,Transfer,1444.31,-1298852.75,GBP,Starbucks
TXN0000016364,2024-08-24T05:54:53,ACC00000430,Debit,1370.28,-1300223.03,GBP,Grocery
TXN0000016365,2024-01-24T00:32:01,ACC00003406,Debit,840.73,-1301063.76,USD,Walmart
TXN0000016366,2024-02-08T13:27:59,ACC00005429,ATM,528.66,-1301592.42,USD,Starbucks
TXN0000016367,2024-01-01T04:17:13,ACC00000064,Debit,795.34,-1302387.76,EUR,Grocery
TXN0000016368,2024-04-07T12:32:43,ACC00002034,Payment,523.74,-1302911.5,JPY,Shell
TXN0000016369,2024-06-27T23:45:38,ACC00005473,Payment,1082.74,-1303994.24,JPY,Amazon
TXN0000016370,2024-04-16T18:07:16,ACC00001409,Transfer,53.7,-1303940.54,GBP,Online Store
TXN0000016371,2024-07-07T09:20:57,ACC00006538,Transfer,1435.18,-1302505.36,GBP,Restaurant
TXN0000016372,2024-05-13T11:04:13,ACC00003750,Credit,1807.88,-1300697.48,JPY,Shell
TXN0000016373,2024-02-24T22:51:37,ACC00003574,ATM,1629.6,-1302327.08,USD,Shell
TXN0000016374,2024-08-06T01:58:34,ACC00009439,Debit,553.62,-1302880.7,GBP,Online Store
TXN0000016375,2024-07-04T22:17:05,ACC00002127,Transfer,1331.32,-1301549.38,GBP,Online Store
TXN0000016376,2024-01-28T20:09:35,ACC00002097,Payment,1386.37,-1302935.75,USD,Grocery
TXN0000016377,2024-01-04T16:27:36,ACC00007217,ATM,108.95,-1303044.7,USD,Target
TXN0000016378,2024-04-19T04:00:14,ACC00004715,Credit,625.1,-1302419.6,EUR,Shell
TXN0000016379,2024-08-17T12:50:39,ACC00004677,Credit,1703.24,-1300716.36,EUR,Walmart
TXN0000016380,2024-03-18T18:01:46,ACC00005198,Credit,1030.38,-1299685.98,JPY,Shell
TXN0000016381,2024-10-19T23:54:36,ACC00002742,Debit,1544.65,-1301230.63,GBP,Shell
TXN0000016382,2024-09-10T15:51:35,ACC00007354,Transfer,1811.07,-1299419.56,JPY,Target
TXN0000016383,2024-08-08T19:07:48,ACC00004047,Credit,919.46,-1298500.1,JPY,Target
TXN0000016384,2024-10-18T22:10:33,ACC00001468,Debit,399.37,-1298899.47,GBP,Target
TXN0000016385,2024-06-12T02:13:40,ACC00005108,Credit,1600.52,-1297298.95,JPY,Restaurant
TXN0000016386,2024-10-20T13:51:03,ACC00007101,ATM,759.36,-1298058.31,EUR,Shell
TXN0000016387,2024-03-17T15:49:37,ACC00005920,Payment,1573.71,-1299632.02,JPY,Target
TXN0000016388,2024-11-04T04:12:45,ACC00008924,Credit,464.34,-1299167.68,JPY,Starbucks
TXN0000016389,2024-03-31T11:19:05,ACC00002842,Debit,1180.04,-1300347.72,JPY,Restaurant
TXN0000016390,2024-01-04T09:14:38,ACC00009508,Credit,692.0,-1299655.72,EUR,Online Store
TXN0000016391,2024-05-12T09:17:30,ACC00003312,ATM,129.81,-1299785.53,EUR,Walmart
TXN0000016392,2024-06-04T01:38:33,ACC00009044,Transfer,838.17,-1298947.36,EUR,Target
TXN0000016393,2024-09-28T17:50:18,ACC00008832,Transfer,1830.99,-1297116.37,USD,Restaurant
TXN0000016394,2024-11-11T15:10:23,ACC00007025,Debit,431.94,-1297548.31,JPY,Restaurant
TXN0000016395,2024-10-07T21:23:12,ACC00001966,Credit,1123.84,-1296424.47,GBP,Shell
TXN0000016396,2024-05-23T18:32:54,ACC00004119,Payment,429.63,-1296854.1,GBP,Walmart
TXN0000016397,2024-11-21T05:33:52,ACC00000709,Debit,318.26,-1297172.36,JPY,Grocery
TXN0000016398,2024-07-13T10:11:37,ACC00002457,Debit,718.68,-1297891.04,JPY,Walmart
TXN0000016399,2024-03-02T05:46:57,ACC00002619,Payment,543.04,-1298434.08,EUR,Target
TXN0000016400,2024-05-26T04:45:59,ACC00008662,Payment,257.11,-1298691.19,JPY,Grocery
TXN0000016401,2024-06-25T23:25:10,ACC00006472,Debit,108.32,-1298799.51,EUR,Amazon
TXN0000016402,2024-09-09T11:07:45,ACC00006354,ATM,1554.61,-1300354.12,GBP,Target
TXN0000016403,2024-09-05T08:08:51,ACC00006344,Payment,1217.7,-1301571.82,JPY,Online Store
TXN0000016404,2024-02-15T13:32:25,ACC00008119,Payment,861.97,-1302433.79,JPY,Restaurant
TXN0000016405,2024-05-11T16:12:23,ACC00001229,Transfer,1269.21,-1301164.58,USD,Restaurant
TXN0000016406,2024-11-27T04:32:52,ACC00001688,Payment,948.28,-1302112.86,EUR,Online Store
TXN0000016407,2024-01-30T05:21:49,ACC00004706,ATM,1409.3,-1303522.16,EUR,Grocery
TXN0000016408,2024-05-24T00:31:08,ACC00002299,Transfer,1266.71,-1302255.45,JPY,Walmart
TXN0000016409,2024-11-01T07:43:13,ACC00005006,Credit,1365.82,-1300889.63,JPY,Starbucks
TXN0000016410,2024-12-16T20:43:09,ACC00001870,ATM,1494.8,-1302384.43,EUR,Amazon
TXN0000016411,2024-10-16T18:22:34,ACC00001512,Debit,588.73,-1302973.16,USD,Grocery
TXN0000016412,2024-04-27T20:38:05,ACC00000743,Debit,56.62,-1303029.78,JPY,Starbucks
TXN0000016413,2024-08-19T02:35:12,ACC00003071,ATM,813.81,-1303843.59,JPY,Amazon
TXN0000016414,2024-12-18T11:18:13,ACC00007450,Payment,1133.97,-1304977.56,GBP,Online Store
TXN0000016415,2024-01-05T02:05:20,ACC00008879,Payment,879.27,-1305856.83,EUR,Target
TXN0000016416,2024-10-17T11:16:21,ACC00000167,Credit,105.65,-1305751.18,GBP,Online Store
TXN0000016417,2024-01-15T23:01:08,ACC00003942,Transfer,54.17,-1305697.01,JPY,Shell
TXN0000016418,2024-07-19T20:02:55,ACC00003435,Debit,263.8,-1305960.81,EUR,Online Store
TXN0000016419,2024-12-08T20:09:53,ACC00008727,Payment,1159.88,-1307120.69,GBP,Target
TXN0000016420,2024-02-19T03:29:56,ACC00000471,Transfer,1208.51,-1305912.18,EUR,Grocery
TXN0000016421,2024-01-08T08:56:11,ACC00003700,Credit,1288.05,-1304624.13,GBP,Walmart
TXN0000016422,2024-07-13T04:54:27,ACC00001474,ATM,1052.22,-1305676.35,EUR,Restaurant
TXN0000016423,2024-07-17T04:30:41,ACC00000537,Transfer,379.09,-1305297.26,EUR,Grocery
TXN0000016424,2024-08-07T13:22:27,ACC00001614,ATM,1202.39,-1306499.65,JPY,Online Store
TXN0000016425,2024-05-01T19:15:06,ACC00002367,Debit,1419.83,-1307919.48,JPY,Shell
TXN0000016426,2024-11-12T14:05:44,ACC00001129,ATM,1425.59,-1309345.07,GBP,Shell
TXN0000016427,2024-06-14T03:10:52,ACC00003189,Payment,992.03,-1310337.1,GBP,Amazon
TXN0000016428,2024-03-11T07:51:32,ACC00008316,Debit,205.9,-1310543.0,JPY,Online Store
TXN0000016429,2024-05-17T08:01:45,ACC00007019,Credit,1904.15,-1308638.85,JPY,Amazon
TXN0000016430,2024-03-09T06:28:29,ACC00003204,Credit,1372.24,-1307266.61,USD,Target
TXN0000016431,2024-12-29T16:12:08,ACC00008572,Payment,229.24,-1307495.85,EUR,Grocery
TXN0000016432,2024-03-23T16:53:05,ACC00003095,Payment,1585.5,-1309081.35,EUR,Online Store
TXN0000016433,2024-02-27T21:31:50,ACC00001295,Transfer,1979.78,-1307101.57,EUR,Grocery
TXN0000016434,2024-02-03T14:46:50,ACC00001827,Payment,1044.1,-1308145.67,EUR,Amazon
TXN0000016435,2024-03-18T02:36:02,ACC00005570,Debit,759.28,-1308904.95,GBP,Grocery
TXN0000016436,2024-12-29T22:01:26,ACC00005332,Credit,681.82,-1308223.13,EUR,Grocery
TXN0000016437,2024-02-29T01:06:10,ACC00009716,Credit,1907.95,-1306315.18,JPY,Amazon
TXN0000016438,2024-02-27T23:40:11,ACC00002152,Credit,111.49,-1306203.69,JPY,Grocery
TXN0000016439,2024-12-24T08:14:08,ACC00005581,Transfer,849.79,-1305353.9,GBP,Restaurant
TXN0000016440,2024-12-16T10:17:27,ACC00002111,Credit,11.12,-1305342.78,GBP,Shell
TXN0000016441,2024-01-16T21:07:21,ACC00001888,Transfer,1985.92,-1303356.86,EUR,Restaurant
TXN0000016442,2024-10-16T15:44:48,ACC00004890,ATM,1071.01,-1304427.87,GBP,Starbucks
TXN0000016443,2024-08-23T01:28:54,ACC00005640,Credit,27.81,-1304400.06,JPY,Online Store
TXN0000016444,2024-02-24T18:48:56,ACC00005195,Transfer,702.04,-1303698.02,GBP,Restaurant
TXN0000016445,2024-10-31T16:04:24,ACC00009213,Payment,1257.03,-1304955.05,EUR,Starbucks
TXN0000016446,2024-03-19T04:31:05,ACC00000776,Debit,1529.78,-1306484.83,GBP,Online Store
TXN0000016447,2024-03-11T17:20:03,ACC00007245,Debit,1683.13,-1308167.96,USD,Starbucks
TXN0000016448,2024-05-18T11:56:30,ACC00009050,Payment,1478.49,-1309646.45,USD,Walmart
TXN0000016449,2024-08-24T01:58:17,ACC00009945,Credit,178.4,-1309468.05,EUR,Starbucks
TXN0000016450,2024-08-07T02:18:58,ACC00003628,Credit,1092.11,-1308375.94,JPY,Target
TXN0000016451,2024-04-30T01:17:39,ACC00007315,ATM,475.9,-1308851.84,USD,Restaurant
TXN0000016452,2024-12-29T11:32:47,ACC00002124,Credit,1681.7,-1307170.14,USD,Walmart
TXN0000016453,2024-05-23T15:32:36,ACC00009773,Payment,64.87,-1307235.01,USD,Restaurant
TXN0000016454,2024-08-14T03:43:34,ACC00004430,Debit,1993.6,-1309228.61,USD,Grocery
TXN0000016455,2024-07-10T15:23:38,ACC00004241,Credit,824.89,-1308403.72,EUR,Walmart
TXN0000016456,2024-12-03T12:13:16,ACC00008269,ATM,833.11,-1309236.83,EUR,Starbucks
TXN0000016457,2024-05-03T00:41:36,ACC00001042,Payment,1677.77,-1310914.6,GBP,Restaurant
TXN0000016458,2024-02-21T22:17:16,ACC00008460,Credit,803.28,-1310111.32,USD,Online Store
TXN0000016459,2024-08-13T08:04:39,ACC00003228,Debit,735.95,-1310847.27,GBP,Walmart
TXN0000016460,2024-08-19T23:34:36,ACC00000623,ATM,1172.54,-1312019.81,USD,Online Store
TXN0000016461,2024-09-03T05:21:21,ACC00003128,ATM,1629.16,-1313648.97,JPY,Starbucks
TXN0000016462,2024-07-30T10:19:11,ACC00008220,Transfer,1192.39,-1312456.58,GBP,Target
TXN0000016463,2024-05-22T11:25:35,ACC00003505,ATM,1521.94,-1313978.52,USD,Restaurant
TXN0000016464,2024-12-01T14:35:02,ACC00009906,Credit,1317.15,-1312661.37,USD,Grocery
TXN0000016465,2024-11-25T12:16:55,ACC00000806,Credit,1391.67,-1311269.7,JPY,Starbucks
TXN0000016466,2024-06-27T19:21:09,ACC00000482,Transfer,1499.23,-1309770.47,JPY,Shell
TXN0000016467,2024-03-10T01:57:02,ACC00002938,Debit,227.59,-1309998.06,JPY,Starbucks
TXN0000016468,2024-06-22T02:42:45,ACC00003294,Credit,1502.23,-1308495.83,JPY,Walmart
TXN0000016469,2024-12-13T21:02:59,ACC00003623,ATM,733.04,-1309228.87,JPY,Restaurant
TXN0000016470,2024-12-16T08:31:53,ACC00006529,Credit,1893.42,-1307335.45,USD,Target
TXN0000016471,2024-03-29T01:00:17,ACC00001532,Debit,1458.41,-1308793.86,GBP,Walmart
TXN0000016472,2024-01-20T02:57:48,ACC00008370,Transfer,734.01,-1308059.85,EUR,Walmart
TXN0000016473,2024-03-07T06:28:54,ACC00003573,Credit,1551.72,-1306508.13,EUR,Walmart
TXN0000016474,2024-07-04T13:19:57,ACC00001683,Transfer,648.55,-1305859.58,EUR,Target
TXN0000016475,2024-09-20T19:57:27,ACC00005010,Credit,1475.13,-1304384.45,JPY,Amazon
TXN0000016476,2024-12-13T21:55:05,ACC00008059,Debit,316.13,-1304700.58,JPY,Shell
TXN0000016477,2024-07-25T23:18:26,ACC00009388,Payment,44.82,-1304745.4,EUR,Target
TXN0000016478,2024-08-10T03:04:04,ACC00004476,ATM,508.17,-1305253.57,USD,Online Store
TXN0000016479,2024-05-23T18:17:38,ACC00003057,Credit,856.63,-1304396.94,USD,Online Store
TXN0000016480,2024-10-16T19:20:24,ACC00007434,Payment,610.69,-1305007.63,JPY,Online Store
TXN0000016481,2024-07-28T01:33:04,ACC00001291,ATM,915.56,-1305923.19,USD,Online Store
TXN0000016482,2024-06-10T06:31:41,ACC00004170,Payment,1700.12,-1307623.31,JPY,Walmart
TXN0000016483,2024-03-20T05:31:27,ACC00007041,Credit,177.4,-1307445.91,GBP,Starbucks
TXN0000016484,2024-02-05T13:52:59,ACC00001359,Debit,851.63,-1308297.54,GBP,Target
TXN0000016485,2024-12-07T05:21:55,ACC00008153,Debit,1045.81,-1309343.35,USD,Walmart
TXN0000016486,2024-08-14T10:04:08,ACC00007228,Payment,1385.96,-1310729.31,GBP,Amazon
TXN0000016487,2024-10-11T07:08:45,ACC00000934,Credit,1827.0,-1308902.31,GBP,Amazon
TXN0000016488,2024-05-16T02:04:50,ACC00004748,Credit,1993.7,-1306908.61,GBP,Shell
TXN0000016489,2024-07-15T08:45:19,ACC00008656,Debit,1427.67,-1308336.28,JPY,Walmart
TXN0000016490,2024-07-03T01:35:26,ACC00002344,Debit,1990.07,-1310326.35,JPY,Grocery
TXN0000016491,2024-05-19T11:41:06,ACC00004398,Transfer,84.56,-1310241.79,GBP,Walmart
TXN0000016492,2024-03-25T09:52:58,ACC00006725,Debit,303.56,-1310545.35,GBP,Walmart
TXN0000016493,2024-01-28T23:51:14,ACC00008679,Credit,1287.58,-1309257.77,GBP,Amazon
TXN0000016494,2024-07-11T02:28:13,ACC00006229,Payment,759.39,-1310017.16,USD,Walmart
TXN0000016495,2024-11-29T07:12:03,ACC00006695,Debit,1192.58,-1311209.74,JPY,Walmart
TXN0000016496,2024-06-14T07:08:55,ACC00005242,Transfer,1345.41,-1309864.33,GBP,Amazon
TXN0000016497,2024-04-18T17:38:38,ACC00005373,Payment,1007.62,-1310871.95,EUR,Online Store
TXN0000016498,2024-08-15T19:38:44,ACC00005006,Credit,1446.05,-1309425.9,EUR,Online Store
TXN0000016499,2024-05-13T05:49:48,ACC00005959,ATM,185.15,-1309611.05,USD,Walmart
TXN0000016500,2024-09-09T13:16:39,ACC00009521,Transfer,1716.86,-1307894.19,EUR,Restaurant
TXN0000016501,2024-12-25T05:47:38,ACC00006855,ATM,776.14,-1308670.33,EUR,Walmart
TXN0000016502,2024-07-28T02:39:06,ACC00000113,ATM,1664.36,-1310334.69,GBP,Amazon
TXN0000016503,2024-09-23T19:33:21,ACC00000149,Payment,785.75,-1311120.44,EUR,Starbucks
TXN0000016504,2024-03-17T15:31:28,ACC00006803,Debit,1015.27,-1312135.71,GBP,Online Store
TXN0000016505,2024-05-02T08:07:14,ACC00007347,Debit,1699.66,-1313835.37,USD,Walmart
TXN0000016506,2024-08-13T23:52:22,ACC00000515,Credit,1910.66,-1311924.71,USD,Shell
TXN0000016507,2024-08-08T18:06:40,ACC00003858,ATM,1649.04,-1313573.75,USD,Restaurant
TXN0000016508,2024-12-27T13:49:56,ACC00000022,Credit,1471.5,-1312102.25,GBP,Shell
TXN0000016509,2024-09-24T00:44:10,ACC00004604,Transfer,1412.71,-1310689.54,GBP,Grocery
TXN0000016510,2024-01-19T17:35:39,ACC00002997,Payment,1326.64,-1312016.18,USD,Starbucks
TXN0000016511,2024-07-04T22:51:18,ACC00001017,Payment,1672.73,-1313688.91,GBP,Online Store
TXN0000016512,2024-07-04T07:26:44,ACC00002072,ATM,1432.68,-1315121.59,JPY,Online Store
TXN0000016513,2024-04-26T17:06:40,ACC00005928,ATM,819.67,-1315941.26,JPY,Walmart
TXN0000016514,2024-11-29T20:59:15,ACC00000703,Payment,610.51,-1316551.77,GBP,Grocery
TXN0000016515,2024-10-20T16:18:29,ACC00006040,Payment,1462.93,-1318014.7,USD,Amazon
TXN0000016516,2024-01-11T17:36:42,ACC00004542,Debit,1915.87,-1319930.57,EUR,Shell
TXN0000016517,2024-05-04T14:55:15,ACC00000109,ATM,771.32,-1320701.89,USD,Online Store
TXN0000016518,2024-10-04T12:49:13,ACC00006721,Transfer,551.17,-1320150.72,JPY,Starbucks
TXN0000016519,2024-09-14T13:29:48,ACC00005258,Payment,802.01,-1320952.73,GBP,Restaurant
TXN0000016520,2024-05-20T06:59:30,ACC00005892,Credit,608.38,-1320344.35,JPY,Amazon
TXN0000016521,2024-06-06T10:08:02,ACC00005665,ATM,1618.84,-1321963.19,JPY,Restaurant
TXN0000016522,2024-02-28T15:40:51,ACC00005655,ATM,1806.3,-1323769.49,USD,Walmart
TXN0000016523,2024-04-25T02:59:19,ACC00009109,Debit,1996.26,-1325765.75,USD,Restaurant
TXN0000016524,2024-07-19T19:53:51,ACC00002713,Transfer,275.17,-1325490.58,JPY,Target
TXN0000016525,2024-01-27T04:32:51,ACC00009359,Credit,1785.09,-1323705.49,GBP,Restaurant
TXN0000016526,2024-08-21T05:03:22,ACC00007530,Debit,741.65,-1324447.14,EUR,Starbucks
TXN0000016527,2024-04-06T09:21:57,ACC00001561,ATM,561.75,-1325008.89,GBP,Shell
TXN0000016528,2024-04-29T07:23:01,ACC00003558,ATM,1336.75,-1326345.64,EUR,Walmart
TXN0000016529,2024-12-14T16:05:44,ACC00004406,ATM,96.88,-1326442.52,GBP,Online Store
TXN0000016530,2024-07-06T14:18:07,ACC00000020,Transfer,37.11,-1326405.41,GBP,Walmart
TXN0000016531,2024-11-29T17:14:27,ACC00001183,Transfer,1091.17,-1325314.24,JPY,Shell
TXN0000016532,2024-06-06T15:55:33,ACC00009301,ATM,802.87,-1326117.11,JPY,Grocery
TXN0000016533,2024-09-26T05:03:58,ACC00008999,ATM,1850.77,-1327967.88,JPY,Walmart
TXN0000016534,2024-02-11T20:39:47,ACC00003625,Credit,716.11,-1327251.77,USD,Online Store
TXN0000016535,2024-06-12T06:57:19,ACC00001514,ATM,449.53,-1327701.3,JPY,Walmart
TXN0000016536,2024-07-23T12:43:57,ACC00003316,Debit,1477.79,-1329179.09,JPY,Grocery
TXN0000016537,2024-09-04T04:15:14,ACC00006806,Transfer,394.82,-1328784.27,USD,Shell
TXN0000016538,2024-07-21T09:51:06,ACC00009674,Transfer,715.54,-1328068.73,GBP,Grocery
TXN0000016539,2024-04-01T20:59:23,ACC00005426,Payment,1408.0,-1329476.73,JPY,Restaurant
TXN0000016540,2024-02-13T19:24:03,ACC00004056,ATM,1126.48,-1330603.21,JPY,Restaurant
TXN0000016541,2024-05-14T21:28:34,ACC00002425,ATM,547.02,-1331150.23,JPY,Target
TXN0000016542,2024-08-08T07:51:15,ACC00005576,Payment,22.3,-1331172.53,JPY,Walmart
TXN0000016543,2024-11-06T14:46:29,ACC00001700,Credit,221.99,-1330950.54,USD,Starbucks
TXN0000016544,2024-10-15T21:01:01,ACC00002459,ATM,1602.38,-1332552.92,GBP,Starbucks
TXN0000016545,2024-12-23T10:02:59,ACC00009757,ATM,1497.27,-1334050.19,GBP,Starbucks
TXN0000016546,2024-08-22T12:52:24,ACC00005053,Payment,1732.56,-1335782.75,EUR,Online Store
TXN0000016547,2024-01-11T21:53:56,ACC00001756,Debit,1297.28,-1337080.03,USD,Amazon
TXN0000016548,2024-11-04T15:41:09,ACC00009552,Debit,482.69,-1337562.72,EUR,Online Store
TXN0000016549,2024-07-05T07:41:38,ACC00007695,Credit,1768.14,-1335794.58,GBP,Online Store
TXN0000016550,2024-07-07T09:58:30,ACC00009728,Payment,769.94,-1336564.52,USD,Restaurant
TXN0000016551,2024-12-25T10:22:12,ACC00007831,ATM,1382.33,-1337946.85,EUR,Shell
TXN0000016552,2024-02-19T21:16:30,ACC00002070,Credit,1453.62,-1336493.23,USD,Walmart
TXN0000016553,2024-11-01T01:15:36,ACC00004572,Debit,1581.96,-1338075.19,USD,Grocery
TXN0000016554,2024-10-26T04:50:34,ACC00005423,Debit,176.58,-1338251.77,GBP,Target
TXN0000016555,2024-04-02T04:21:06,ACC00004553,Debit,31.25,-1338283.02,GBP,Shell
TXN0000016556,2024-03-31T20:46:07,ACC00007280,ATM,44.05,-1338327.07,GBP,Online Store
TXN0000016557,2024-03-26T00:00:23,ACC00009786,Credit,1752.27,-1336574.8,EUR,Restaurant
TXN0000016558,2024-01-04T13:25:45,ACC00008340,Credit,1956.1,-1334618.7,EUR,Target
TXN0000016559,2024-11-20T15:29:24,ACC00006829,ATM,277.37,-1334896.07,USD,Shell
TXN0000016560,2024-08-06T13:03:18,ACC00002652,Transfer,868.39,-1334027.68,JPY,Target
TXN0000016561,2024-09-23T06:54:47,ACC00003197,Credit,1843.72,-1332183.96,EUR,Shell
TXN0000016562,2024-01-03T11:42:57,ACC00000491,Transfer,1842.29,-1330341.67,USD,Shell
TXN0000016563,2024-03-19T18:29:12,ACC00000554,ATM,1427.76,-1331769.43,USD,Shell
TXN0000016564,2024-04-14T15:09:31,ACC00008916,Debit,1060.19,-1332829.62,JPY,Online Store
TXN0000016565,2024-08-08T20:52:10,ACC00001952,Credit,1409.33,-1331420.29,USD,Online Store
TXN0000016566,2024-02-19T19:54:26,ACC00004502,Credit,1070.96,-1330349.33,JPY,Walmart
TXN0000016567,2024-12-22T05:53:21,ACC00007935,Debit,1340.24,-1331689.57,GBP,Walmart
TXN0000016568,2024-07-27T06:53:16,ACC00009667,Credit,742.16,-1330947.41,USD,Amazon
TXN0000016569,2024-10-26T23:30:28,ACC00006943,Payment,1742.64,-1332690.05,EUR,Online Store
TXN0000016570,2024-04-30T00:38:45,ACC00006673,ATM,420.43,-1333110.48,USD,Target
TXN0000016571,2024-01-01T01:27:47,ACC00003929,Credit,673.32,-1332437.16,USD,Walmart
TXN0000016572,2024-07-21T16:21:46,ACC00001893,Payment,1778.07,-1334215.23,USD,Walmart
TXN0000016573,2024-08-01T07:21:09,ACC00002931,Credit,1829.2,-1332386.03,GBP,Amazon
TXN0000016574,2024-11-25T04:15:17,ACC00001232,ATM,701.89,-1333087.92,USD,Amazon
TXN0000016575,2024-07-20T21:48:58,ACC00006716,ATM,1151.66,-1334239.58,EUR,Walmart
TXN0000016576,2024-04-28T17:29:55,ACC00001086,Transfer,1265.09,-1332974.49,GBP,Starbucks
TXN0000016577,2024-02-26T23:33:12,ACC00003706,Debit,1269.32,-1334243.81,EUR,Shell
TXN0000016578,2024-03-19T08:19:14,ACC00001246,ATM,850.24,-1335094.05,EUR,Starbucks
TXN0000016579,2024-04-02T00:06:34,ACC00000951,Payment,1641.57,-1336735.62,USD,Shell
TXN0000016580,2024-03-06T02:12:30,ACC00003739,Debit,1959.11,-1338694.73,USD,Target
TXN0000016581,2024-05-01T09:45:17,ACC00004470,ATM,1294.77,-1339989.5,GBP,Shell
TXN0000016582,2024-06-19T06:47:56,ACC00007681,ATM,293.64,-1340283.14,GBP,Online Store
TXN0000016583,2024-02-21T14:29:48,ACC00003828,Payment,1318.34,-1341601.48,GBP,Grocery
TXN0000016584,2024-08-30T03:46:56,ACC00003149,Transfer,109.3,-1341492.18,USD,Shell
TXN0000016585,2024-07-27T12:58:37,ACC00006872,Payment,609.8,-1342101.98,USD,Amazon
TXN0000016586,2024-08-02T00:04:26,ACC00003049,Debit,1967.4,-1344069.38,JPY,Walmart
TXN0000016587,2024-11-17T04:36:13,ACC00002651,Credit,1897.07,-1342172.31,EUR,Target
TXN0000016588,2024-04-15T02:34:15,ACC00003308,Credit,214.22,-1341958.09,EUR,Target
TXN0000016589,2024-09-22T10:40:38,ACC00000741,Transfer,1346.17,-1340611.92,EUR,Target
TXN0000016590,2024-06-03T06:02:15,ACC00001079,Transfer,41.19,-1340570.73,GBP,Target
TXN0000016591,2024-01-06T23:11:56,ACC00001593,Payment,1253.07,-1341823.8,JPY,Walmart
TXN0000016592,2024-08-15T16:05:42,ACC00004031,ATM,1363.77,-1343187.57,USD,Amazon
TXN0000016593,2024-12-24T21:21:56,ACC00009343,ATM,70.79,-1343258.36,JPY,Restaurant
TXN0000016594,2024-09-30T12:15:26,ACC00009265,Debit,231.37,-1343489.73,USD,Target
TXN0000016595,2024-07-12T17:25:02,ACC00000353,Credit,968.91,-1342520.82,JPY,Target
TXN0000016596,2024-08-11T21:01:23,ACC00008236,Debit,1295.64,-1343816.46,EUR,Amazon
TXN0000016597,2024-07-02T11:30:56,ACC00006795,Payment,1315.46,-1345131.92,EUR,Target
TXN0000016598,2024-07-07T11:37:12,ACC00001568,Payment,1815.69,-1346947.61,USD,Target
TXN0000016599,2024-04-07T07:25:52,ACC00007594,Debit,1737.95,-1348685.56,JPY,Amazon
TXN0000016600,2024-07-31T07:48:21,ACC00005150,Debit,1061.64,-1349747.2,USD,Amazon
TXN0000016601,2024-04-08T10:35:52,ACC00000908,Payment,222.79,-1349969.99,GBP,Starbucks
TXN0000016602,2024-01-24T02:11:23,ACC00003681,Transfer,91.87,-1349878.12,EUR,Online Store
TXN0000016603,2024-06-27T01:39:52,ACC00009262,Transfer,935.64,-1348942.48,EUR,Target
TXN0000016604,2024-10-14T13:36:34,ACC00004093,Credit,1501.85,-1347440.63,GBP,Starbucks
TXN0000016605,2024-05-05T03:11:10,ACC00001589,Credit,1232.97,-1346207.66,JPY,Shell
TXN0000016606,2024-05-22T04:48:19,ACC00006298,Payment,1814.09,-1348021.75,EUR,Restaurant
TXN0000016607,2024-09-25T04:51:46,ACC00002175,Payment,1760.87,-1349782.62,JPY,Walmart
TXN0000016608,2024-02-01T22:27:24,ACC00004065,Credit,1172.56,-1348610.06,EUR,Grocery
TXN0000016609,2024-11-24T20:25:15,ACC00008418,Debit,645.9,-1349255.96,EUR,Walmart
TXN0000016610,2024-03-20T21:06:43,ACC00009896,ATM,1281.58,-1350537.54,USD,Online Store
TXN0000016611,2024-06-02T09:21:48,ACC00001318,Payment,1504.62,-1352042.16,JPY,Target
TXN0000016612,2024-05-19T10:18:27,ACC00008827,ATM,1467.6,-1353509.76,GBP,Walmart
TXN0000016613,2024-04-28T19:27:57,ACC00004291,ATM,1939.15,-1355448.91,JPY,Shell
TXN0000016614,2024-07-10T04:19:34,ACC00003925,Payment,45.23,-1355494.14,GBP,Amazon
TXN0000016615,2024-09-18T04:23:23,ACC00004999,Payment,543.52,-1356037.66,JPY,Shell
TXN0000016616,2024-07-29T11:12:09,ACC00004456,Payment,1867.81,-1357905.47,GBP,Target
TXN0000016617,2024-10-10T04:42:07,ACC00003435,Payment,578.26,-1358483.73,JPY,Starbucks
TXN0000016618,2024-07-08T11:55:06,ACC00002990,Credit,845.6,-1357638.13,USD,Restaurant
TXN0000016619,2024-06-30T17:09:25,ACC00006162,Payment,797.14,-1358435.27,USD,Shell
TXN0000016620,2024-07-10T23:30:47,ACC00008136,Transfer,1881.7,-1356553.57,EUR,Target
TXN0000016621,2024-01-07T12:38:44,ACC00005842,Debit,700.96,-1357254.53,EUR,Starbucks
TXN0000016622,2024-01-11T08:00:08,ACC00003864,ATM,995.55,-1358250.08,USD,Amazon
TXN0000016623,2024-09-21T20:52:11,ACC00009753,Transfer,984.16,-1357265.92,GBP,Grocery
TXN0000016624,2024-01-11T17:58:23,ACC00009255,Debit,393.47,-1357659.39,GBP,Shell
TXN0000016625,2024-01-22T00:35:08,ACC00007353,Debit,223.49,-1357882.88,USD,Restaurant
TXN0000016626,2024-04-04T19:04:08,ACC00003874,Debit,1080.52,-1358963.4,USD,Online Store
TXN0000016627,2024-10-17T10:29:26,ACC00005627,Payment,645.46,-1359608.86,GBP,Grocery
TXN0000016628,2024-03-16T01:24:04,ACC00006862,Payment,1603.29,-1361212.15,EUR,Amazon
TXN0000016629,2024-11-29T19:05:40,ACC00001805,Credit,1863.55,-1359348.6,GBP,Starbucks
TXN0000016630,2024-01-11T11:14:29,ACC00004034,Credit,1114.93,-1358233.67,USD,Target
TXN0000016631,2024-12-02T06:06:32,ACC00000605,ATM,1449.01,-1359682.68,GBP,Grocery
TXN0000016632,2024-04-01T10:11:29,ACC00004762,Debit,854.61,-1360537.29,USD,Amazon
TXN0000016633,2024-02-28T10:08:45,ACC00006894,Credit,1286.59,-1359250.7,JPY,Grocery
TXN0000016634,2024-10-07T12:58:59,ACC00006160,ATM,1521.22,-1360771.92,GBP,Amazon
TXN0000016635,2024-06-15T15:00:42,ACC00006544,Transfer,456.25,-1360315.67,USD,Restaurant
TXN0000016636,2024-12-04T06:31:17,ACC00003893,Debit,1589.3,-1361904.97,JPY,Amazon
TXN0000016637,2024-09-13T12:31:58,ACC00002131,Transfer,227.84,-1361677.13,JPY,Starbucks
TXN0000016638,2024-05-27T23:25:51,ACC00006860,Transfer,1543.37,-1360133.76,USD,Shell
TXN0000016639,2024-07-19T19:14:29,ACC00008357,Credit,1237.26,-1358896.5,GBP,Starbucks
TXN0000016640,2024-03-12T11:27:08,ACC00003852,ATM,1815.98,-1360712.48,USD,Shell
TXN0000016641,2024-04-03T07:19:31,ACC00009358,Credit,1759.11,-1358953.37,GBP,Walmart
TXN0000016642,2024-06-22T02:09:52,ACC00007018,Debit,45.96,-1358999.33,USD,Walmart
TXN0000016643,2024-10-25T13:55:52,ACC00003946,Credit,1368.18,-1357631.15,JPY,Target
TXN0000016644,2024-08-11T22:02:29,ACC00009419,Transfer,1996.75,-1355634.4,JPY,Amazon
TXN0000016645,2024-05-06T18:06:37,ACC00001833,Debit,393.03,-1356027.43,USD,Grocery
TXN0000016646,2024-06-01T20:46:45,ACC00002896,Credit,1571.35,-1354456.08,JPY,Amazon
TXN0000016647,2024-01-21T22:12:09,ACC00008147,ATM,433.15,-1354889.23,GBP,Target
TXN0000016648,2024-06-09T06:03:25,ACC00009976,Credit,1920.98,-1352968.25,GBP,Grocery
TXN0000016649,2024-09-12T15:38:47,ACC00004898,Debit,326.65,-1353294.9,JPY,Amazon
TXN0000016650,2024-09-19T10:51:55,ACC00009066,Transfer,810.31,-1352484.59,EUR,Online Store
TXN0000016651,2024-08-29T21:29:32,ACC00008930,Debit,996.61,-1353481.2,USD,Target
TXN0000016652,2024-01-18T15:05:28,ACC00000179,Debit,107.08,-1353588.28,USD,Online Store
TXN0000016653,2024-12-10T09:55:38,ACC00008706,Transfer,585.46,-1353002.82,GBP,Online Store
TXN0000016654,2024-05-17T05:15:07,ACC00004251,Transfer,1596.39,-1351406.43,GBP,Target
TXN0000016655,2024-10-02T14:11:05,ACC00002180,Payment,1543.31,-1352949.74,EUR,Online Store
TXN0000016656,2024-09-03T16:08:14,ACC00007152,Debit,1947.97,-1354897.71,GBP,Grocery
TXN0000016657,2024-12-22T11:15:43,ACC00003020,Debit,628.04,-1355525.75,EUR,Grocery
TXN0000016658,2024-02-11T17:24:01,ACC00006029,Debit,270.11,-1355795.86,GBP,Walmart
TXN0000016659,2024-02-14T01:20:59,ACC00005086,ATM,29.49,-1355825.35,USD,Target
TXN0000016660,2024-04-19T22:49:51,ACC00005673,Debit,1730.82,-1357556.17,USD,Walmart
TXN0000016661,2024-03-23T17:10:14,ACC00008374,ATM,1602.26,-1359158.43,EUR,Restaurant
TXN0000016662,2024-02-21T14:16:01,ACC00000709,Debit,803.63,-1359962.06,USD,Target
TXN0000016663,2024-01-10T01:15:33,ACC00005410,Transfer,1466.59,-1358495.47,JPY,Shell
TXN0000016664,2024-02-03T03:20:37,ACC00009662,ATM,398.73,-1358894.2,GBP,Walmart
TXN0000016665,2024-02-19T05:22:31,ACC00005657,ATM,785.78,-1359679.98,EUR,Target
TXN0000016666,2024-11-04T23:29:06,ACC00009070,ATM,852.91,-1360532.89,JPY,Shell
TXN0000016667,2024-03-09T12:00:02,ACC00009752,Debit,815.47,-1361348.36,JPY,Amazon
TXN0000016668,2024-10-18T02:03:10,ACC00000061,Debit,17.92,-1361366.28,GBP,Starbucks
TXN0000016669,2024-12-03T11:10:17,ACC00004866,Transfer,458.17,-1360908.11,GBP,Walmart
TXN0000016670,2024-04-07T12:36:18,ACC00008788,Payment,402.19,-1361310.3,JPY,Target
TXN0000016671,2024-12-01T18:26:05,ACC00000484,Credit,105.41,-1361204.89,USD,Online Store
TXN0000016672,2024-08-03T16:44:17,ACC00001757,Transfer,1326.33,-1359878.56,GBP,Walmart
TXN0000016673,2024-01-26T19:13:09,ACC00006716,Transfer,885.13,-1358993.43,JPY,Amazon
TXN0000016674,2024-10-25T21:29:21,ACC00006247,Debit,1375.29,-1360368.72,JPY,Target
TXN0000016675,2024-08-30T06:24:59,ACC00008285,Debit,653.27,-1361021.99,GBP,Shell
TXN0000016676,2024-02-23T21:48:07,ACC00009647,ATM,1438.19,-1362460.18,EUR,Shell
TXN0000016677,2024-08-10T21:43:22,ACC00000489,ATM,806.93,-1363267.11,USD,Online Store
TXN0000016678,2024-11-03T13:08:48,ACC00002298,Credit,964.53,-1362302.58,GBP,Online Store
TXN0000016679,2024-02-02T20:27:39,ACC00002468,Payment,453.4,-1362755.98,JPY,Walmart
TXN0000016680,2024-02-14T22:21:47,ACC00000235,Payment,443.31,-1363199.29,GBP,Walmart
TXN0000016681,2024-11-12T20:13:59,ACC00001399,Payment,1327.96,-1364527.25,EUR,Grocery
TXN0000016682,2024-03-12T18:25:09,ACC00002156,ATM,158.76,-1364686.01,USD,Amazon
TXN0000016683,2024-04-03T15:18:31,ACC00000700,Payment,1977.64,-1366663.65,JPY,Shell
TXN0000016684,2024-08-16T21:55:41,ACC00009775,ATM,1520.31,-1368183.96,EUR,Grocery
TXN0000016685,2024-07-28T17:57:39,ACC00003988,ATM,190.91,-1368374.87,USD,Walmart
TXN0000016686,2024-05-13T23:50:16,ACC00006902,Payment,1599.25,-1369974.12,JPY,Online Store
TXN0000016687,2024-06-05T18:21:54,ACC00007878,Debit,937.8,-1370911.92,JPY,Starbucks
TXN0000016688,2024-12-18T04:55:42,ACC00000737,Credit,1595.02,-1369316.9,GBP,Shell
TXN0000016689,2024-04-11T22:00:00,ACC00009616,Payment,760.28,-1370077.18,JPY,Starbucks
TXN0000016690,2024-08-16T19:44:17,ACC00002737,Payment,1189.83,-1371267.01,JPY,Walmart
TXN0000016691,2024-11-28T02:22:15,ACC00008618,ATM,1815.15,-1373082.16,EUR,Restaurant
TXN0000016692,2024-06-27T20:58:20,ACC00009845,Transfer,1648.61,-1371433.55,GBP,Amazon
TXN0000016693,2024-06-18T19:27:08,ACC00003879,Payment,1841.98,-1373275.53,GBP,Online Store
TXN0000016694,2024-08-08T06:27:03,ACC00005674,Transfer,1997.22,-1371278.31,EUR,Amazon
TXN0000016695,2024-01-10T12:35:49,ACC00000761,Credit,317.01,-1370961.3,GBP,Shell
TXN0000016696,2024-08-25T01:21:30,ACC00006574,Transfer,1048.07,-1369913.23,GBP,Shell
TXN0000016697,2024-05-25T10:00:28,ACC00000839,Payment,942.33,-1370855.56,USD,Walmart
TXN0000016698,2024-04-30T01:30:58,ACC00008157,Transfer,891.69,-1369963.87,EUR,Grocery
TXN0000016699,2024-07-07T20:16:39,ACC00007345,Payment,1907.88,-1371871.75,EUR,Target
TXN0000016700,2024-08-14T06:14:11,ACC00004609,ATM,873.42,-1372745.17,JPY,Shell
TXN0000016701,2024-07-13T08:17:06,ACC00007388,Payment,757.79,-1373502.96,USD,Grocery
TXN0000016702,2024-01-16T14:12:45,ACC00000199,Debit,143.64,-1373646.6,EUR,Walmart
TXN0000016703,2024-10-16T13:08:16,ACC00000477,Transfer,22.42,-1373624.18,USD,Restaurant
TXN0000016704,2024-11-24T10:44:06,ACC00000643,Transfer,282.49,-1373341.69,USD,Starbucks
TXN0000016705,2024-08-09T05:27:45,ACC00005733,Payment,1476.43,-1374818.12,GBP,Restaurant
TXN0000016706,2024-12-22T22:26:18,ACC00007849,Credit,909.76,-1373908.36,USD,Amazon
TXN0000016707,2024-07-10T16:46:02,ACC00007935,Credit,118.23,-1373790.13,EUR,Grocery
TXN0000016708,2024-01-27T07:11:23,ACC00006367,Transfer,764.28,-1373025.85,GBP,Shell
TXN0000016709,2024-11-24T23:19:15,ACC00003637,ATM,1178.29,-1374204.14,USD,Restaurant
TXN0000016710,2024-01-15T14:43:52,ACC00003520,Credit,1976.41,-1372227.73,EUR,Target
TXN0000016711,2024-07-30T06:10:53,ACC00004712,Payment,985.23,-1373212.96,USD,Shell
TXN0000016712,2024-02-22T01:15:39,ACC00005539,Debit,1530.89,-1374743.85,USD,Grocery
TXN0000016713,2024-05-10T15:51:31,ACC00003991,Credit,718.14,-1374025.71,JPY,Starbucks
TXN0000016714,2024-07-26T23:13:52,ACC00003408,Transfer,549.67,-1373476.04,USD,Grocery
TXN0000016715,2024-03-26T18:24:09,ACC00008254,Credit,1639.77,-1371836.27,EUR,Restaurant
TXN0000016716,2024-08-05T23:46:28,ACC00008629,Debit,589.57,-1372425.84,GBP,Online Store
TXN0000016717,2024-12-13T17:40:12,ACC00002131,Transfer,1166.33,-1371259.51,JPY,Online Store
TXN0000016718,2024-05-09T03:03:36,ACC00001796,Transfer,1475.56,-1369783.95,JPY,Restaurant
TXN0000016719,2024-09-25T06:58:59,ACC00003275,ATM,58.26,-1369842.21,GBP,Starbucks
TXN0000016720,2024-08-16T02:52:43,ACC00003259,Credit,1089.53,-1368752.68,USD,Online Store
TXN0000016721,2024-09-22T11:21:19,ACC00009262,Transfer,353.32,-1368399.36,EUR,Restaurant
TXN0000016722,2024-03-09T21:18:50,ACC00007417,Credit,848.86,-1367550.5,JPY,Target
TXN0000016723,2024-06-28T09:53:13,ACC00001758,Debit,93.04,-1367643.54,GBP,Walmart
TXN0000016724,2024-12-14T09:48:26,ACC00007379,Payment,1070.32,-1368713.86,GBP,Starbucks
TXN0000016725,2024-11-25T16:13:25,ACC00005955,Payment,1165.05,-1369878.91,USD,Shell
TXN0000016726,2024-10-24T13:59:12,ACC00005547,Payment,117.68,-1369996.59,EUR,Target
TXN0000016727,2024-08-16T03:03:13,ACC00002158,Debit,1182.13,-1371178.72,USD,Grocery
TXN0000016728,2024-04-18T10:00:34,ACC00002009,Transfer,88.01,-1371090.71,GBP,Amazon
TXN0000016729,2024-01-31T08:13:19,ACC00005825,Transfer,1093.46,-1369997.25,GBP,Walmart
TXN0000016730,2024-08-31T07:28:00,ACC00007127,ATM,1588.09,-1371585.34,JPY,Amazon
TXN0000016731,2024-12-18T15:11:27,ACC00009881,Payment,518.08,-1372103.42,JPY,Grocery
TXN0000016732,2024-01-20T20:36:31,ACC00003141,ATM,1027.16,-1373130.58,JPY,Walmart
TXN0000016733,2024-06-20T14:10:09,ACC00007769,Credit,1442.38,-1371688.2,USD,Starbucks
TXN0000016734,2024-11-02T14:45:49,ACC00002430,Payment,800.19,-1372488.39,JPY,Target
TXN0000016735,2024-12-09T21:07:54,ACC00001793,Payment,1924.46,-1374412.85,JPY,Grocery
TXN0000016736,2024-11-09T18:26:28,ACC00009707,ATM,1461.96,-1375874.81,EUR,Amazon
TXN0000016737,2024-10-09T14:19:02,ACC00004434,Debit,433.09,-1376307.9,EUR,Shell
TXN0000016738,2024-07-14T13:29:08,ACC00004693,Transfer,1459.22,-1374848.68,USD,Online Store
TXN0000016739,2024-12-16T18:42:46,ACC00008874,Credit,1963.57,-1372885.11,USD,Amazon
TXN0000016740,2024-02-16T00:36:22,ACC00006666,Debit,1413.06,-1374298.17,GBP,Walmart
TXN0000016741,2024-01-11T01:15:24,ACC00002509,Payment,1875.32,-1376173.49,JPY,Shell
TXN0000016742,2024-07-01T18:42:10,ACC00009423,Credit,436.53,-1375736.96,EUR,Online Store
TXN0000016743,2024-04-06T21:00:01,ACC00001987,Transfer,470.87,-1375266.09,JPY,Amazon
TXN0000016744,2024-11-24T05:00:59,ACC00002490,Credit,299.95,-1374966.14,EUR,Walmart
TXN0000016745,2024-06-24T02:18:23,ACC00008662,Transfer,1506.18,-1373459.96,JPY,Amazon
TXN0000016746,2024-02-10T13:51:11,ACC00004164,Transfer,22.27,-1373437.69,EUR,Walmart
TXN0000016747,2024-03-05T01:01:45,ACC00006698,Transfer,1938.25,-1371499.44,JPY,Target
TXN0000016748,2024-02-22T23:52:07,ACC00000877,Debit,211.94,-1371711.38,EUR,Restaurant
TXN0000016749,2024-01-27T16:14:52,ACC00001489,Debit,998.78,-1372710.16,EUR,Walmart
TXN0000016750,2024-03-24T02:10:25,ACC00008911,Debit,1361.32,-1374071.48,GBP,Walmart
TXN0000016751,2024-06-01T04:15:06,ACC00007994,Debit,1717.26,-1375788.74,GBP,Walmart
TXN0000016752,2024-06-04T02:44:10,ACC00004828,Credit,1526.99,-1374261.75,JPY,Target
TXN0000016753,2024-06-08T05:48:15,ACC00006235,Transfer,169.62,-1374092.13,JPY,Shell
TXN0000016754,2024-06-27T02:15:18,ACC00008576,Credit,1583.06,-1372509.07,USD,Online Store
TXN0000016755,2024-09-25T03:17:51,ACC00003300,Payment,1220.38,-1373729.45,GBP,Target
TXN0000016756,2024-07-22T05:34:55,ACC00006605,Debit,1363.86,-1375093.31,EUR,Restaurant
TXN0000016757,2024-09-13T10:27:42,ACC00007179,ATM,508.91,-1375602.22,EUR,Target
TXN0000016758,2024-05-13T10:02:05,ACC00009016,Transfer,1473.36,-1374128.86,JPY,Starbucks
TXN0000016759,2024-06-11T06:30:38,ACC00008526,Debit,1996.63,-1376125.49,JPY,Amazon
TXN0000016760,2024-03-24T03:52:11,ACC00002646,Payment,1520.12,-1377645.61,USD,Grocery
TXN0000016761,2024-12-13T10:02:40,ACC00002464,Payment,1775.15,-1379420.76,EUR,Restaurant
TXN0000016762,2024-01-01T19:43:26,ACC00003494,ATM,1807.93,-1381228.69,JPY,Restaurant
TXN0000016763,2024-02-16T20:23:48,ACC00005668,Credit,1763.53,-1379465.16,GBP,Restaurant
TXN0000016764,2024-10-16T21:00:26,ACC00003967,Debit,1095.15,-1380560.31,USD,Target
TXN0000016765,2024-09-11T14:53:15,ACC00000494,Credit,1902.71,-1378657.6,JPY,Starbucks
TXN0000016766,2024-08-02T20:18:33,ACC00007182,Transfer,326.25,-1378331.35,USD,Target
TXN0000016767,2024-11-29T02:51:06,ACC00003117,Payment,369.09,-1378700.44,USD,Amazon
TXN0000016768,2024-04-24T13:43:44,ACC00009911,ATM,236.01,-1378936.45,GBP,Target
TXN0000016769,2024-11-24T01:05:53,ACC00002561,ATM,473.12,-1379409.57,USD,Walmart
TXN0000016770,2024-08-11T14:51:59,ACC00001279,Transfer,871.64,-1378537.93,EUR,Amazon
TXN0000016771,2024-05-25T07:15:28,ACC00007119,Credit,141.17,-1378396.76,EUR,Grocery
TXN0000016772,2024-09-06T17:29:12,ACC00001516,ATM,42.93,-1378439.69,GBP,Online Store
TXN0000016773,2024-09-07T10:29:01,ACC00003651,Debit,1339.09,-1379778.78,EUR,Shell
TXN0000016774,2024-12-22T05:03:24,ACC00007230,Debit,320.25,-1380099.03,JPY,Grocery
TXN0000016775,2024-04-27T03:54:35,ACC00006710,Transfer,1449.62,-1378649.41,USD,Restaurant
TXN0000016776,2024-11-29T11:14:27,ACC00009943,Debit,615.81,-1379265.22,JPY,Walmart
TXN0000016777,2024-07-25T08:24:42,ACC00002561,Transfer,1799.39,-1377465.83,JPY,Shell
TXN0000016778,2024-03-24T09:20:05,ACC00000092,ATM,361.92,-1377827.75,JPY,Online Store
TXN0000016779,2024-08-14T08:10:39,ACC00007688,Transfer,1796.22,-1376031.53,JPY,Shell
TXN0000016780,2024-07-01T12:43:02,ACC00000033,ATM,1143.89,-1377175.42,USD,Shell
TXN0000016781,2024-05-08T19:49:27,ACC00003366,Debit,36.76,-1377212.18,GBP,Starbucks
TXN0000016782,2024-06-12T10:39:52,ACC00001934,ATM,167.73,-1377379.91,GBP,Restaurant
TXN0000016783,2024-04-26T10:01:07,ACC00007796,Credit,418.4,-1376961.51,GBP,Shell
TXN0000016784,2024-04-26T20:28:20,ACC00008310,Transfer,1079.67,-1375881.84,EUR,Walmart
TXN0000016785,2024-08-10T10:05:09,ACC00005869,Transfer,567.74,-1375314.1,EUR,Shell
TXN0000016786,2024-12-15T21:38:21,ACC00009083,Credit,684.56,-1374629.54,USD,Walmart
TXN0000016787,2024-09-09T14:46:13,ACC00007456,Transfer,1317.64,-1373311.9,USD,Amazon
TXN0000016788,2024-12-22T19:34:23,ACC00003275,ATM,957.31,-1374269.21,USD,Restaurant
TXN0000016789,2024-08-28T09:56:32,ACC00004812,Credit,903.59,-1373365.62,JPY,Amazon
TXN0000016790,2024-10-11T10:34:13,ACC00000572,Credit,92.37,-1373273.25,EUR,Starbucks
TXN0000016791,2024-07-26T05:07:10,ACC00001562,Credit,1508.08,-1371765.17,JPY,Target
TXN0000016792,2024-07-21T07:12:44,ACC00004465,Payment,1870.79,-1373635.96,USD,Restaurant
TXN0000016793,2024-01-10T22:44:28,ACC00004832,Credit,1946.55,-1371689.41,USD,Grocery
TXN0000016794,2024-06-01T07:53:41,ACC00001479,Debit,31.71,-1371721.12,JPY,Restaurant
TXN0000016795,2024-03-25T23:27:25,ACC00000597,Credit,99.12,-1371622.0,USD,Online Store
TXN0000016796,2024-08-19T14:40:45,ACC00009550,Credit,1712.87,-1369909.13,JPY,Target
TXN0000016797,2024-07-25T07:36:54,ACC00000295,ATM,934.93,-1370844.06,GBP,Restaurant
TXN0000016798,2024-12-24T10:25:49,ACC00009235,Payment,1758.19,-1372602.25,JPY,Grocery
TXN0000016799,2024-09-04T04:05:42,ACC00005093,Debit,1517.53,-1374119.78,EUR,Restaurant
TXN0000016800,2024-02-22T23:49:27,ACC00009542,Credit,114.34,-1374005.44,EUR,Shell
TXN0000016801,2024-12-06T08:29:07,ACC00009969,ATM,1796.13,-1375801.57,EUR,Target
TXN0000016802,2024-07-16T20:54:10,ACC00003951,Payment,1053.04,-1376854.61,GBP,Starbucks
TXN0000016803,2024-12-07T04:53:10,ACC00003970,ATM,1450.51,-1378305.12,JPY,Shell
TXN0000016804,2024-07-30T07:27:51,ACC00007324,Payment,732.37,-1379037.49,GBP,Shell
TXN0000016805,2024-10-03T22:42:14,ACC00008092,ATM,863.16,-1379900.65,GBP,Target
TXN0000016806,2024-07-16T14:29:17,ACC00004628,Transfer,615.74,-1379284.91,JPY,Amazon
TXN0000016807,2024-12-29T03:59:00,ACC00005486,ATM,1776.42,-1381061.33,JPY,Online Store
TXN0000016808,2024-08-22T20:29:56,ACC00004486,Credit,1000.86,-1380060.47,EUR,Amazon
TXN0000016809,2024-11-25T15:04:28,ACC00006708,Transfer,804.8,-1379255.67,GBP,Shell
TXN0000016810,2024-06-15T05:45:20,ACC00007827,Transfer,819.07,-1378436.6,GBP,Starbucks
TXN0000016811,2024-10-03T13:16:55,ACC00000818,Credit,939.28,-1377497.32,USD,Shell
TXN0000016812,2024-10-05T14:49:52,ACC00008614,Credit,1199.95,-1376297.37,USD,Shell
TXN0000016813,2024-08-29T18:11:25,ACC00008483,Debit,888.35,-1377185.72,USD,Starbucks
TXN0000016814,2024-05-26T09:59:10,ACC00004507,Credit,154.27,-1377031.45,GBP,Restaurant
TXN0000016815,2024-07-09T10:13:42,ACC00006978,Transfer,1395.78,-1375635.67,USD,Walmart
TXN0000016816,2024-12-08T04:46:57,ACC00002050,Credit,899.0,-1374736.67,USD,Walmart
TXN0000016817,2024-09-23T17:40:49,ACC00005117,Transfer,175.42,-1374561.25,EUR,Shell
TXN0000016818,2024-10-03T10:35:16,ACC00004590,Transfer,1856.67,-1372704.58,EUR,Grocery
TXN0000016819,2024-07-12T05:31:32,ACC00003249,Debit,1307.9,-1374012.48,USD,Shell
TXN0000016820,2024-06-26T22:35:37,ACC00000095,Debit,1413.84,-1375426.32,EUR,Shell
TXN0000016821,2024-10-31T06:01:06,ACC00000907,Debit,1913.25,-1377339.57,EUR,Shell
TXN0000016822,2024-01-11T08:12:25,ACC00007316,Payment,1805.77,-1379145.34,EUR,Amazon
TXN0000016823,2024-09-24T16:24:06,ACC00009330,Credit,1986.25,-1377159.09,JPY,Online Store
TXN0000016824,2024-01-16T03:02:17,ACC00005052,ATM,1682.84,-1378841.93,USD,Amazon
TXN0000016825,2024-01-13T08:11:52,ACC00006375,Payment,1147.39,-1379989.32,JPY,Grocery
TXN0000016826,2024-07-10T16:52:20,ACC00007267,Debit,1582.54,-1381571.86,JPY,Restaurant
TXN0000016827,2024-03-12T11:19:46,ACC00008380,Transfer,1173.78,-1380398.08,JPY,Amazon
TXN0000016828,2024-07-12T20:51:01,ACC00004447,Payment,1231.28,-1381629.36,JPY,Online Store
TXN0000016829,2024-05-17T06:03:12,ACC00007194,Credit,171.31,-1381458.05,EUR,Starbucks
TXN0000016830,2024-01-25T08:47:50,ACC00002523,Transfer,927.62,-1380530.43,GBP,Starbucks
TXN0000016831,2024-05-04T11:20:28,ACC00002011,ATM,1632.21,-1382162.64,JPY,Starbucks
TXN0000016832,2024-10-04T20:41:57,ACC00001093,Payment,1205.9,-1383368.54,JPY,Amazon
TXN0000016833,2024-11-27T02:57:48,ACC00008738,Transfer,15.13,-1383353.41,EUR,Restaurant
TXN0000016834,2024-07-12T21:24:45,ACC00005845,ATM,254.02,-1383607.43,GBP,Amazon
TXN0000016835,2024-06-27T22:56:04,ACC00003050,Debit,496.94,-1384104.37,JPY,Walmart
TXN0000016836,2024-05-03T01:58:23,ACC00001631,Transfer,1395.63,-1382708.74,GBP,Amazon
TXN0000016837,2024-05-04T07:21:43,ACC00005246,Transfer,1294.47,-1381414.27,JPY,Shell
TXN0000016838,2024-11-27T15:50:58,ACC00009408,Credit,1687.39,-1379726.88,USD,Grocery
TXN0000016839,2024-08-27T17:06:13,ACC00001027,ATM,1758.42,-1381485.3,JPY,Online Store
TXN0000016840,2024-01-10T11:56:36,ACC00009904,Debit,354.03,-1381839.33,JPY,Starbucks
TXN0000016841,2024-03-16T21:57:39,ACC00000894,Debit,1715.19,-1383554.52,JPY,Online Store
TXN0000016842,2024-09-03T01:13:32,ACC00002007,Debit,723.85,-1384278.37,GBP,Walmart
TXN0000016843,2024-08-03T08:56:46,ACC00002610,ATM,1394.99,-1385673.36,JPY,Restaurant
TXN0000016844,2024-10-03T04:11:42,ACC00006651,ATM,1547.85,-1387221.21,GBP,Restaurant
TXN0000016845,2024-09-13T02:13:10,ACC00008947,Payment,1019.08,-1388240.29,USD,Amazon
TXN0000016846,2024-03-17T16:45:55,ACC00004137,Credit,1878.33,-1386361.96,GBP,Starbucks
TXN0000016847,2024-05-25T11:42:56,ACC00005126,Debit,977.99,-1387339.95,EUR,Shell
TXN0000016848,2024-10-24T15:31:14,ACC00004416,ATM,1794.67,-1389134.62,EUR,Grocery
TXN0000016849,2024-05-01T12:33:15,ACC00000198,ATM,347.91,-1389482.53,GBP,Restaurant
TXN0000016850,2024-10-29T17:59:56,ACC00004877,Debit,436.59,-1389919.12,EUR,Target
TXN0000016851,2024-08-22T14:49:06,ACC00007161,Credit,1529.11,-1388390.01,GBP,Online Store
TXN0000016852,2024-11-02T05:01:32,ACC00007714,ATM,1790.5,-1390180.51,USD,Grocery
TXN0000016853,2024-12-20T05:10:16,ACC00005793,ATM,251.46,-1390431.97,JPY,Starbucks
TXN0000016854,2024-03-22T07:16:50,ACC00008118,Transfer,572.72,-1389859.25,JPY,Starbucks
TXN0000016855,2024-08-21T17:51:42,ACC00008837,Credit,743.52,-1389115.73,USD,Starbucks
TXN0000016856,2024-11-17T02:02:04,ACC00007744,Credit,201.88,-1388913.85,JPY,Amazon
TXN0000016857,2024-06-13T05:10:58,ACC00003327,Debit,1770.91,-1390684.76,JPY,Shell
TXN0000016858,2024-03-27T00:29:53,ACC00006396,Transfer,1107.56,-1389577.2,EUR,Walmart
TXN0000016859,2024-02-06T11:30:04,ACC00008554,Debit,1399.44,-1390976.64,EUR,Online Store
TXN0000016860,2024-08-08T00:24:53,ACC00002173,Credit,298.24,-1390678.4,USD,Walmart
TXN0000016861,2024-07-01T01:43:22,ACC00005941,Credit,501.52,-1390176.88,USD,Online Store
TXN0000016862,2024-07-21T00:50:21,ACC00004645,Debit,1967.26,-1392144.14,EUR,Restaurant
TXN0000016863,2024-05-19T02:22:22,ACC00006893,Transfer,912.47,-1391231.67,GBP,Shell
TXN0000016864,2024-10-03T06:12:59,ACC00005490,Transfer,989.82,-1390241.85,GBP,Restaurant
TXN0000016865,2024-11-19T13:50:23,ACC00009471,Payment,1987.8,-1392229.65,USD,Restaurant
TXN0000016866,2024-02-07T22:00:16,ACC00001048,Transfer,1192.51,-1391037.14,GBP,Shell
TXN0000016867,2024-09-24T13:12:37,ACC00008064,Transfer,524.78,-1390512.36,JPY,Walmart
TXN0000016868,2024-04-20T09:14:12,ACC00006133,Credit,525.29,-1389987.07,JPY,Shell
TXN0000016869,2024-07-24T05:13:59,ACC00004941,Transfer,138.96,-1389848.11,JPY,Amazon
TXN0000016870,2024-03-03T14:55:06,ACC00001421,Credit,1777.28,-1388070.83,JPY,Starbucks
TXN0000016871,2024-04-14T08:23:32,ACC00004441,Transfer,905.91,-1387164.92,JPY,Target
TXN0000016872,2024-10-16T15:39:54,ACC00006362,Debit,687.2,-1387852.12,USD,Target
TXN0000016873,2024-01-07T01:47:42,ACC00003005,Credit,1857.96,-1385994.16,JPY,Grocery
TXN0000016874,2024-03-20T00:20:39,ACC00008821,Credit,121.23,-1385872.93,EUR,Walmart
TXN0000016875,2024-04-11T16:39:21,ACC00005673,Debit,1923.5,-1387796.43,EUR,Restaurant
TXN0000016876,2024-09-10T16:48:30,ACC00007728,Credit,1473.31,-1386323.12,GBP,Grocery
TXN0000016877,2024-03-18T05:21:39,ACC00004080,Debit,864.99,-1387188.11,EUR,Restaurant
TXN0000016878,2024-02-19T01:45:35,ACC00002102,Transfer,1768.82,-1385419.29,GBP,Shell
TXN0000016879,2024-09-16T00:09:36,ACC00004053,ATM,641.13,-1386060.42,JPY,Online Store
TXN0000016880,2024-04-22T17:17:17,ACC00009008,Payment,701.54,-1386761.96,EUR,Starbucks
TXN0000016881,2024-02-06T00:07:58,ACC00000355,ATM,950.48,-1387712.44,JPY,Walmart
TXN0000016882,2024-04-10T10:13:29,ACC00003551,Debit,1755.22,-1389467.66,GBP,Shell
TXN0000016883,2024-10-14T20:37:09,ACC00002579,Debit,1802.55,-1391270.21,EUR,Shell
TXN0000016884,2024-09-06T08:28:43,ACC00009281,ATM,710.35,-1391980.56,USD,Starbucks
TXN0000016885,2024-09-08T23:03:11,ACC00009922,ATM,1714.53,-1393695.09,USD,Online Store
TXN0000016886,2024-06-06T13:15:21,ACC00002772,Transfer,1985.85,-1391709.24,GBP,Amazon
TXN0000016887,2024-03-11T02:40:51,ACC00007705,Debit,1494.69,-1393203.93,EUR,Target
TXN0000016888,2024-09-06T08:19:32,ACC00008586,Credit,228.65,-1392975.28,USD,Amazon
TXN0000016889,2024-04-19T23:05:20,ACC00000174,Payment,1665.5,-1394640.78,USD,Walmart
TXN0000016890,2024-06-02T09:42:45,ACC00009223,Payment,1894.87,-1396535.65,GBP,Shell
TXN0000016891,2024-10-26T19:00:01,ACC00003666,Debit,871.2,-1397406.85,JPY,Target
TXN0000016892,2024-03-01T15:01:55,ACC00006752,ATM,535.29,-1397942.14,EUR,Online Store
TXN0000016893,2024-01-23T20:02:47,ACC00005784,Payment,201.35,-1398143.49,USD,Starbucks
TXN0000016894,2024-07-18T04:06:57,ACC00001663,Payment,1019.3,-1399162.79,GBP,Walmart
TXN0000016895,2024-04-21T14:52:43,ACC00006000,Payment,1293.08,-1400455.87,EUR,Grocery
TXN0000016896,2024-02-09T00:25:38,ACC00009736,Payment,277.66,-1400733.53,GBP,Shell
TXN0000016897,2024-03-30T22:20:08,ACC00009845,Transfer,1467.18,-1399266.35,JPY,Starbucks
TXN0000016898,2024-07-22T01:00:58,ACC00008251,Credit,1914.0,-1397352.35,USD,Starbucks
TXN0000016899,2024-09-30T10:33:45,ACC00008131,Debit,18.83,-1397371.18,GBP,Target
TXN0000016900,2024-06-21T08:06:37,ACC00002953,Payment,12.39,-1397383.57,EUR,Shell
TXN0000016901,2024-01-01T04:58:24,ACC00008610,ATM,395.39,-1397778.96,EUR,Amazon
TXN0000016902,2024-11-14T00:58:56,ACC00007976,Transfer,1072.18,-1396706.78,JPY,Shell
TXN0000016903,2024-06-09T01:22:06,ACC00005338,Credit,1219.15,-1395487.63,GBP,Grocery
TXN0000016904,2024-03-10T02:03:38,ACC00007717,Debit,1057.96,-1396545.59,EUR,Online Store
TXN0000016905,2024-03-07T03:04:46,ACC00002712,ATM,1243.22,-1397788.81,USD,Amazon
TXN0000016906,2024-01-26T13:12:29,ACC00005530,Payment,61.86,-1397850.67,JPY,Shell
TXN0000016907,2024-07-07T04:59:59,ACC00005168,Transfer,1768.07,-1396082.6,USD,Amazon
TXN0000016908,2024-07-10T06:11:11,ACC00005992,Transfer,936.28,-1395146.32,GBP,Online Store
TXN0000016909,2024-11-06T02:16:43,ACC00001024,Transfer,745.38,-1394400.94,EUR,Target
TXN0000016910,2024-09-01T11:15:39,ACC00007752,Transfer,1915.74,-1392485.2,JPY,Target
TXN0000016911,2024-01-03T15:55:36,ACC00006615,Credit,1890.99,-1390594.21,GBP,Starbucks
TXN0000016912,2024-03-13T17:16:23,ACC00004950,Credit,978.21,-1389616.0,USD,Starbucks
TXN0000016913,2024-03-10T13:18:53,ACC00003243,ATM,1834.98,-1391450.98,EUR,Online Store
TXN0000016914,2024-04-02T23:16:01,ACC00008231,Credit,198.23,-1391252.75,EUR,Amazon
TXN0000016915,2024-01-28T09:22:55,ACC00008761,Debit,208.35,-1391461.1,EUR,Starbucks
TXN0000016916,2024-09-28T14:09:07,ACC00000770,Debit,904.32,-1392365.42,GBP,Target
TXN0000016917,2024-11-29T03:21:47,ACC00002650,ATM,363.77,-1392729.19,EUR,Grocery
TXN0000016918,2024-01-11T11:57:39,ACC00001328,Debit,1566.93,-1394296.12,EUR,Amazon
TXN0000016919,2024-06-13T23:24:36,ACC00008476,Credit,698.42,-1393597.7,JPY,Online Store
TXN0000016920,2024-04-27T12:43:21,ACC00001059,Credit,38.64,-1393559.06,JPY,Amazon
TXN0000016921,2024-07-13T09:48:41,ACC00002526,ATM,1378.95,-1394938.01,USD,Starbucks
TXN0000016922,2024-12-27T23:25:51,ACC00005531,Payment,1536.52,-1396474.53,USD,Grocery
TXN0000016923,2024-02-28T13:47:33,ACC00007906,Debit,1606.73,-1398081.26,EUR,Grocery
TXN0000016924,2024-09-13T21:15:10,ACC00008081,ATM,1091.65,-1399172.91,JPY,Restaurant
TXN0000016925,2024-08-25T14:11:52,ACC00004255,ATM,784.4,-1399957.31,GBP,Starbucks
TXN0000016926,2024-05-25T20:42:45,ACC00007749,Payment,14.14,-1399971.45,EUR,Target
TXN0000016927,2024-03-10T06:05:34,ACC00008483,Payment,1538.93,-1401510.38,JPY,Grocery
TXN0000016928,2024-03-07T07:32:45,ACC00009592,ATM,577.51,-1402087.89,GBP,Amazon
TXN0000016929,2024-03-20T07:48:11,ACC00007695,Transfer,113.77,-1401974.12,JPY,Target
TXN0000016930,2024-01-09T11:22:14,ACC00006115,Payment,677.64,-1402651.76,EUR,Amazon
TXN0000016931,2024-03-16T23:27:58,ACC00008838,Transfer,1882.2,-1400769.56,EUR,Target
TXN0000016932,2024-07-12T22:38:10,ACC00002151,Debit,264.71,-1401034.27,GBP,Amazon
TXN0000016933,2024-09-24T14:36:09,ACC00005468,Transfer,1812.52,-1399221.75,GBP,Shell
TXN0000016934,2024-07-21T21:37:47,ACC00001336,Transfer,1048.74,-1398173.01,GBP,Amazon
TXN0000016935,2024-09-06T17:13:56,ACC00002204,Credit,572.35,-1397600.66,JPY,Amazon
TXN0000016936,2024-10-26T05:04:33,ACC00003114,Payment,699.69,-1398300.35,EUR,Grocery
TXN0000016937,2024-01-29T14:57:30,ACC00000458,Debit,1491.7,-1399792.05,EUR,Restaurant
TXN0000016938,2024-02-21T01:27:28,ACC00009729,Debit,1480.05,-1401272.1,USD,Walmart
TXN0000016939,2024-03-27T23:28:40,ACC00007291,Debit,1416.96,-1402689.06,GBP,Walmart
TXN0000016940,2024-07-24T16:30:20,ACC00004515,ATM,584.61,-1403273.67,EUR,Shell
TXN0000016941,2024-05-14T16:02:48,ACC00007535,Transfer,1093.46,-1402180.21,JPY,Grocery
TXN0000016942,2024-04-23T10:28:47,ACC00008138,Payment,1432.83,-1403613.04,EUR,Shell
TXN0000016943,2024-03-26T12:45:42,ACC00004802,Payment,502.6,-1404115.64,JPY,Starbucks
TXN0000016944,2024-06-02T15:19:28,ACC00003366,Payment,540.77,-1404656.41,USD,Grocery
TXN0000016945,2024-10-09T23:14:16,ACC00001574,Credit,1802.29,-1402854.12,EUR,Starbucks
TXN0000016946,2024-11-11T02:31:22,ACC00007106,ATM,577.05,-1403431.17,JPY,Grocery
TXN0000016947,2024-05-06T19:46:38,ACC00007533,Transfer,207.71,-1403223.46,EUR,Shell
TXN0000016948,2024-08-29T05:12:02,ACC00007085,Credit,1168.82,-1402054.64,GBP,Walmart
TXN0000016949,2024-02-13T19:24:16,ACC00002251,Payment,1548.21,-1403602.85,USD,Online Store
TXN0000016950,2024-07-24T06:17:06,ACC00009739,Payment,674.25,-1404277.1,EUR,Grocery
TXN0000016951,2024-07-21T02:15:41,ACC00005829,Debit,1353.04,-1405630.14,USD,Target
TXN0000016952,2024-09-30T16:13:58,ACC00005182,Debit,37.32,-1405667.46,EUR,Grocery
TXN0000016953,2024-06-27T15:12:20,ACC00008023,Debit,1604.84,-1407272.3,EUR,Amazon
TXN0000016954,2024-09-01T02:51:15,ACC00008610,ATM,999.35,-1408271.65,USD,Amazon
TXN0000016955,2024-05-31T12:17:29,ACC00006333,ATM,216.47,-1408488.12,EUR,Restaurant
TXN0000016956,2024-02-07T08:43:38,ACC00000475,Transfer,317.3,-1408170.82,JPY,Shell
TXN0000016957,2024-09-15T13:54:39,ACC00004693,ATM,1099.19,-1409270.01,JPY,Walmart
TXN0000016958,2024-04-26T01:33:29,ACC00000826,Debit,999.01,-1410269.02,EUR,Shell
TXN0000016959,2024-07-04T10:55:52,ACC00004278,Credit,1885.59,-1408383.43,GBP,Restaurant
TXN0000016960,2024-03-19T07:13:58,ACC00003206,Debit,1450.51,-1409833.94,JPY,Restaurant
TXN0000016961,2024-05-26T17:42:25,ACC00005968,Debit,1168.47,-1411002.41,EUR,Starbucks
TXN0000016962,2024-06-11T05:00:49,ACC00008889,Debit,1920.17,-1412922.58,JPY,Grocery
TXN0000016963,2024-04-25T10:21:10,ACC00008054,Payment,1967.03,-1414889.61,JPY,Online Store
TXN0000016964,2024-03-25T09:48:16,ACC00005735,ATM,1342.18,-1416231.79,GBP,Starbucks
TXN0000016965,2024-08-15T03:04:05,ACC00005448,Transfer,1876.05,-1414355.74,USD,Walmart
TXN0000016966,2024-11-01T10:01:37,ACC00008216,Debit,1463.0,-1415818.74,JPY,Shell
TXN0000016967,2024-01-26T06:31:46,ACC00007260,Credit,1404.37,-1414414.37,GBP,Walmart
TXN0000016968,2024-10-09T03:28:05,ACC00009087,ATM,1926.81,-1416341.18,GBP,Shell
TXN0000016969,2024-03-11T06:52:08,ACC00002956,Debit,1998.09,-1418339.27,JPY,Shell
TXN0000016970,2024-04-03T05:22:42,ACC00000288,ATM,1237.66,-1419576.93,EUR,Starbucks
TXN0000016971,2024-09-16T09:30:13,ACC00000325,Payment,540.8,-1420117.73,USD,Restaurant
TXN0000016972,2024-03-28T11:48:50,ACC00009581,Debit,336.18,-1420453.91,USD,Restaurant
TXN0000016973,2024-12-14T03:04:22,ACC00008084,Payment,149.17,-1420603.08,GBP,Grocery
TXN0000016974,2024-03-22T16:43:35,ACC00009408,Transfer,908.19,-1419694.89,GBP,Starbucks
TXN0000016975,2024-06-29T12:48:36,ACC00008490,Debit,639.7,-1420334.59,EUR,Amazon
TXN0000016976,2024-06-17T09:05:16,ACC00003707,Debit,998.02,-1421332.61,EUR,Grocery
TXN0000016977,2024-06-04T03:52:28,ACC00004381,ATM,1277.57,-1422610.18,USD,Starbucks
TXN0000016978,2024-01-11T03:10:37,ACC00001708,ATM,1939.46,-1424549.64,JPY,Starbucks
TXN0000016979,2024-03-24T18:39:00,ACC00004384,Debit,1223.28,-1425772.92,JPY,Grocery
TXN0000016980,2024-10-27T16:14:07,ACC00002199,Credit,890.42,-1424882.5,EUR,Walmart
TXN0000016981,2024-04-16T20:13:27,ACC00006495,Debit,1822.08,-1426704.58,JPY,Shell
TXN0000016982,2024-04-06T15:23:30,ACC00006816,Debit,1870.23,-1428574.81,EUR,Amazon
TXN0000016983,2024-10-08T22:11:24,ACC00001017,ATM,1016.45,-1429591.26,GBP,Online Store
TXN0000016984,2024-09-16T16:13:39,ACC00007894,ATM,1787.95,-1431379.21,GBP,Grocery
TXN0000016985,2024-08-23T12:22:08,ACC00007089,ATM,830.32,-1432209.53,EUR,Restaurant
TXN0000016986,2024-06-24T12:55:54,ACC00004710,Credit,902.58,-1431306.95,EUR,Shell
TXN0000016987,2024-07-21T19:49:40,ACC00001374,Transfer,1823.27,-1429483.68,JPY,Starbucks
TXN0000016988,2024-08-14T16:46:41,ACC00007244,Credit,1206.87,-1428276.81,GBP,Shell
TXN0000016989,2024-09-23T01:20:06,ACC00003999,Credit,686.35,-1427590.46,JPY,Grocery
TXN0000016990,2024-06-09T01:25:07,ACC00004182,Credit,535.1,-1427055.36,EUR,Walmart
TXN0000016991,2024-04-11T06:24:04,ACC00001045,Debit,1257.1,-1428312.46,JPY,Amazon
TXN0000016992,2024-06-24T10:58:28,ACC00002268,ATM,228.42,-1428540.88,GBP,Shell
TXN0000016993,2024-12-08T14:30:03,ACC00009533,Debit,1763.89,-1430304.77,GBP,Online Store
TXN0000016994,2024-11-07T16:04:08,ACC00005624,ATM,323.76,-1430628.53,EUR,Starbucks
TXN0000016995,2024-03-08T18:21:16,ACC00003388,ATM,1635.21,-1432263.74,EUR,Walmart
TXN0000016996,2024-08-24T20:16:15,ACC00001889,Payment,273.49,-1432537.23,EUR,Starbucks
TXN0000016997,2024-12-25T17:55:41,ACC00003220,Payment,381.5,-1432918.73,EUR,Shell
TXN0000016998,2024-04-05T06:52:40,ACC00000986,Transfer,1499.65,-1431419.08,EUR,Amazon
TXN0000016999,2024-08-13T01:28:18,ACC00009934,Payment,227.24,-1431646.32,EUR,Shell
TXN0000017000,2024-11-14T06:24:39,ACC00006114,Payment,54.2,-1431700.52,USD,Online Store
TXN0000017001,2024-01-01T02:47:10,ACC00005118,ATM,1325.98,-1433026.5,USD,Walmart
TXN0000017002,2024-09-10T02:43:33,ACC00005921,Credit,1308.71,-1431717.79,USD,Target
TXN0000017003,2024-05-24T16:11:57,ACC00000156,ATM,164.11,-1431881.9,USD,Shell
TXN0000017004,2024-04-07T00:40:16,ACC00008969,Payment,1253.74,-1433135.64,GBP,Target
TXN0000017005,2024-03-22T20:34:44,ACC00003130,Credit,415.6,-1432720.04,USD,Restaurant
TXN0000017006,2024-10-09T14:43:25,ACC00004522,ATM,1237.63,-1433957.67,USD,Restaurant
TXN0000017007,2024-03-21T05:18:23,ACC00000594,Payment,763.81,-1434721.48,USD,Online Store
TXN0000017008,2024-07-28T05:38:58,ACC00006879,ATM,1464.83,-1436186.31,GBP,Shell
TXN0000017009,2024-04-19T14:51:58,ACC00004256,ATM,1393.05,-1437579.36,GBP,Shell
TXN0000017010,2024-02-19T01:02:02,ACC00000578,ATM,396.32,-1437975.68,EUR,Target
TXN0000017011,2024-02-03T17:27:18,ACC00003509,ATM,114.79,-1438090.47,EUR,Shell
TXN0000017012,2024-12-09T09:58:04,ACC00002978,Credit,295.05,-1437795.42,USD,Restaurant
TXN0000017013,2024-11-08T08:31:20,ACC00006261,Debit,1675.81,-1439471.23,EUR,Online Store
TXN0000017014,2024-11-24T05:56:19,ACC00002191,ATM,1928.24,-1441399.47,EUR,Target
TXN0000017015,2024-05-15T22:16:55,ACC00001508,Payment,906.9,-1442306.37,EUR,Amazon
TXN0000017016,2024-07-18T15:03:59,ACC00009689,Credit,1922.52,-1440383.85,EUR,Restaurant
TXN0000017017,2024-10-25T10:48:24,ACC00006200,Credit,1272.7,-1439111.15,USD,Shell
TXN0000017018,2024-04-23T21:58:52,ACC00007640,Payment,1637.84,-1440748.99,EUR,Walmart
TXN0000017019,2024-12-05T23:01:46,ACC00000326,ATM,1189.1,-1441938.09,EUR,Online Store
TXN0000017020,2024-12-11T15:18:37,ACC00007391,ATM,1486.87,-1443424.96,USD,Starbucks
TXN0000017021,2024-03-13T08:32:37,ACC00001210,ATM,1211.51,-1444636.47,EUR,Starbucks
TXN0000017022,2024-12-16T21:20:41,ACC00003051,Transfer,1374.0,-1443262.47,GBP,Shell
TXN0000017023,2024-08-18T11:43:08,ACC00000119,Credit,1867.47,-1441395.0,JPY,Grocery
TXN0000017024,2024-03-20T02:47:11,ACC00005220,ATM,469.34,-1441864.34,USD,Grocery
TXN0000017025,2024-04-20T17:31:36,ACC00008131,Payment,1839.11,-1443703.45,JPY,Shell
TXN0000017026,2024-12-11T01:43:53,ACC00003486,Debit,1612.24,-1445315.69,USD,Shell
TXN0000017027,2024-02-22T22:59:20,ACC00005233,Credit,1488.03,-1443827.66,GBP,Starbucks
TXN0000017028,2024-12-13T09:12:47,ACC00009321,Payment,1602.32,-1445429.98,GBP,Restaurant
TXN0000017029,2024-12-23T19:45:23,ACC00002620,Transfer,295.49,-1445134.49,EUR,Starbucks
TXN0000017030,2024-02-01T09:43:53,ACC00000178,Debit,579.91,-1445714.4,JPY,Shell
TXN0000017031,2024-05-15T02:49:35,ACC00001610,Credit,662.39,-1445052.01,USD,Grocery
TXN0000017032,2024-10-04T03:44:29,ACC00008016,ATM,555.49,-1445607.5,JPY,Restaurant
TXN0000017033,2024-12-25T13:05:36,ACC00003028,Credit,1486.41,-1444121.09,JPY,Online Store
TXN0000017034,2024-10-09T02:10:20,ACC00003141,Credit,1072.03,-1443049.06,JPY,Starbucks
TXN0000017035,2024-04-15T22:43:45,ACC00006053,ATM,693.0,-1443742.06,JPY,Starbucks
TXN0000017036,2024-05-11T07:02:35,ACC00005058,Credit,1399.53,-1442342.53,GBP,Shell
TXN0000017037,2024-12-12T21:21:33,ACC00003114,Credit,585.51,-1441757.02,EUR,Restaurant
TXN0000017038,2024-11-17T22:23:33,ACC00006533,ATM,58.52,-1441815.54,EUR,Walmart
TXN0000017039,2024-05-08T14:24:25,ACC00005671,Debit,1152.11,-1442967.65,GBP,Restaurant
TXN0000017040,2024-10-01T22:28:56,ACC00002629,Payment,1130.04,-1444097.69,JPY,Shell
TXN0000017041,2024-10-04T00:35:31,ACC00006281,Transfer,1299.29,-1442798.4,EUR,Starbucks
TXN0000017042,2024-09-28T13:55:45,ACC00008098,Credit,1052.19,-1441746.21,GBP,Target
TXN0000017043,2024-09-11T21:05:49,ACC00007460,ATM,1073.98,-1442820.19,JPY,Restaurant
TXN0000017044,2024-08-29T06:52:53,ACC00004578,Debit,276.33,-1443096.52,JPY,Amazon
TXN0000017045,2024-01-22T19:56:43,ACC00005449,Transfer,51.93,-1443044.59,GBP,Restaurant
TXN0000017046,2024-04-21T13:24:27,ACC00007118,Transfer,1556.02,-1441488.57,GBP,Shell
TXN0000017047,2024-07-25T16:58:31,ACC00007898,Credit,1104.54,-1440384.03,USD,Online Store
TXN0000017048,2024-04-07T01:20:44,ACC00008380,Debit,1023.38,-1441407.41,JPY,Online Store
TXN0000017049,2024-01-30T12:39:56,ACC00005048,Credit,1344.08,-1440063.33,USD,Shell
TXN0000017050,2024-01-21T12:36:18,ACC00009286,ATM,1530.67,-1441594.0,GBP,Amazon
TXN0000017051,2024-06-10T09:50:23,ACC00000769,Debit,1116.41,-1442710.41,USD,Walmart
TXN0000017052,2024-10-22T23:50:54,ACC00003711,ATM,168.04,-1442878.45,USD,Online Store
TXN0000017053,2024-03-12T22:14:18,ACC00004317,Credit,102.65,-1442775.8,USD,Shell
TXN0000017054,2024-04-12T02:11:09,ACC00000176,ATM,34.07,-1442809.87,GBP,Amazon
TXN0000017055,2024-12-14T19:26:50,ACC00003246,ATM,1469.86,-1444279.73,USD,Shell
TXN0000017056,2024-06-27T16:04:28,ACC00004804,Transfer,1996.26,-1442283.47,JPY,Starbucks
TXN0000017057,2024-12-24T23:26:12,ACC00001632,Credit,848.43,-1441435.04,GBP,Amazon
TXN0000017058,2024-03-21T08:13:24,ACC00005813,ATM,1037.07,-1442472.11,EUR,Online Store
TXN0000017059,2024-06-19T03:37:46,ACC00002965,Payment,30.33,-1442502.44,USD,Amazon
TXN0000017060,2024-05-24T15:24:40,ACC00003971,Payment,396.65,-1442899.09,EUR,Starbucks
TXN0000017061,2024-08-05T04:11:44,ACC00008335,Payment,1748.94,-1444648.03,EUR,Shell
TXN0000017062,2024-10-26T05:24:32,ACC00008323,Debit,721.26,-1445369.29,JPY,Amazon
TXN0000017063,2024-08-11T04:23:48,ACC00004352,Credit,930.0,-1444439.29,EUR,Grocery
TXN0000017064,2024-04-29T00:43:05,ACC00005016,Transfer,478.3,-1443960.99,EUR,Restaurant
TXN0000017065,2024-02-02T17:53:01,ACC00002080,Debit,1501.05,-1445462.04,JPY,Walmart
TXN0000017066,2024-04-28T18:06:34,ACC00006620,Debit,519.65,-1445981.69,USD,Restaurant
TXN0000017067,2024-06-24T11:11:46,ACC00009755,Payment,1018.53,-1447000.22,EUR,Starbucks
TXN0000017068,2024-05-12T04:52:39,ACC00007014,Payment,730.28,-1447730.5,USD,Starbucks
TXN0000017069,2024-09-28T12:55:07,ACC00002247,Transfer,349.81,-1447380.69,EUR,Starbucks
TXN0000017070,2024-05-03T09:58:20,ACC00004190,ATM,1384.81,-1448765.5,JPY,Target
TXN0000017071,2024-05-25T11:55:31,ACC00003964,Payment,774.37,-1449539.87,USD,Amazon
TXN0000017072,2024-09-22T17:16:31,ACC00008800,Credit,713.82,-1448826.05,GBP,Shell
TXN0000017073,2024-04-08T08:27:32,ACC00004096,ATM,1169.94,-1449995.99,USD,Grocery
TXN0000017074,2024-02-22T03:19:17,ACC00002436,Debit,614.96,-1450610.95,GBP,Walmart
TXN0000017075,2024-11-02T20:26:11,ACC00005082,Transfer,911.46,-1449699.49,USD,Target
TXN0000017076,2024-10-03T19:04:47,ACC00002407,ATM,226.23,-1449925.72,EUR,Amazon
TXN0000017077,2024-01-08T20:26:18,ACC00003934,Payment,1566.96,-1451492.68,USD,Walmart
TXN0000017078,2024-09-09T20:48:33,ACC00009852,Transfer,208.0,-1451284.68,USD,Starbucks
TXN0000017079,2024-01-02T04:06:11,ACC00005468,Payment,1147.73,-1452432.41,EUR,Shell
TXN0000017080,2024-11-09T20:38:51,ACC00000934,Transfer,430.26,-1452002.15,USD,Target
TXN0000017081,2024-04-22T22:56:55,ACC00002817,Payment,1269.16,-1453271.31,JPY,Target
TXN0000017082,2024-10-12T00:31:14,ACC00000793,Credit,22.84,-1453248.47,GBP,Target
TXN0000017083,2024-12-17T10:23:35,ACC00000964,ATM,827.28,-1454075.75,USD,Online Store
TXN0000017084,2024-07-29T02:03:22,ACC00009389,Debit,486.29,-1454562.04,EUR,Starbucks
TXN0000017085,2024-10-23T00:45:54,ACC00005837,Transfer,1376.87,-1453185.17,JPY,Walmart
TXN0000017086,2024-05-17T19:34:15,ACC00007155,Transfer,688.44,-1452496.73,EUR,Restaurant
TXN0000017087,2024-07-19T13:04:34,ACC00009160,ATM,346.16,-1452842.89,EUR,Walmart
TXN0000017088,2024-01-14T15:56:29,ACC00005932,ATM,645.0,-1453487.89,JPY,Amazon
TXN0000017089,2024-05-12T10:25:46,ACC00001504,Credit,478.71,-1453009.18,JPY,Restaurant
TXN0000017090,2024-01-06T20:12:20,ACC00008501,Payment,1595.37,-1454604.55,EUR,Online Store
TXN0000017091,2024-02-07T12:01:39,ACC00008951,Debit,771.39,-1455375.94,JPY,Grocery
TXN0000017092,2024-07-04T12:15:56,ACC00003128,Payment,675.88,-1456051.82,JPY,Restaurant
TXN0000017093,2024-03-03T08:36:13,ACC00000114,Debit,917.24,-1456969.06,EUR,Shell
TXN0000017094,2024-11-09T16:07:06,ACC00009321,Debit,1019.4,-1457988.46,JPY,Shell
TXN0000017095,2024-08-22T20:40:23,ACC00006395,Credit,1721.82,-1456266.64,GBP,Starbucks
TXN0000017096,2024-10-27T14:32:01,ACC00003856,Credit,1628.42,-1454638.22,EUR,Grocery
TXN0000017097,2024-03-12T22:09:17,ACC00008686,Payment,1083.65,-1455721.87,JPY,Starbucks
TXN0000017098,2024-05-17T04:50:35,ACC00006755,Transfer,288.34,-1455433.53,JPY,Online Store
TXN0000017099,2024-03-23T11:53:43,ACC00008884,Transfer,1677.15,-1453756.38,GBP,Online Store
TXN0000017100,2024-07-05T23:46:40,ACC00008827,Credit,783.88,-1452972.5,JPY,Walmart
TXN0000017101,2024-03-06T03:28:23,ACC00006563,Debit,610.75,-1453583.25,EUR,Target
TXN0000017102,2024-12-19T07:27:29,ACC00008610,Debit,1269.65,-1454852.9,JPY,Restaurant
TXN0000017103,2024-10-30T07:57:03,ACC00003610,ATM,455.27,-1455308.17,USD,Online Store
TXN0000017104,2024-01-15T02:24:49,ACC00002146,Credit,1178.44,-1454129.73,USD,Grocery
TXN0000017105,2024-09-06T05:45:09,ACC00005396,Credit,641.39,-1453488.34,GBP,Walmart
TXN0000017106,2024-02-15T20:41:41,ACC00000188,Payment,194.24,-1453682.58,EUR,Starbucks
TXN0000017107,2024-07-10T12:04:31,ACC00009371,Transfer,1461.65,-1452220.93,EUR,Online Store
TXN0000017108,2024-04-19T21:12:34,ACC00000830,Transfer,1809.17,-1450411.76,USD,Starbucks
TXN0000017109,2024-10-05T15:21:03,ACC00009822,ATM,1707.17,-1452118.93,EUR,Restaurant
TXN0000017110,2024-11-14T07:54:10,ACC00001074,Payment,584.98,-1452703.91,GBP,Shell
TXN0000017111,2024-06-20T22:12:19,ACC00005067,Transfer,1069.16,-1451634.75,JPY,Amazon
TXN0000017112,2024-07-12T04:09:01,ACC00002124,Transfer,1318.25,-1450316.5,USD,Restaurant
TXN0000017113,2024-10-03T18:53:31,ACC00007683,ATM,1249.85,-1451566.35,EUR,Restaurant
TXN0000017114,2024-04-22T09:48:16,ACC00009058,ATM,526.2,-1452092.55,GBP,Restaurant
TXN0000017115,2024-01-31T01:38:14,ACC00005497,Transfer,606.45,-1451486.1,JPY,Online Store
TXN0000017116,2024-08-02T03:22:17,ACC00004758,Credit,1836.45,-1449649.65,JPY,Grocery
TXN0000017117,2024-06-19T01:32:20,ACC00001933,ATM,1204.58,-1450854.23,JPY,Starbucks
TXN0000017118,2024-11-17T12:43:50,ACC00005657,Debit,485.57,-1451339.8,GBP,Target
TXN0000017119,2024-05-09T05:30:07,ACC00003796,Transfer,362.32,-1450977.48,USD,Shell
TXN0000017120,2024-07-19T20:07:56,ACC00002686,ATM,1124.97,-1452102.45,JPY,Walmart
TXN0000017121,2024-11-05T01:13:21,ACC00009397,Debit,14.21,-1452116.66,EUR,Starbucks
TXN0000017122,2024-05-14T04:51:21,ACC00003185,Credit,1639.09,-1450477.57,JPY,Target
TXN0000017123,2024-04-08T17:05:02,ACC00005805,Payment,1910.45,-1452388.02,EUR,Restaurant
TXN0000017124,2024-02-10T01:03:05,ACC00008647,Credit,1095.02,-1451293.0,USD,Walmart
TXN0000017125,2024-09-19T06:56:36,ACC00002411,Payment,812.35,-1452105.35,JPY,Starbucks
TXN0000017126,2024-05-19T09:06:13,ACC00005598,Transfer,1689.14,-1450416.21,EUR,Grocery
TXN0000017127,2024-02-28T17:30:59,ACC00002142,Transfer,1350.1,-1449066.11,EUR,Starbucks
TXN0000017128,2024-11-18T20:19:27,ACC00000702,Debit,1621.5,-1450687.61,EUR,Target
TXN0000017129,2024-04-30T07:40:24,ACC00003160,Payment,1389.58,-1452077.19,GBP,Walmart
TXN0000017130,2024-01-12T09:36:06,ACC00007899,Payment,1387.47,-1453464.66,USD,Shell
TXN0000017131,2024-07-22T14:12:38,ACC00000580,ATM,1792.84,-1455257.5,JPY,Amazon
TXN0000017132,2024-11-20T17:58:45,ACC00009441,Transfer,563.24,-1454694.26,EUR,Target
TXN0000017133,2024-04-17T08:49:11,ACC00006468,ATM,1793.36,-1456487.62,EUR,Starbucks
TXN0000017134,2024-01-05T14:58:21,ACC00008854,ATM,1933.58,-1458421.2,GBP,Starbucks
TXN0000017135,2024-05-13T18:35:41,ACC00005419,Credit,1944.9,-1456476.3,JPY,Amazon
TXN0000017136,2024-09-28T20:36:44,ACC00007238,Transfer,191.43,-1456284.87,USD,Walmart
TXN0000017137,2024-05-04T01:14:01,ACC00003861,Transfer,196.48,-1456088.39,EUR,Amazon
TXN0000017138,2024-08-03T14:15:58,ACC00006733,ATM,47.71,-1456136.1,JPY,Starbucks
TXN0000017139,2024-02-13T14:57:35,ACC00001159,Debit,1728.5,-1457864.6,GBP,Amazon
TXN0000017140,2024-02-17T20:32:34,ACC00001283,Debit,171.52,-1458036.12,USD,Target
TXN0000017141,2024-09-09T19:49:06,ACC00000974,Credit,159.27,-1457876.85,JPY,Shell
TXN0000017142,2024-03-15T09:48:06,ACC00007965,Payment,1739.69,-1459616.54,JPY,Online Store
TXN0000017143,2024-07-04T07:29:49,ACC00007561,Payment,1215.64,-1460832.18,USD,Walmart
TXN0000017144,2024-10-08T05:54:08,ACC00009653,Debit,858.36,-1461690.54,JPY,Target
TXN0000017145,2024-05-04T08:37:16,ACC00006923,Transfer,382.75,-1461307.79,EUR,Shell
TXN0000017146,2024-03-22T21:39:11,ACC00007134,Payment,1264.42,-1462572.21,USD,Target
TXN0000017147,2024-12-06T08:56:53,ACC00002868,Payment,1646.61,-1464218.82,GBP,Target
TXN0000017148,2024-05-26T23:01:32,ACC00008182,Payment,1366.69,-1465585.51,USD,Amazon
TXN0000017149,2024-09-01T20:47:53,ACC00003840,Payment,1603.59,-1467189.1,EUR,Online Store
TXN0000017150,2024-07-05T16:25:39,ACC00004120,Transfer,526.98,-1466662.12,GBP,Walmart
TXN0000017151,2024-05-06T11:12:31,ACC00008815,Payment,144.48,-1466806.6,USD,Restaurant
TXN0000017152,2024-01-05T03:34:59,ACC00007093,Debit,1939.65,-1468746.25,GBP,Grocery
TXN0000017153,2024-09-30T23:37:15,ACC00007047,Debit,269.9,-1469016.15,USD,Online Store
TXN0000017154,2024-06-12T13:18:59,ACC00009822,Transfer,151.66,-1468864.49,USD,Target
TXN0000017155,2024-03-08T06:50:27,ACC00005076,Debit,1056.88,-1469921.37,GBP,Online Store
TXN0000017156,2024-04-13T16:16:01,ACC00005968,Debit,1247.19,-1471168.56,USD,Amazon
TXN0000017157,2024-07-09T07:01:58,ACC00008913,ATM,692.72,-1471861.28,JPY,Amazon
TXN0000017158,2024-08-11T22:59:39,ACC00009671,Debit,507.05,-1472368.33,JPY,Restaurant
TXN0000017159,2024-07-20T07:54:42,ACC00008884,ATM,1972.98,-1474341.31,USD,Target
TXN0000017160,2024-03-10T19:51:13,ACC00003682,Debit,1926.65,-1476267.96,EUR,Online Store
TXN0000017161,2024-03-02T05:18:04,ACC00009820,Debit,32.01,-1476299.97,EUR,Online Store
TXN0000017162,2024-08-01T08:49:39,ACC00002570,Debit,957.9,-1477257.87,GBP,Restaurant
TXN0000017163,2024-04-07T11:41:44,ACC00006272,Payment,1470.67,-1478728.54,GBP,Walmart
TXN0000017164,2024-03-26T07:28:19,ACC00007305,Debit,1089.83,-1479818.37,EUR,Target
TXN0000017165,2024-02-20T22:31:06,ACC00009692,Debit,1478.16,-1481296.53,EUR,Starbucks
TXN0000017166,2024-04-16T15:54:28,ACC00003677,Payment,604.67,-1481901.2,EUR,Online Store
TXN0000017167,2024-03-03T18:49:31,ACC00002787,ATM,791.79,-1482692.99,JPY,Restaurant
TXN0000017168,2024-05-16T07:19:33,ACC00005224,Payment,596.45,-1483289.44,USD,Restaurant
TXN0000017169,2024-08-20T12:49:33,ACC00002331,ATM,990.65,-1484280.09,GBP,Shell
TXN0000017170,2024-12-16T13:32:15,ACC00006311,ATM,1936.58,-1486216.67,USD,Target
TXN0000017171,2024-11-29T06:04:50,ACC00006724,Transfer,868.14,-1485348.53,EUR,Shell
TXN0000017172,2024-10-10T06:42:48,ACC00004026,Credit,1673.88,-1483674.65,EUR,Restaurant
TXN0000017173,2024-02-24T18:46:15,ACC00006079,Transfer,1831.52,-1481843.13,JPY,Online Store
TXN0000017174,2024-10-29T08:06:34,ACC00009310,ATM,1502.12,-1483345.25,GBP,Online Store
TXN0000017175,2024-03-03T16:09:29,ACC00003120,ATM,746.99,-1484092.24,JPY,Shell
TXN0000017176,2024-03-24T21:59:48,ACC00002130,ATM,798.01,-1484890.25,EUR,Online Store
TXN0000017177,2024-10-20T01:07:02,ACC00008682,Transfer,490.13,-1484400.12,JPY,Shell
TXN0000017178,2024-09-28T18:34:03,ACC00006203,Payment,1050.7,-1485450.82,EUR,Restaurant
TXN0000017179,2024-06-01T08:30:50,ACC00008526,Credit,1253.92,-1484196.9,EUR,Restaurant
TXN0000017180,2024-10-29T01:49:58,ACC00003640,Debit,935.82,-1485132.72,USD,Walmart
TXN0000017181,2024-02-03T02:54:21,ACC00000393,Credit,1145.55,-1483987.17,USD,Amazon
TXN0000017182,2024-04-20T03:45:49,ACC00004172,Payment,248.51,-1484235.68,JPY,Online Store
TXN0000017183,2024-05-12T12:50:19,ACC00007477,Debit,1774.18,-1486009.86,JPY,Walmart
TXN0000017184,2024-11-02T10:56:37,ACC00005301,Payment,633.72,-1486643.58,USD,Walmart
TXN0000017185,2024-08-17T11:37:37,ACC00009370,Transfer,1222.52,-1485421.06,GBP,Target
TXN0000017186,2024-08-10T02:52:28,ACC00001127,ATM,1912.82,-1487333.88,EUR,Grocery
TXN0000017187,2024-04-10T14:29:55,ACC00009741,ATM,16.83,-1487350.71,JPY,Target
TXN0000017188,2024-01-17T09:33:23,ACC00009915,Debit,326.09,-1487676.8,USD,Grocery
TXN0000017189,2024-09-20T21:51:24,ACC00009934,Transfer,1114.24,-1486562.56,JPY,Walmart
TXN0000017190,2024-09-28T15:28:00,ACC00005172,Payment,1811.97,-1488374.53,JPY,Restaurant
TXN0000017191,2024-12-29T07:46:03,ACC00000952,Transfer,1142.63,-1487231.9,JPY,Amazon
TXN0000017192,2024-10-16T06:51:19,ACC00001255,Debit,1540.05,-1488771.95,USD,Walmart
TXN0000017193,2024-06-25T04:52:26,ACC00005229,Transfer,1226.7,-1487545.25,JPY,Shell
TXN0000017194,2024-02-22T07:33:18,ACC00004359,Transfer,871.6,-1486673.65,USD,Starbucks
TXN0000017195,2024-05-23T06:45:47,ACC00001031,Payment,242.79,-1486916.44,EUR,Shell
TXN0000017196,2024-12-30T13:45:53,ACC00008588,Credit,1820.95,-1485095.49,EUR,Grocery
TXN0000017197,2024-09-13T08:39:18,ACC00008247,Credit,1980.17,-1483115.32,EUR,Restaurant
TXN0000017198,2024-08-22T09:29:35,ACC00003716,Credit,672.67,-1482442.65,USD,Shell
TXN0000017199,2024-05-14T04:03:11,ACC00005629,Payment,545.2,-1482987.85,GBP,Amazon
TXN0000017200,2024-05-03T12:18:41,ACC00003042,Transfer,945.8,-1482042.05,GBP,Grocery
TXN0000017201,2024-06-24T20:22:16,ACC00004566,Payment,1685.08,-1483727.13,EUR,Shell
TXN0000017202,2024-10-25T18:55:15,ACC00004835,Transfer,1086.16,-1482640.97,EUR,Amazon
TXN0000017203,2024-05-14T05:13:25,ACC00000717,Transfer,1785.82,-1480855.15,USD,Online Store
TXN0000017204,2024-08-15T13:47:40,ACC00005067,Debit,1166.11,-1482021.26,JPY,Starbucks
TXN0000017205,2024-02-15T07:02:07,ACC00007037,Payment,1788.96,-1483810.22,JPY,Starbucks
TXN0000017206,2024-09-11T19:33:35,ACC00000606,ATM,1852.5,-1485662.72,EUR,Target
TXN0000017207,2024-11-05T02:36:31,ACC00009903,Debit,1047.7,-1486710.42,EUR,Grocery
TXN0000017208,2024-02-19T05:14:32,ACC00003026,Transfer,793.13,-1485917.29,GBP,Restaurant
TXN0000017209,2024-04-25T10:57:08,ACC00006447,ATM,1134.6,-1487051.89,EUR,Restaurant
TXN0000017210,2024-11-28T03:17:07,ACC00000240,Transfer,847.95,-1486203.94,EUR,Starbucks
TXN0000017211,2024-05-02T14:37:46,ACC00000896,Transfer,305.28,-1485898.66,GBP,Restaurant
TXN0000017212,2024-07-21T23:31:02,ACC00004133,Debit,1387.81,-1487286.47,GBP,Amazon
TXN0000017213,2024-12-23T05:18:44,ACC00009535,ATM,1491.38,-1488777.85,EUR,Restaurant
TXN0000017214,2024-12-24T12:02:45,ACC00003030,ATM,556.87,-1489334.72,GBP,Online Store
TXN0000017215,2024-03-08T11:49:55,ACC00007935,Debit,296.18,-1489630.9,JPY,Restaurant
TXN0000017216,2024-06-23T04:53:09,ACC00003333,ATM,1389.96,-1491020.86,USD,Grocery
TXN0000017217,2024-02-07T03:48:36,ACC00006717,Transfer,44.98,-1490975.88,EUR,Restaurant
TXN0000017218,2024-11-24T08:41:18,ACC00009247,Debit,1057.54,-1492033.42,GBP,Amazon
TXN0000017219,2024-08-06T02:23:34,ACC00007734,Transfer,1090.3,-1490943.12,EUR,Restaurant
TXN0000017220,2024-10-20T02:26:20,ACC00003116,Credit,538.42,-1490404.7,GBP,Starbucks
TXN0000017221,2024-12-25T16:52:25,ACC00007186,ATM,1801.6,-1492206.3,GBP,Grocery
TXN0000017222,2024-05-23T12:58:00,ACC00008761,Debit,1568.75,-1493775.05,EUR,Shell
TXN0000017223,2024-04-13T14:54:39,ACC00005667,Credit,1500.95,-1492274.1,JPY,Walmart
TXN0000017224,2024-09-08T03:26:11,ACC00000941,Debit,1070.1,-1493344.2,EUR,Grocery
TXN0000017225,2024-11-16T18:25:43,ACC00003022,Debit,1720.95,-1495065.15,JPY,Starbucks
TXN0000017226,2024-03-19T22:03:38,ACC00005779,Payment,1340.58,-1496405.73,EUR,Shell
TXN0000017227,2024-04-16T03:47:07,ACC00009225,ATM,1020.06,-1497425.79,EUR,Walmart
TXN0000017228,2024-05-13T22:12:30,ACC00002380,Payment,1495.84,-1498921.63,EUR,Online Store
TXN0000017229,2024-03-04T23:54:12,ACC00005344,Transfer,1241.96,-1497679.67,JPY,Amazon
TXN0000017230,2024-05-27T23:48:25,ACC00001480,Transfer,53.15,-1497626.52,USD,Restaurant
TXN0000017231,2024-03-08T15:52:19,ACC00002078,Transfer,424.9,-1497201.62,USD,Grocery
TXN0000017232,2024-07-29T19:36:09,ACC00005857,Debit,1814.12,-1499015.74,EUR,Shell
TXN0000017233,2024-06-20T06:09:10,ACC00009618,Credit,770.86,-1498244.88,JPY,Restaurant
TXN0000017234,2024-04-01T12:35:37,ACC00007729,Credit,1462.58,-1496782.3,GBP,Amazon
TXN0000017235,2024-10-11T16:33:29,ACC00008988,Transfer,295.23,-1496487.07,JPY,Starbucks
TXN0000017236,2024-02-17T20:34:46,ACC00000505,ATM,1611.45,-1498098.52,GBP,Grocery
TXN0000017237,2024-09-13T23:57:47,ACC00007167,Transfer,520.97,-1497577.55,JPY,Restaurant
TXN0000017238,2024-10-08T21:05:55,ACC00006046,Debit,1413.79,-1498991.34,EUR,Shell
TXN0000017239,2024-11-15T20:08:46,ACC00006400,ATM,239.38,-1499230.72,JPY,Walmart
TXN0000017240,2024-06-18T03:48:34,ACC00000996,Debit,41.79,-1499272.51,USD,Shell
TXN0000017241,2024-04-17T05:13:42,ACC00003142,Debit,1485.86,-1500758.37,USD,Online Store
TXN0000017242,2024-06-23T03:11:45,ACC00005007,Credit,68.24,-1500690.13,EUR,Target
TXN0000017243,2024-10-07T09:07:22,ACC00007662,Transfer,1396.11,-1499294.02,EUR,Starbucks
TXN0000017244,2024-09-19T06:36:10,ACC00001896,ATM,221.38,-1499515.4,GBP,Online Store
TXN0000017245,2024-06-06T00:37:22,ACC00004968,Transfer,1912.55,-1497602.85,USD,Amazon
TXN0000017246,2024-12-02T05:09:07,ACC00002443,Credit,830.42,-1496772.43,JPY,Starbucks
TXN0000017247,2024-04-02T05:39:37,ACC00004105,Debit,712.69,-1497485.12,GBP,Shell
TXN0000017248,2024-09-10T14:11:36,ACC00001688,Credit,1910.32,-1495574.8,USD,Amazon
TXN0000017249,2024-05-29T06:38:41,ACC00000257,ATM,1971.38,-1497546.18,EUR,Target
TXN0000017250,2024-12-17T00:08:47,ACC00004837,ATM,1642.17,-1499188.35,USD,Target
TXN0000017251,2024-06-01T01:08:59,ACC00004008,Debit,1732.49,-1500920.84,USD,Starbucks
TXN0000017252,2024-08-25T13:44:04,ACC00009215,Transfer,1636.19,-1499284.65,GBP,Starbucks
TXN0000017253,2024-05-14T09:54:35,ACC00009529,Payment,1898.33,-1501182.98,GBP,Target
TXN0000017254,2024-05-12T04:21:11,ACC00008072,Transfer,266.29,-1500916.69,EUR,Grocery
TXN0000017255,2024-01-11T07:35:22,ACC00002391,Debit,1205.46,-1502122.15,EUR,Amazon
TXN0000017256,2024-05-16T06:24:43,ACC00008746,ATM,30.88,-1502153.03,USD,Grocery
TXN0000017257,2024-10-21T09:42:19,ACC00002298,Debit,597.82,-1502750.85,EUR,Restaurant
TXN0000017258,2024-05-23T12:16:56,ACC00000850,Transfer,474.43,-1502276.42,EUR,Online Store
TXN0000017259,2024-01-13T21:47:35,ACC00003532,Credit,1332.57,-1500943.85,JPY,Grocery
TXN0000017260,2024-06-19T12:27:35,ACC00002981,Credit,32.65,-1500911.2,JPY,Grocery
TXN0000017261,2024-08-01T09:22:21,ACC00000881,Transfer,612.44,-1500298.76,EUR,Restaurant
TXN0000017262,2024-12-23T08:07:08,ACC00009913,Debit,580.83,-1500879.59,JPY,Amazon
TXN0000017263,2024-03-28T02:36:38,ACC00006062,ATM,1698.48,-1502578.07,JPY,Online Store
TXN0000017264,2024-02-23T05:50:49,ACC00006619,Credit,692.89,-1501885.18,GBP,Restaurant
TXN0000017265,2024-09-07T07:18:46,ACC00009435,Transfer,1176.96,-1500708.22,GBP,Walmart
TXN0000017266,2024-01-03T02:09:29,ACC00004095,ATM,251.63,-1500959.85,EUR,Walmart
TXN0000017267,2024-05-09T01:30:21,ACC00003371,Debit,1667.74,-1502627.59,EUR,Shell
TXN0000017268,2024-11-11T13:15:18,ACC00006914,Debit,984.7,-1503612.29,EUR,Walmart
TXN0000017269,2024-04-12T02:23:59,ACC00004490,Transfer,1810.76,-1501801.53,JPY,Restaurant
TXN0000017270,2024-07-17T03:53:07,ACC00004182,Debit,1332.66,-1503134.19,USD,Starbucks
TXN0000017271,2024-04-23T22:39:49,ACC00001463,Payment,1087.59,-1504221.78,JPY,Starbucks
TXN0000017272,2024-08-12T04:29:15,ACC00005095,Debit,1678.39,-1505900.17,JPY,Target
TXN0000017273,2024-06-28T14:32:27,ACC00001812,ATM,1907.95,-1507808.12,GBP,Target
TXN0000017274,2024-10-05T09:25:40,ACC00002379,Payment,1895.76,-1509703.88,JPY,Starbucks
TXN0000017275,2024-02-17T22:04:53,ACC00007787,Transfer,1770.34,-1507933.54,JPY,Grocery
TXN0000017276,2024-03-27T14:47:42,ACC00006691,Credit,1047.26,-1506886.28,GBP,Walmart
TXN0000017277,2024-02-23T16:28:04,ACC00006338,ATM,1933.55,-1508819.83,EUR,Target
TXN0000017278,2024-08-30T11:57:28,ACC00004386,ATM,141.49,-1508961.32,EUR,Amazon
TXN0000017279,2024-12-14T11:58:57,ACC00000903,Payment,426.9,-1509388.22,EUR,Online Store
TXN0000017280,2024-09-15T00:10:32,ACC00000400,Credit,1140.67,-1508247.55,GBP,Restaurant
TXN0000017281,2024-02-06T23:01:59,ACC00004060,Credit,1380.46,-1506867.09,GBP,Starbucks
TXN0000017282,2024-06-05T17:20:56,ACC00003893,Debit,1201.39,-1508068.48,USD,Walmart
TXN0000017283,2024-09-26T05:42:03,ACC00000745,Credit,1093.78,-1506974.7,USD,Walmart
TXN0000017284,2024-04-17T16:53:50,ACC00005150,Payment,870.26,-1507844.96,EUR,Grocery
TXN0000017285,2024-11-10T11:17:40,ACC00005319,Credit,144.09,-1507700.87,EUR,Restaurant
TXN0000017286,2024-06-30T16:38:02,ACC00009115,Debit,1752.17,-1509453.04,GBP,Restaurant
TXN0000017287,2024-06-07T09:14:37,ACC00004779,Transfer,1416.3,-1508036.74,JPY,Restaurant
TXN0000017288,2024-10-28T11:35:48,ACC00008631,Credit,972.66,-1507064.08,JPY,Grocery
TXN0000017289,2024-03-28T10:57:16,ACC00006661,Transfer,24.17,-1507039.91,JPY,Online Store
TXN0000017290,2024-07-01T02:40:27,ACC00007190,Payment,1555.18,-1508595.09,EUR,Target
TXN0000017291,2024-08-14T01:54:25,ACC00003289,Debit,1374.05,-1509969.14,EUR,Grocery
TXN0000017292,2024-01-03T06:43:56,ACC00002248,Credit,1361.77,-1508607.37,EUR,Walmart
TXN0000017293,2024-04-14T06:48:10,ACC00001800,Credit,1415.22,-1507192.15,JPY,Target
TXN0000017294,2024-03-06T12:46:04,ACC00000513,Credit,782.93,-1506409.22,EUR,Grocery
TXN0000017295,2024-09-03T17:26:45,ACC00001055,Transfer,1825.97,-1504583.25,GBP,Target
TXN0000017296,2024-04-15T17:50:09,ACC00004604,Transfer,110.41,-1504472.84,JPY,Target
TXN0000017297,2024-10-18T15:02:22,ACC00002840,Credit,715.15,-1503757.69,JPY,Walmart
TXN0000017298,2024-10-15T17:21:05,ACC00007030,Debit,1275.27,-1505032.96,USD,Amazon
TXN0000017299,2024-06-04T09:45:47,ACC00004050,Credit,1946.11,-1503086.85,JPY,Target
TXN0000017300,2024-08-11T22:01:23,ACC00000480,Credit,1679.08,-1501407.77,GBP,Shell
TXN0000017301,2024-11-24T19:33:58,ACC00006670,Transfer,979.15,-1500428.62,EUR,Walmart
TXN0000017302,2024-11-08T10:12:17,ACC00009660,Payment,1032.21,-1501460.83,JPY,Restaurant
TXN0000017303,2024-07-03T09:41:35,ACC00009913,Transfer,1300.79,-1500160.04,EUR,Shell
TXN0000017304,2024-06-18T05:06:56,ACC00005331,Transfer,207.32,-1499952.72,EUR,Shell
TXN0000017305,2024-03-17T00:41:40,ACC00006668,Credit,804.28,-1499148.44,USD,Online Store
TXN0000017306,2024-10-14T08:47:01,ACC00004031,ATM,1792.21,-1500940.65,GBP,Starbucks
TXN0000017307,2024-03-16T04:15:31,ACC00005144,ATM,1913.4,-1502854.05,GBP,Online Store
TXN0000017308,2024-04-17T13:42:00,ACC00007670,Debit,548.94,-1503402.99,JPY,Shell
TXN0000017309,2024-12-12T12:01:49,ACC00001267,Debit,145.39,-1503548.38,USD,Amazon
TXN0000017310,2024-10-31T08:17:03,ACC00007535,Transfer,299.65,-1503248.73,JPY,Amazon
TXN0000017311,2024-07-01T22:48:18,ACC00005998,ATM,1487.25,-1504735.98,GBP,Target
TXN0000017312,2024-07-02T00:20:54,ACC00000232,ATM,1093.22,-1505829.2,JPY,Grocery
TXN0000017313,2024-07-01T12:25:21,ACC00005693,ATM,1460.83,-1507290.03,USD,Walmart
TXN0000017314,2024-03-13T09:40:13,ACC00007850,Credit,1891.5,-1505398.53,JPY,Online Store
TXN0000017315,2024-07-25T06:43:10,ACC00004309,Credit,851.19,-1504547.34,EUR,Restaurant
TXN0000017316,2024-12-15T23:16:21,ACC00002654,Credit,293.47,-1504253.87,EUR,Grocery
TXN0000017317,2024-10-18T21:56:31,ACC00005721,Transfer,222.55,-1504031.32,EUR,Grocery
TXN0000017318,2024-01-27T02:59:40,ACC00009668,Credit,349.98,-1503681.34,USD,Restaurant
TXN0000017319,2024-04-18T03:17:09,ACC00007594,Credit,668.27,-1503013.07,EUR,Restaurant
TXN0000017320,2024-04-28T11:51:28,ACC00002773,Debit,1202.13,-1504215.2,GBP,Shell
TXN0000017321,2024-07-18T13:26:26,ACC00004844,Credit,1118.81,-1503096.39,USD,Online Store
TXN0000017322,2024-04-27T16:24:31,ACC00008207,ATM,1005.56,-1504101.95,USD,Amazon
TXN0000017323,2024-08-19T11:33:03,ACC00005459,Payment,1476.0,-1505577.95,GBP,Restaurant
TXN0000017324,2024-12-20T10:11:02,ACC00000055,Debit,1031.78,-1506609.73,EUR,Walmart
TXN0000017325,2024-02-11T07:41:50,ACC00001815,ATM,1678.79,-1508288.52,JPY,Shell
TXN0000017326,2024-08-08T22:10:31,ACC00003659,Payment,1201.85,-1509490.37,EUR,Restaurant
TXN0000017327,2024-10-19T21:44:28,ACC00009145,Debit,934.37,-1510424.74,EUR,Grocery
TXN0000017328,2024-09-21T09:11:32,ACC00008472,Payment,1528.91,-1511953.65,GBP,Amazon
TXN0000017329,2024-03-23T21:27:16,ACC00000583,Debit,1871.48,-1513825.13,GBP,Shell
TXN0000017330,2024-11-15T16:56:22,ACC00006649,Transfer,1799.29,-1512025.84,USD,Walmart
TXN0000017331,2024-06-10T11:06:51,ACC00006747,Payment,694.27,-1512720.11,EUR,Shell
TXN0000017332,2024-08-26T15:33:48,ACC00007639,Transfer,817.55,-1511902.56,JPY,Starbucks
TXN0000017333,2024-01-09T03:12:44,ACC00005000,ATM,1639.28,-1513541.84,EUR,Amazon
TXN0000017334,2024-04-07T02:48:29,ACC00005025,Credit,994.97,-1512546.87,USD,Amazon
TXN0000017335,2024-09-26T07:48:29,ACC00004399,ATM,1845.16,-1514392.03,USD,Amazon
TXN0000017336,2024-02-09T07:48:12,ACC00009245,ATM,1405.91,-1515797.94,GBP,Shell
TXN0000017337,2024-08-20T07:40:43,ACC00001621,Transfer,417.58,-1515380.36,GBP,Grocery
TXN0000017338,2024-11-29T07:20:44,ACC00002298,Credit,1976.1,-1513404.26,EUR,Restaurant
TXN0000017339,2024-05-23T11:45:49,ACC00006457,Payment,1628.28,-1515032.54,GBP,Walmart
TXN0000017340,2024-11-17T08:12:23,ACC00004185,Payment,893.83,-1515926.37,GBP,Amazon
TXN0000017341,2024-07-21T15:27:43,ACC00003692,Credit,690.44,-1515235.93,EUR,Grocery
TXN0000017342,2024-04-23T08:18:29,ACC00002564,Debit,169.75,-1515405.68,EUR,Starbucks
TXN0000017343,2024-12-19T20:33:59,ACC00002114,Payment,672.2,-1516077.88,JPY,Walmart
TXN0000017344,2024-03-09T06:12:17,ACC00000749,ATM,421.58,-1516499.46,USD,Shell
TXN0000017345,2024-02-06T15:15:19,ACC00008401,Payment,1703.55,-1518203.01,GBP,Amazon
TXN0000017346,2024-11-06T06:06:19,ACC00001112,Debit,1997.21,-1520200.22,JPY,Walmart
TXN0000017347,2024-07-28T17:56:17,ACC00002790,Debit,500.53,-1520700.75,JPY,Walmart
TXN0000017348,2024-05-15T20:32:21,ACC00004005,ATM,1763.51,-1522464.26,EUR,Grocery
TXN0000017349,2024-04-01T03:33:24,ACC00006774,Payment,417.85,-1522882.11,EUR,Restaurant
TXN0000017350,2024-07-19T22:51:24,ACC00009672,Payment,1273.37,-1524155.48,USD,Starbucks
TXN0000017351,2024-03-22T00:15:27,ACC00001837,Credit,702.15,-1523453.33,GBP,Grocery
TXN0000017352,2024-07-16T00:33:59,ACC00002453,Debit,1957.77,-1525411.1,GBP,Walmart
TXN0000017353,2024-07-31T13:35:47,ACC00005563,Debit,742.28,-1526153.38,USD,Walmart
TXN0000017354,2024-09-03T07:29:16,ACC00009107,Debit,69.26,-1526222.64,JPY,Restaurant
TXN0000017355,2024-01-29T15:19:05,ACC00002332,Payment,594.09,-1526816.73,EUR,Online Store
TXN0000017356,2024-10-23T05:53:07,ACC00008989,Payment,813.55,-1527630.28,EUR,Starbucks
TXN0000017357,2024-06-22T19:40:12,ACC00000999,Transfer,94.96,-1527535.32,GBP,Grocery
TXN0000017358,2024-01-06T22:35:52,ACC00000236,Debit,637.96,-1528173.28,GBP,Grocery
TXN0000017359,2024-05-15T04:06:27,ACC00006609,Credit,1025.02,-1527148.26,USD,Target
TXN0000017360,2024-01-13T07:04:18,ACC00003210,Payment,97.9,-1527246.16,USD,Shell
TXN0000017361,2024-02-10T23:18:53,ACC00003860,Payment,378.4,-1527624.56,USD,Amazon
TXN0000017362,2024-05-03T00:58:29,ACC00003093,Credit,1055.77,-1526568.79,EUR,Amazon
TXN0000017363,2024-06-01T05:11:46,ACC00007875,Debit,1284.24,-1527853.03,EUR,Walmart
TXN0000017364,2024-10-31T10:50:49,ACC00006431,Debit,116.52,-1527969.55,EUR,Walmart
TXN0000017365,2024-07-24T05:17:24,ACC00000391,Transfer,1900.79,-1526068.76,EUR,Restaurant
TXN0000017366,2024-03-16T03:31:47,ACC00008894,Credit,1307.5,-1524761.26,GBP,Walmart
TXN0000017367,2024-10-03T23:37:53,ACC00000623,Debit,1803.81,-1526565.07,GBP,Grocery
TXN0000017368,2024-01-24T18:29:35,ACC00000594,Credit,1315.34,-1525249.73,USD,Restaurant
TXN0000017369,2024-10-06T01:33:23,ACC00008249,ATM,449.43,-1525699.16,USD,Amazon
TXN0000017370,2024-12-23T02:28:37,ACC00003146,Transfer,1243.99,-1524455.17,EUR,Walmart
TXN0000017371,2024-12-11T19:28:59,ACC00002657,Credit,813.48,-1523641.69,GBP,Amazon
TXN0000017372,2024-07-20T19:53:15,ACC00005702,Debit,1600.46,-1525242.15,JPY,Walmart
TXN0000017373,2024-02-15T06:07:29,ACC00006952,Credit,634.02,-1524608.13,GBP,Amazon
TXN0000017374,2024-08-25T19:03:37,ACC00000824,ATM,353.84,-1524961.97,JPY,Walmart
TXN0000017375,2024-12-29T20:33:21,ACC00009462,Debit,1074.37,-1526036.34,EUR,Starbucks
TXN0000017376,2024-08-27T22:48:17,ACC00008872,ATM,164.69,-1526201.03,JPY,Amazon
TXN0000017377,2024-11-01T21:26:51,ACC00004510,ATM,1779.1,-1527980.13,USD,Amazon
TXN0000017378,2024-06-14T21:57:59,ACC00001138,Payment,913.8,-1528893.93,JPY,Restaurant
TXN0000017379,2024-10-29T03:58:07,ACC00005357,ATM,184.02,-1529077.95,EUR,Amazon
TXN0000017380,2024-05-22T04:29:17,ACC00002221,Credit,1745.76,-1527332.19,GBP,Online Store
TXN0000017381,2024-02-21T13:34:07,ACC00000842,Payment,1420.11,-1528752.3,JPY,Target
TXN0000017382,2024-06-29T10:52:05,ACC00001693,ATM,637.39,-1529389.69,JPY,Restaurant
TXN0000017383,2024-07-29T05:36:53,ACC00006954,Debit,1633.18,-1531022.87,JPY,Walmart
TXN0000017384,2024-08-24T07:28:58,ACC00006290,ATM,438.17,-1531461.04,EUR,Online Store
TXN0000017385,2024-10-13T08:04:25,ACC00003599,Payment,813.46,-1532274.5,USD,Walmart
TXN0000017386,2024-03-14T17:52:35,ACC00007599,Payment,1391.1,-1533665.6,USD,Target
TXN0000017387,2024-05-17T15:13:15,ACC00009926,Credit,1752.6,-1531913.0,EUR,Online Store
TXN0000017388,2024-03-24T07:36:48,ACC00001690,Credit,1790.28,-1530122.72,JPY,Shell
TXN0000017389,2024-03-15T11:34:21,ACC00007542,Payment,1279.06,-1531401.78,GBP,Grocery
TXN0000017390,2024-01-15T19:47:08,ACC00000764,Payment,472.47,-1531874.25,JPY,Grocery
TXN0000017391,2024-06-17T00:47:30,ACC00005580,Transfer,1805.64,-1530068.61,EUR,Grocery
TXN0000017392,2024-06-20T06:02:49,ACC00006618,Credit,1073.43,-1528995.18,EUR,Online Store
TXN0000017393,2024-03-31T16:17:04,ACC00006618,Credit,581.33,-1528413.85,JPY,Target
TXN0000017394,2024-03-24T08:06:40,ACC00000769,Transfer,1086.44,-1527327.41,USD,Amazon
TXN0000017395,2024-05-26T05:09:39,ACC00000007,Credit,870.9,-1526456.51,JPY,Online Store
TXN0000017396,2024-06-28T07:43:03,ACC00009417,Credit,1179.81,-1525276.7,EUR,Walmart
TXN0000017397,2024-04-26T08:35:43,ACC00004984,Transfer,1746.88,-1523529.82,GBP,Shell
TXN0000017398,2024-12-07T13:02:18,ACC00005156,Payment,1103.46,-1524633.28,EUR,Restaurant
TXN0000017399,2024-11-04T02:34:55,ACC00006387,ATM,1165.54,-1525798.82,JPY,Grocery
TXN0000017400,2024-02-20T02:02:58,ACC00002166,Debit,109.19,-1525908.01,GBP,Online Store
TXN0000017401,2024-02-20T11:48:43,ACC00005876,ATM,1309.94,-1527217.95,JPY,Target
TXN0000017402,2024-02-26T18:52:22,ACC00004563,Debit,542.61,-1527760.56,EUR,Grocery
TXN0000017403,2024-08-11T21:54:02,ACC00000347,Transfer,1981.84,-1525778.72,USD,Starbucks
TXN0000017404,2024-04-12T22:59:52,ACC00005232,ATM,1170.5,-1526949.22,USD,Online Store
TXN0000017405,2024-04-01T13:51:01,ACC00003444,Debit,1899.38,-1528848.6,EUR,Starbucks
TXN0000017406,2024-08-05T02:57:10,ACC00007227,Payment,158.86,-1529007.46,GBP,Restaurant
TXN0000017407,2024-04-20T13:06:13,ACC00002190,ATM,362.82,-1529370.28,USD,Online Store
TXN0000017408,2024-06-09T14:35:22,ACC00002694,Debit,359.8,-1529730.08,EUR,Online Store
TXN0000017409,2024-10-09T11:42:21,ACC00009980,Transfer,900.42,-1528829.66,EUR,Target
TXN0000017410,2024-10-14T06:15:40,ACC00006583,Credit,1582.65,-1527247.01,GBP,Shell
TXN0000017411,2024-09-23T03:01:23,ACC00005851,Credit,1477.09,-1525769.92,EUR,Amazon
TXN0000017412,2024-11-12T09:42:09,ACC00005646,Debit,862.58,-1526632.5,JPY,Target
TXN0000017413,2024-05-25T20:14:56,ACC00001749,ATM,195.59,-1526828.09,GBP,Shell
TXN0000017414,2024-08-22T12:24:59,ACC00002602,ATM,1826.97,-1528655.06,EUR,Shell
TXN0000017415,2024-05-17T22:05:14,ACC00009069,Transfer,74.84,-1528580.22,EUR,Online Store
TXN0000017416,2024-10-12T10:52:33,ACC00002985,ATM,783.31,-1529363.53,GBP,Grocery
TXN0000017417,2024-08-16T16:00:27,ACC00007111,ATM,1239.42,-1530602.95,GBP,Restaurant
TXN0000017418,2024-06-22T04:49:24,ACC00007637,ATM,1243.07,-1531846.02,JPY,Starbucks
TXN0000017419,2024-08-10T10:07:20,ACC00008112,Credit,316.1,-1531529.92,GBP,Shell
TXN0000017420,2024-12-15T19:14:46,ACC00008122,Payment,1210.84,-1532740.76,EUR,Target
TXN0000017421,2024-10-06T19:16:16,ACC00007100,Transfer,574.97,-1532165.79,JPY,Shell
TXN0000017422,2024-09-03T22:07:42,ACC00007447,Payment,1952.89,-1534118.68,USD,Restaurant
TXN0000017423,2024-12-04T22:19:01,ACC00005058,Payment,1207.03,-1535325.71,JPY,Target
TXN0000017424,2024-10-10T06:02:53,ACC00004983,Credit,17.14,-1535308.57,USD,Starbucks
TXN0000017425,2024-07-29T16:59:21,ACC00007049,Payment,1323.3,-1536631.87,EUR,Grocery
TXN0000017426,2024-10-20T14:36:47,ACC00007377,Payment,50.16,-1536682.03,GBP,Restaurant
TXN0000017427,2024-10-29T11:30:58,ACC00003854,Transfer,1722.84,-1534959.19,JPY,Starbucks
TXN0000017428,2024-04-06T22:39:02,ACC00007802,Transfer,1618.34,-1533340.85,USD,Walmart
TXN0000017429,2024-09-19T02:28:26,ACC00004138,Transfer,1544.23,-1531796.62,GBP,Online Store
TXN0000017430,2024-06-23T13:26:25,ACC00002698,ATM,1223.66,-1533020.28,JPY,Target
TXN0000017431,2024-08-06T04:12:13,ACC00003252,Payment,118.53,-1533138.81,EUR,Target
TXN0000017432,2024-02-22T01:26:46,ACC00007793,Transfer,1446.74,-1531692.07,EUR,Shell
TXN0000017433,2024-04-06T04:55:50,ACC00009528,Debit,1068.9,-1532760.97,JPY,Shell
TXN0000017434,2024-08-02T11:46:48,ACC00007400,ATM,285.23,-1533046.2,EUR,Shell
TXN0000017435,2024-02-20T15:18:06,ACC00001110,Transfer,1257.75,-1531788.45,EUR,Shell
TXN0000017436,2024-09-11T12:58:34,ACC00006204,ATM,1161.19,-1532949.64,JPY,Amazon
TXN0000017437,2024-07-31T08:44:28,ACC00008622,Credit,354.59,-1532595.05,USD,Amazon
TXN0000017438,2024-06-11T05:07:42,ACC00006383,ATM,1508.62,-1534103.67,EUR,Online Store
TXN0000017439,2024-09-25T17:04:08,ACC00008385,Debit,1120.27,-1535223.94,EUR,Target
TXN0000017440,2024-10-03T12:44:39,ACC00008857,Credit,1059.31,-1534164.63,GBP,Grocery
TXN0000017441,2024-03-28T17:15:21,ACC00001572,ATM,1222.96,-1535387.59,USD,Starbucks
TXN0000017442,2024-03-10T08:51:13,ACC00008884,Transfer,615.74,-1534771.85,EUR,Walmart
TXN0000017443,2024-11-11T00:45:24,ACC00001555,Payment,10.23,-1534782.08,EUR,Online Store
TXN0000017444,2024-09-26T22:55:16,ACC00000556,Payment,305.73,-1535087.81,USD,Target
TXN0000017445,2024-02-22T12:50:55,ACC00000556,Payment,20.99,-1535108.8,GBP,Shell
TXN0000017446,2024-06-01T19:04:54,ACC00009398,Debit,1221.42,-1536330.22,GBP,Amazon
TXN0000017447,2024-06-30T11:14:10,ACC00005541,ATM,1336.82,-1537667.04,JPY,Shell
TXN0000017448,2024-10-23T10:57:39,ACC00000168,ATM,615.9,-1538282.94,EUR,Amazon
TXN0000017449,2024-04-25T08:53:23,ACC00009854,Debit,1437.73,-1539720.67,GBP,Starbucks
TXN0000017450,2024-09-06T19:47:52,ACC00004232,ATM,913.85,-1540634.52,EUR,Online Store
TXN0000017451,2024-06-08T23:43:44,ACC00005639,Payment,1085.47,-1541719.99,JPY,Target
TXN0000017452,2024-11-04T19:15:03,ACC00008189,ATM,1289.7,-1543009.69,JPY,Online Store
TXN0000017453,2024-08-22T09:36:32,ACC00000231,Transfer,757.53,-1542252.16,GBP,Starbucks
TXN0000017454,2024-02-19T13:33:10,ACC00005216,Credit,812.87,-1541439.29,EUR,Target
TXN0000017455,2024-10-22T21:24:03,ACC00009383,Payment,330.04,-1541769.33,JPY,Target
TXN0000017456,2024-03-01T20:32:42,ACC00005094,Debit,1773.12,-1543542.45,USD,Target
TXN0000017457,2024-12-15T17:53:32,ACC00006115,Credit,846.1,-1542696.35,USD,Grocery
TXN0000017458,2024-10-01T12:33:14,ACC00004987,Transfer,1478.03,-1541218.32,USD,Amazon
TXN0000017459,2024-08-05T16:41:13,ACC00004352,Payment,1101.97,-1542320.29,JPY,Grocery
TXN0000017460,2024-11-25T03:06:42,ACC00003298,Transfer,1119.01,-1541201.28,EUR,Grocery
TXN0000017461,2024-11-17T14:57:58,ACC00004880,Debit,734.2,-1541935.48,EUR,Amazon
TXN0000017462,2024-06-23T09:54:33,ACC00002786,Transfer,1800.27,-1540135.21,GBP,Walmart
TXN0000017463,2024-09-07T00:05:01,ACC00008056,ATM,1264.17,-1541399.38,JPY,Grocery
TXN0000017464,2024-12-18T08:08:12,ACC00003728,Debit,817.89,-1542217.27,GBP,Online Store
TXN0000017465,2024-03-28T04:05:00,ACC00003766,ATM,1030.5,-1543247.77,USD,Shell
TXN0000017466,2024-05-23T18:16:48,ACC00003425,Payment,312.83,-1543560.6,GBP,Restaurant
TXN0000017467,2024-08-25T19:17:44,ACC00004522,Credit,1061.22,-1542499.38,EUR,Walmart
TXN0000017468,2024-10-14T01:29:30,ACC00002495,Credit,881.4,-1541617.98,EUR,Restaurant
TXN0000017469,2024-04-16T02:21:12,ACC00003745,Credit,1509.38,-1540108.6,EUR,Starbucks
TXN0000017470,2024-08-18T23:18:39,ACC00001849,ATM,802.57,-1540911.17,GBP,Online Store
TXN0000017471,2024-02-24T09:47:48,ACC00004417,Credit,405.33,-1540505.84,EUR,Grocery
TXN0000017472,2024-07-17T03:40:56,ACC00004742,Payment,456.85,-1540962.69,EUR,Restaurant
TXN0000017473,2024-06-05T08:25:43,ACC00006318,ATM,702.34,-1541665.03,USD,Starbucks
TXN0000017474,2024-09-23T10:58:28,ACC00000223,Credit,1674.02,-1539991.01,USD,Walmart
TXN0000017475,2024-01-22T08:55:43,ACC00001920,Payment,292.37,-1540283.38,USD,Grocery
TXN0000017476,2024-03-04T17:10:54,ACC00008558,Transfer,1373.22,-1538910.16,GBP,Online Store
TXN0000017477,2024-11-08T06:07:43,ACC00006646,Transfer,479.99,-1538430.17,GBP,Online Store
TXN0000017478,2024-11-17T00:17:27,ACC00000290,Debit,1060.39,-1539490.56,JPY,Grocery
TXN0000017479,2024-01-25T22:00:37,ACC00008830,Credit,864.68,-1538625.88,USD,Target
TXN0000017480,2024-06-02T14:38:53,ACC00003534,Credit,770.38,-1537855.5,GBP,Starbucks
TXN0000017481,2024-12-21T23:01:20,ACC00003930,Transfer,1054.12,-1536801.38,JPY,Target
TXN0000017482,2024-10-12T21:27:52,ACC00009496,Debit,916.39,-1537717.77,EUR,Starbucks
TXN0000017483,2024-01-17T15:23:44,ACC00007841,ATM,331.1,-1538048.87,JPY,Amazon
TXN0000017484,2024-06-03T01:26:40,ACC00008739,Debit,1278.31,-1539327.18,EUR,Walmart
TXN0000017485,2024-10-02T09:18:45,ACC00005139,ATM,799.7,-1540126.88,EUR,Restaurant
TXN0000017486,2024-09-03T02:11:27,ACC00000402,Transfer,1617.68,-1538509.2,JPY,Starbucks
TXN0000017487,2024-12-05T11:09:10,ACC00005914,Credit,1187.11,-1537322.09,GBP,Walmart
TXN0000017488,2024-08-10T20:33:09,ACC00001107,Payment,1366.48,-1538688.57,GBP,Restaurant
TXN0000017489,2024-06-28T01:37:27,ACC00001402,Credit,139.57,-1538549.0,GBP,Shell
TXN0000017490,2024-10-01T08:10:40,ACC00008778,Payment,1172.02,-1539721.02,GBP,Amazon
TXN0000017491,2024-03-14T14:34:19,ACC00004488,Debit,893.54,-1540614.56,EUR,Starbucks
TXN0000017492,2024-06-19T05:53:17,ACC00004473,Payment,1248.76,-1541863.32,JPY,Grocery
TXN0000017493,2024-01-02T11:33:10,ACC00006072,Transfer,826.78,-1541036.54,JPY,Walmart
TXN0000017494,2024-02-12T03:28:26,ACC00001949,Debit,729.97,-1541766.51,GBP,Online Store
TXN0000017495,2024-08-11T01:24:42,ACC00008394,Credit,627.48,-1541139.03,JPY,Walmart
TXN0000017496,2024-09-27T05:07:41,ACC00005471,ATM,490.52,-1541629.55,EUR,Target
TXN0000017497,2024-08-17T20:06:25,ACC00005981,Transfer,1911.05,-1539718.5,JPY,Starbucks
TXN0000017498,2024-11-26T16:18:08,ACC00008986,ATM,488.22,-1540206.72,USD,Starbucks
TXN0000017499,2024-03-24T22:21:39,ACC00005071,Debit,826.14,-1541032.86,GBP,Starbucks
TXN0000017500,2024-05-23T00:31:10,ACC00004419,Credit,1915.63,-1539117.23,JPY,Online Store
TXN0000017501,2024-10-15T05:54:51,ACC00004088,Debit,711.25,-1539828.48,GBP,Online Store
TXN0000017502,2024-10-09T18:04:15,ACC00002105,Credit,254.63,-1539573.85,EUR,Walmart
TXN0000017503,2024-02-06T11:49:05,ACC00009695,Credit,1632.67,-1537941.18,GBP,Amazon
TXN0000017504,2024-09-26T11:17:37,ACC00003022,Debit,1429.28,-1539370.46,GBP,Restaurant
TXN0000017505,2024-03-31T05:06:21,ACC00000389,Credit,145.71,-1539224.75,USD,Shell
TXN0000017506,2024-06-24T05:03:51,ACC00006172,Credit,1685.56,-1537539.19,JPY,Target
TXN0000017507,2024-04-02T17:54:29,ACC00005781,ATM,608.02,-1538147.21,USD,Starbucks
TXN0000017508,2024-07-30T23:06:44,ACC00001136,ATM,1383.99,-1539531.2,JPY,Online Store
TXN0000017509,2024-06-13T15:59:44,ACC00009152,Credit,29.06,-1539502.14,GBP,Walmart
TXN0000017510,2024-07-04T21:15:45,ACC00002865,Debit,509.15,-1540011.29,USD,Grocery
TXN0000017511,2024-07-03T07:42:55,ACC00008093,Credit,1480.76,-1538530.53,JPY,Restaurant
TXN0000017512,2024-09-18T13:15:02,ACC00001781,ATM,1471.22,-1540001.75,USD,Amazon
TXN0000017513,2024-06-22T09:11:44,ACC00006265,Payment,1050.7,-1541052.45,GBP,Target
TXN0000017514,2024-08-13T21:08:34,ACC00003900,ATM,874.28,-1541926.73,USD,Shell
TXN0000017515,2024-09-09T10:53:12,ACC00006838,Debit,747.38,-1542674.11,EUR,Starbucks
TXN0000017516,2024-04-25T15:50:31,ACC00006631,Debit,1713.36,-1544387.47,JPY,Restaurant
TXN0000017517,2024-10-19T13:54:09,ACC00003084,ATM,1061.03,-1545448.5,EUR,Shell
TXN0000017518,2024-06-16T06:54:14,ACC00002210,ATM,426.4,-1545874.9,JPY,Amazon
TXN0000017519,2024-06-17T21:13:13,ACC00008097,Debit,945.18,-1546820.08,USD,Starbucks
TXN0000017520,2024-12-12T09:25:44,ACC00006157,Transfer,487.07,-1546333.01,JPY,Starbucks
TXN0000017521,2024-06-30T16:24:08,ACC00004856,Debit,126.28,-1546459.29,JPY,Starbucks
TXN0000017522,2024-05-16T19:04:12,ACC00000346,Payment,1170.38,-1547629.67,JPY,Shell
TXN0000017523,2024-11-14T08:11:54,ACC00004222,ATM,1318.38,-1548948.05,GBP,Walmart
TXN0000017524,2024-08-15T14:14:16,ACC00009432,Debit,1036.79,-1549984.84,EUR,Restaurant
TXN0000017525,2024-09-09T17:02:28,ACC00002044,Transfer,1846.43,-1548138.41,USD,Starbucks
TXN0000017526,2024-08-29T01:00:01,ACC00000709,ATM,953.85,-1549092.26,EUR,Shell
TXN0000017527,2024-08-01T05:20:49,ACC00009916,Payment,852.9,-1549945.16,GBP,Amazon
TXN0000017528,2024-12-29T01:49:24,ACC00001042,Debit,166.57,-1550111.73,GBP,Walmart
TXN0000017529,2024-02-26T16:17:05,ACC00007442,Debit,1511.45,-1551623.18,EUR,Online Store
TXN0000017530,2024-12-13T18:03:31,ACC00003185,Payment,982.75,-1552605.93,GBP,Restaurant
TXN0000017531,2024-06-17T03:52:40,ACC00007647,Credit,517.33,-1552088.6,EUR,Grocery
TXN0000017532,2024-05-07T02:38:23,ACC00004981,Credit,663.39,-1551425.21,JPY,Restaurant
TXN0000017533,2024-06-18T15:58:42,ACC00007624,Credit,784.13,-1550641.08,JPY,Online Store
TXN0000017534,2024-03-22T09:05:44,ACC00000277,Transfer,83.53,-1550557.55,GBP,Walmart
TXN0000017535,2024-10-23T20:47:01,ACC00005484,Transfer,1636.51,-1548921.04,USD,Shell
TXN0000017536,2024-03-27T07:19:56,ACC00002455,Debit,1334.12,-1550255.16,GBP,Grocery
TXN0000017537,2024-01-10T17:37:21,ACC00005958,Credit,1035.53,-1549219.63,USD,Restaurant
TXN0000017538,2024-10-02T04:39:49,ACC00002922,Debit,569.67,-1549789.3,USD,Starbucks
TXN0000017539,2024-01-16T10:22:21,ACC00001204,ATM,613.83,-1550403.13,GBP,Target
TXN0000017540,2024-11-13T08:40:47,ACC00005474,Debit,1143.29,-1551546.42,JPY,Starbucks
TXN0000017541,2024-08-11T13:05:04,ACC00005781,Credit,474.09,-1551072.33,JPY,Online Store
TXN0000017542,2024-06-14T06:13:09,ACC00003936,ATM,302.27,-1551374.6,GBP,Shell
TXN0000017543,2024-12-14T07:29:29,ACC00007253,ATM,850.18,-1552224.78,EUR,Starbucks
TXN0000017544,2024-04-27T17:08:41,ACC00002696,Transfer,1311.44,-1550913.34,EUR,Starbucks
TXN0000017545,2024-02-26T15:46:31,ACC00006835,Payment,572.51,-1551485.85,JPY,Amazon
TXN0000017546,2024-08-07T02:58:52,ACC00005424,Transfer,1096.64,-1550389.21,EUR,Starbucks
TXN0000017547,2024-02-02T08:52:48,ACC00000202,Payment,304.71,-1550693.92,USD,Shell
TXN0000017548,2024-09-16T22:10:11,ACC00001071,ATM,1066.99,-1551760.91,EUR,Target
TXN0000017549,2024-02-17T12:56:26,ACC00009029,Credit,180.24,-1551580.67,GBP,Shell
TXN0000017550,2024-01-24T03:54:28,ACC00001010,Credit,1759.9,-1549820.77,USD,Shell
TXN0000017551,2024-04-15T03:47:08,ACC00008484,Payment,1376.32,-1551197.09,USD,Target
TXN0000017552,2024-02-27T01:39:38,ACC00008531,ATM,1954.71,-1553151.8,USD,Online Store
TXN0000017553,2024-06-24T23:42:34,ACC00001586,Debit,55.22,-1553207.02,GBP,Starbucks
TXN0000017554,2024-01-30T00:53:45,ACC00006317,Transfer,1601.88,-1551605.14,GBP,Walmart
TXN0000017555,2024-11-25T08:05:18,ACC00009123,Debit,1587.56,-1553192.7,USD,Restaurant
TXN0000017556,2024-07-20T14:59:26,ACC00002296,Payment,552.68,-1553745.38,GBP,Starbucks
TXN0000017557,2024-02-06T12:02:29,ACC00000499,Debit,381.98,-1554127.36,EUR,Restaurant
TXN0000017558,2024-02-08T10:46:09,ACC00002610,Credit,388.79,-1553738.57,USD,Target
TXN0000017559,2024-09-27T10:27:55,ACC00005295,Payment,660.89,-1554399.46,EUR,Shell
TXN0000017560,2024-06-05T13:45:08,ACC00008493,ATM,1818.42,-1556217.88,GBP,Restaurant
TXN0000017561,2024-12-21T01:11:28,ACC00009093,Credit,1452.96,-1554764.92,GBP,Walmart
TXN0000017562,2024-02-03T19:48:58,ACC00005721,Credit,985.01,-1553779.91,EUR,Starbucks
TXN0000017563,2024-11-23T21:28:27,ACC00009966,Payment,1723.95,-1555503.86,USD,Walmart
TXN0000017564,2024-02-13T16:14:18,ACC00001199,Debit,1173.85,-1556677.71,EUR,Shell
TXN0000017565,2024-07-19T13:05:40,ACC00005185,ATM,103.58,-1556781.29,GBP,Grocery
TXN0000017566,2024-05-19T17:30:27,ACC00002944,Payment,753.12,-1557534.41,GBP,Walmart
TXN0000017567,2024-11-12T23:53:42,ACC00003322,Debit,1223.46,-1558757.87,GBP,Amazon
TXN0000017568,2024-08-23T13:12:25,ACC00009475,ATM,685.54,-1559443.41,EUR,Starbucks
TXN0000017569,2024-06-06T08:38:34,ACC00003439,Debit,1083.32,-1560526.73,GBP,Amazon
TXN0000017570,2024-10-26T11:42:12,ACC00003052,Debit,434.86,-1560961.59,GBP,Grocery
TXN0000017571,2024-04-19T05:59:32,ACC00003156,Credit,375.38,-1560586.21,GBP,Amazon
TXN0000017572,2024-04-10T23:09:40,ACC00006854,Credit,1940.2,-1558646.01,GBP,Target
TXN0000017573,2024-02-26T14:41:57,ACC00003493,Credit,956.78,-1557689.23,EUR,Online Store
TXN0000017574,2024-12-22T05:47:09,ACC00009845,ATM,1387.6,-1559076.83,GBP,Grocery
TXN0000017575,2024-08-30T20:27:44,ACC00004189,Credit,196.82,-1558880.01,USD,Shell
TXN0000017576,2024-04-04T01:46:03,ACC00008013,Credit,1094.52,-1557785.49,USD,Target
TXN0000017577,2024-08-20T05:38:08,ACC00009661,Transfer,40.0,-1557745.49,GBP,Restaurant
TXN0000017578,2024-07-25T19:29:04,ACC00004504,Debit,935.16,-1558680.65,GBP,Grocery
TXN0000017579,2024-04-12T05:58:47,ACC00000461,Payment,1589.52,-1560270.17,JPY,Grocery
TXN0000017580,2024-12-08T21:17:08,ACC00008063,Payment,1996.9,-1562267.07,EUR,Grocery
TXN0000017581,2024-07-11T08:48:52,ACC00004927,Payment,833.05,-1563100.12,USD,Walmart
TXN0000017582,2024-03-21T14:49:52,ACC00000232,Debit,613.34,-1563713.46,JPY,Online Store
TXN0000017583,2024-12-07T18:14:58,ACC00009847,Transfer,1480.11,-1562233.35,JPY,Grocery
TXN0000017584,2024-12-21T10:33:42,ACC00008799,Credit,729.89,-1561503.46,EUR,Grocery
TXN0000017585,2024-12-14T00:06:34,ACC00003685,Transfer,1769.47,-1559733.99,GBP,Grocery
TXN0000017586,2024-09-29T18:46:37,ACC00009010,Payment,138.91,-1559872.9,JPY,Grocery
TXN0000017587,2024-01-08T09:19:23,ACC00005350,Debit,1633.58,-1561506.48,GBP,Grocery
TXN0000017588,2024-08-24T07:20:42,ACC00006757,Credit,39.24,-1561467.24,EUR,Amazon
TXN0000017589,2024-03-14T15:32:08,ACC00002525,Debit,314.21,-1561781.45,EUR,Grocery
TXN0000017590,2024-08-23T10:46:37,ACC00009053,Debit,1171.54,-1562952.99,USD,Walmart
TXN0000017591,2024-08-06T10:11:16,ACC00006623,Debit,333.93,-1563286.92,GBP,Grocery
TXN0000017592,2024-12-10T00:28:10,ACC00000799,Credit,1530.37,-1561756.55,GBP,Grocery
TXN0000017593,2024-08-22T18:11:28,ACC00008844,Credit,1737.0,-1560019.55,JPY,Restaurant
TXN0000017594,2024-03-16T19:55:55,ACC00007986,ATM,1982.82,-1562002.37,EUR,Target
TXN0000017595,2024-09-23T04:34:23,ACC00003088,Transfer,506.79,-1561495.58,USD,Amazon
TXN0000017596,2024-04-18T13:03:16,ACC00000678,Payment,1658.7,-1563154.28,EUR,Shell
TXN0000017597,2024-03-27T19:04:46,ACC00009379,Payment,157.33,-1563311.61,JPY,Shell
TXN0000017598,2024-08-17T21:41:18,ACC00008112,Transfer,1197.64,-1562113.97,USD,Grocery
TXN0000017599,2024-12-05T03:23:10,ACC00009984,Payment,1703.28,-1563817.25,GBP,Amazon
TXN0000017600,2024-07-20T17:36:55,ACC00003325,Debit,940.78,-1564758.03,USD,Target
TXN0000017601,2024-10-18T17:28:50,ACC00002129,Credit,522.48,-1564235.55,EUR,Target
TXN0000017602,2024-11-19T18:56:16,ACC00003690,Debit,1768.93,-1566004.48,USD,Shell
TXN0000017603,2024-09-22T04:02:38,ACC00000368,Credit,485.42,-1565519.06,GBP,Shell
TXN0000017604,2024-11-27T06:32:37,ACC00006390,Transfer,1357.94,-1564161.12,JPY,Shell
TXN0000017605,2024-07-24T20:41:31,ACC00008767,Debit,606.51,-1564767.63,USD,Restaurant
TXN0000017606,2024-11-16T14:57:15,ACC00005260,Payment,1052.01,-1565819.64,JPY,Starbucks
TXN0000017607,2024-09-28T00:20:44,ACC00000606,Credit,395.13,-1565424.51,GBP,Amazon
TXN0000017608,2024-12-01T21:58:12,ACC00005041,Credit,678.58,-1564745.93,EUR,Grocery
TXN0000017609,2024-07-26T12:56:02,ACC00001905,Credit,590.81,-1564155.12,EUR,Grocery
TXN0000017610,2024-11-17T16:39:54,ACC00007178,ATM,1782.07,-1565937.19,EUR,Walmart
TXN0000017611,2024-06-17T19:50:07,ACC00009445,Debit,1822.18,-1567759.37,USD,Restaurant
TXN0000017612,2024-12-19T22:57:46,ACC00001721,Payment,1926.07,-1569685.44,EUR,Target
TXN0000017613,2024-04-21T07:40:01,ACC00006122,Transfer,66.2,-1569619.24,EUR,Grocery
TXN0000017614,2024-11-03T05:53:54,ACC00000914,Credit,1492.29,-1568126.95,USD,Grocery
TXN0000017615,2024-10-12T06:43:12,ACC00000024,Payment,1187.68,-1569314.63,EUR,Restaurant
TXN0000017616,2024-05-14T00:58:06,ACC00006132,Debit,1223.14,-1570537.77,JPY,Walmart
TXN0000017617,2024-01-31T12:36:26,ACC00004540,Transfer,480.92,-1570056.85,GBP,Starbucks
TXN0000017618,2024-08-29T11:18:19,ACC00001556,Payment,1023.2,-1571080.05,EUR,Starbucks
TXN0000017619,2024-08-04T07:02:03,ACC00007803,Transfer,811.76,-1570268.29,GBP,Shell
TXN0000017620,2024-05-10T05:58:33,ACC00000980,Payment,386.16,-1570654.45,USD,Online Store
TXN0000017621,2024-09-28T09:31:46,ACC00002440,Debit,851.0,-1571505.45,EUR,Shell
TXN0000017622,2024-08-04T19:57:22,ACC00007941,Debit,132.1,-1571637.55,USD,Target
TXN0000017623,2024-11-03T22:39:24,ACC00005562,ATM,1029.36,-1572666.91,EUR,Online Store
TXN0000017624,2024-03-28T02:57:56,ACC00001672,Credit,1225.16,-1571441.75,JPY,Online Store
TXN0000017625,2024-07-21T17:40:46,ACC00006451,Transfer,1729.39,-1569712.36,USD,Amazon
TXN0000017626,2024-08-01T09:40:36,ACC00007169,Credit,1409.48,-1568302.88,EUR,Online Store
TXN0000017627,2024-09-30T16:02:04,ACC00000794,Debit,123.53,-1568426.41,USD,Restaurant
TXN0000017628,2024-10-17T09:28:09,ACC00009125,Credit,465.81,-1567960.6,USD,Online Store
TXN0000017629,2024-05-15T10:21:32,ACC00004911,Transfer,930.24,-1567030.36,JPY,Amazon
TXN0000017630,2024-03-13T16:45:48,ACC00008493,Credit,1272.14,-1565758.22,EUR,Shell
TXN0000017631,2024-03-11T07:28:29,ACC00008212,Debit,40.78,-1565799.0,USD,Starbucks
TXN0000017632,2024-11-16T17:54:28,ACC00000471,Debit,460.88,-1566259.88,JPY,Amazon
TXN0000017633,2024-04-25T12:55:31,ACC00004665,Transfer,1685.87,-1564574.01,USD,Grocery
TXN0000017634,2024-07-02T11:45:06,ACC00005286,Transfer,1577.83,-1562996.18,EUR,Restaurant
TXN0000017635,2024-07-29T08:07:46,ACC00008882,ATM,1474.57,-1564470.75,EUR,Shell
TXN0000017636,2024-08-06T05:13:38,ACC00003053,ATM,836.66,-1565307.41,EUR,Target
TXN0000017637,2024-12-06T16:24:56,ACC00005283,Credit,1848.85,-1563458.56,GBP,Grocery
TXN0000017638,2024-09-29T00:59:52,ACC00005199,Transfer,1072.58,-1562385.98,GBP,Online Store
TXN0000017639,2024-05-22T11:45:44,ACC00009755,Payment,495.94,-1562881.92,EUR,Starbucks
TXN0000017640,2024-12-30T23:24:40,ACC00000762,Credit,327.73,-1562554.19,JPY,Shell
TXN0000017641,2024-01-07T09:30:33,ACC00001214,Debit,795.64,-1563349.83,EUR,Shell
TXN0000017642,2024-11-05T13:56:44,ACC00002690,Payment,1977.01,-1565326.84,JPY,Amazon
TXN0000017643,2024-11-17T15:29:41,ACC00004747,Transfer,1663.77,-1563663.07,GBP,Walmart
TXN0000017644,2024-06-15T16:52:46,ACC00001650,ATM,1113.65,-1564776.72,JPY,Amazon
TXN0000017645,2024-03-21T22:15:15,ACC00004757,Credit,1173.9,-1563602.82,USD,Amazon
TXN0000017646,2024-03-14T12:39:39,ACC00006065,ATM,218.56,-1563821.38,JPY,Target
TXN0000017647,2024-08-17T18:23:34,ACC00005318,Payment,1895.99,-1565717.37,JPY,Online Store
TXN0000017648,2024-05-31T00:13:45,ACC00007948,ATM,141.78,-1565859.15,GBP,Target
TXN0000017649,2024-02-24T21:14:21,ACC00003209,Payment,978.27,-1566837.42,GBP,Online Store
TXN0000017650,2024-02-06T18:48:25,ACC00005083,ATM,817.47,-1567654.89,USD,Amazon
TXN0000017651,2024-03-10T23:32:54,ACC00008907,Transfer,688.47,-1566966.42,USD,Grocery
TXN0000017652,2024-06-26T19:21:36,ACC00007148,ATM,969.07,-1567935.49,GBP,Shell
TXN0000017653,2024-10-31T06:54:27,ACC00007761,Credit,692.51,-1567242.98,USD,Restaurant
TXN0000017654,2024-02-14T03:24:38,ACC00007204,Credit,27.8,-1567215.18,JPY,Grocery
TXN0000017655,2024-09-17T02:21:23,ACC00006869,Transfer,1469.35,-1565745.83,USD,Grocery
TXN0000017656,2024-07-06T06:33:36,ACC00000177,Transfer,1246.12,-1564499.71,USD,Grocery
TXN0000017657,2024-07-08T20:38:10,ACC00001035,Credit,97.06,-1564402.65,JPY,Amazon
TXN0000017658,2024-07-08T08:04:48,ACC00006730,Transfer,893.76,-1563508.89,JPY,Shell
TXN0000017659,2024-06-25T16:27:59,ACC00005727,Payment,1462.83,-1564971.72,EUR,Amazon
TXN0000017660,2024-06-17T22:27:52,ACC00005837,ATM,151.37,-1565123.09,USD,Amazon
TXN0000017661,2024-08-25T20:36:24,ACC00008145,Debit,236.08,-1565359.17,JPY,Starbucks
TXN0000017662,2024-03-19T18:18:50,ACC00000892,Transfer,938.35,-1564420.82,USD,Target
TXN0000017663,2024-03-24T17:23:38,ACC00000270,Credit,1670.2,-1562750.62,GBP,Online Store
TXN0000017664,2024-10-12T15:36:10,ACC00007732,Transfer,568.83,-1562181.79,GBP,Amazon
TXN0000017665,2024-12-13T00:35:37,ACC00004285,Payment,1262.67,-1563444.46,EUR,Grocery
TXN0000017666,2024-09-11T18:37:16,ACC00002330,Payment,1131.61,-1564576.07,GBP,Grocery
TXN0000017667,2024-03-30T00:14:15,ACC00001629,Credit,1718.63,-1562857.44,JPY,Target
TXN0000017668,2024-12-08T18:06:20,ACC00006407,Debit,1956.89,-1564814.33,GBP,Shell
TXN0000017669,2024-01-21T06:31:07,ACC00008599,Payment,664.0,-1565478.33,EUR,Walmart
TXN0000017670,2024-12-06T19:16:05,ACC00008813,Transfer,1794.47,-1563683.86,EUR,Starbucks
TXN0000017671,2024-04-02T13:16:05,ACC00003415,Payment,523.74,-1564207.6,USD,Target
TXN0000017672,2024-11-11T13:20:26,ACC00008903,Credit,1147.22,-1563060.38,GBP,Target
TXN0000017673,2024-10-28T22:48:24,ACC00004293,ATM,1684.49,-1564744.87,EUR,Grocery
TXN0000017674,2024-03-24T09:22:06,ACC00001577,Credit,500.14,-1564244.73,GBP,Amazon
TXN0000017675,2024-10-02T00:54:28,ACC00006713,ATM,927.26,-1565171.99,JPY,Amazon
TXN0000017676,2024-11-25T04:59:21,ACC00007776,Transfer,1696.7,-1563475.29,JPY,Grocery
TXN0000017677,2024-05-12T06:46:12,ACC00009604,Payment,1420.26,-1564895.55,JPY,Amazon
TXN0000017678,2024-09-22T10:53:53,ACC00002002,ATM,527.59,-1565423.14,GBP,Restaurant
TXN0000017679,2024-07-18T19:09:35,ACC00006494,ATM,1104.0,-1566527.14,GBP,Walmart
TXN0000017680,2024-06-22T19:53:03,ACC00001777,Payment,967.27,-1567494.41,GBP,Walmart
TXN0000017681,2024-07-05T06:46:38,ACC00006503,Transfer,1341.54,-1566152.87,GBP,Shell
TXN0000017682,2024-02-09T19:39:03,ACC00001551,Transfer,1256.01,-1564896.86,JPY,Shell
TXN0000017683,2024-12-18T17:45:42,ACC00008905,Payment,403.69,-1565300.55,USD,Starbucks
TXN0000017684,2024-02-18T09:44:34,ACC00009648,Payment,104.7,-1565405.25,JPY,Grocery
TXN0000017685,2024-01-27T22:22:23,ACC00006366,Credit,338.92,-1565066.33,USD,Walmart
TXN0000017686,2024-06-12T18:29:04,ACC00000147,Payment,168.38,-1565234.71,USD,Shell
TXN0000017687,2024-01-06T20:10:53,ACC00000649,Payment,1892.86,-1567127.57,JPY,Starbucks
TXN0000017688,2024-10-19T09:43:03,ACC00006187,Debit,932.0,-1568059.57,USD,Amazon
TXN0000017689,2024-11-08T02:41:38,ACC00002901,ATM,1356.49,-1569416.06,GBP,Grocery
TXN0000017690,2024-01-12T11:36:05,ACC00005089,Transfer,833.09,-1568582.97,JPY,Amazon
TXN0000017691,2024-01-07T04:54:55,ACC00008662,Debit,205.28,-1568788.25,GBP,Target
TXN0000017692,2024-01-11T20:40:31,ACC00007116,Payment,1649.34,-1570437.59,USD,Online Store
TXN0000017693,2024-11-27T01:55:01,ACC00003143,Debit,335.05,-1570772.64,USD,Target
TXN0000017694,2024-10-20T18:31:48,ACC00008338,Credit,894.49,-1569878.15,JPY,Restaurant
TXN0000017695,2024-02-25T06:35:59,ACC00002644,Payment,420.72,-1570298.87,USD,Shell
TXN0000017696,2024-07-23T12:50:37,ACC00004115,Debit,1568.07,-1571866.94,GBP,Target
TXN0000017697,2024-09-07T06:25:43,ACC00004046,Credit,900.51,-1570966.43,USD,Amazon
TXN0000017698,2024-03-24T13:38:56,ACC00009339,Debit,1994.87,-1572961.3,EUR,Restaurant
TXN0000017699,2024-06-09T15:59:34,ACC00007906,ATM,233.24,-1573194.54,USD,Amazon
TXN0000017700,2024-02-08T21:39:16,ACC00007406,Transfer,124.44,-1573070.1,USD,Target
TXN0000017701,2024-11-21T00:43:09,ACC00008622,Debit,775.58,-1573845.68,EUR,Shell
TXN0000017702,2024-09-11T22:43:41,ACC00006210,Transfer,1234.36,-1572611.32,USD,Restaurant
TXN0000017703,2024-08-17T18:33:51,ACC00007537,Credit,102.87,-1572508.45,JPY,Grocery
TXN0000017704,2024-01-18T23:06:09,ACC00004896,Transfer,860.39,-1571648.06,JPY,Grocery
TXN0000017705,2024-07-20T11:15:06,ACC00007593,Credit,823.28,-1570824.78,USD,Online Store
TXN0000017706,2024-02-06T14:53:04,ACC00009531,Debit,1887.61,-1572712.39,USD,Starbucks
TXN0000017707,2024-12-08T04:11:31,ACC00008820,ATM,1296.4,-1574008.79,EUR,Target
TXN0000017708,2024-10-16T11:22:26,ACC00008638,Credit,1753.46,-1572255.33,JPY,Restaurant
TXN0000017709,2024-10-17T04:57:49,ACC00007258,ATM,1711.26,-1573966.59,EUR,Amazon
TXN0000017710,2024-08-02T20:44:29,ACC00000008,Credit,805.41,-1573161.18,USD,Shell
TXN0000017711,2024-10-16T15:05:52,ACC00000756,Transfer,200.99,-1572960.19,EUR,Target
TXN0000017712,2024-04-24T08:34:07,ACC00009893,Payment,443.7,-1573403.89,USD,Amazon
TXN0000017713,2024-05-20T03:49:36,ACC00006612,ATM,81.89,-1573485.78,EUR,Amazon
TXN0000017714,2024-12-18T06:55:00,ACC00005756,Credit,522.0,-1572963.78,GBP,Walmart
TXN0000017715,2024-08-10T04:29:28,ACC00000766,Transfer,315.49,-1572648.29,JPY,Shell
TXN0000017716,2024-02-22T16:14:45,ACC00004782,ATM,966.97,-1573615.26,EUR,Target
TXN0000017717,2024-07-16T04:08:48,ACC00000283,Credit,1709.04,-1571906.22,EUR,Shell
TXN0000017718,2024-06-03T23:54:50,ACC00009005,Debit,1615.77,-1573521.99,JPY,Restaurant
TXN0000017719,2024-06-05T06:38:21,ACC00006468,Debit,738.46,-1574260.45,JPY,Target
TXN0000017720,2024-07-28T14:11:38,ACC00009551,ATM,668.81,-1574929.26,USD,Amazon
TXN0000017721,2024-01-01T16:24:23,ACC00001941,Transfer,747.63,-1574181.63,USD,Restaurant
TXN0000017722,2024-08-28T22:19:14,ACC00007822,ATM,1082.17,-1575263.8,JPY,Online Store
TXN0000017723,2024-01-07T11:38:35,ACC00007065,Transfer,231.07,-1575032.73,GBP,Starbucks
TXN0000017724,2024-07-20T12:50:54,ACC00001688,Payment,589.67,-1575622.4,GBP,Starbucks
TXN0000017725,2024-11-22T09:31:12,ACC00000245,Payment,1158.18,-1576780.58,USD,Shell
TXN0000017726,2024-10-31T05:52:33,ACC00003504,ATM,1711.8,-1578492.38,EUR,Grocery
TXN0000017727,2024-05-29T04:30:03,ACC00005879,ATM,178.4,-1578670.78,GBP,Online Store
TXN0000017728,2024-09-08T20:19:52,ACC00006898,Transfer,650.76,-1578020.02,GBP,Walmart
TXN0000017729,2024-06-06T01:29:27,ACC00009254,ATM,310.41,-1578330.43,EUR,Walmart
TXN0000017730,2024-03-01T08:40:06,ACC00003480,Debit,63.89,-1578394.32,GBP,Starbucks
TXN0000017731,2024-05-14T19:55:08,ACC00009446,Credit,863.62,-1577530.7,GBP,Grocery
TXN0000017732,2024-08-18T22:59:19,ACC00005667,ATM,717.43,-1578248.13,GBP,Online Store
TXN0000017733,2024-02-05T13:17:09,ACC00004639,Transfer,728.37,-1577519.76,EUR,Online Store
TXN0000017734,2024-10-25T18:46:06,ACC00005058,Credit,1378.79,-1576140.97,USD,Restaurant
TXN0000017735,2024-02-04T07:37:46,ACC00005764,Credit,1779.36,-1574361.61,JPY,Starbucks
TXN0000017736,2024-11-24T00:06:07,ACC00002432,Debit,247.78,-1574609.39,GBP,Starbucks
TXN0000017737,2024-07-21T13:59:02,ACC00007824,ATM,502.79,-1575112.18,EUR,Shell
TXN0000017738,2024-08-21T22:18:06,ACC00003980,Credit,471.61,-1574640.57,GBP,Starbucks
TXN0000017739,2024-12-20T21:50:11,ACC00006787,Credit,376.68,-1574263.89,JPY,Online Store
TXN0000017740,2024-12-28T01:47:21,ACC00005168,Debit,1165.36,-1575429.25,JPY,Target
TXN0000017741,2024-11-19T20:27:50,ACC00000028,Payment,990.13,-1576419.38,JPY,Walmart
TXN0000017742,2024-07-25T01:45:03,ACC00000786,Payment,1060.59,-1577479.97,JPY,Walmart
TXN0000017743,2024-12-03T06:57:39,ACC00003138,Payment,117.17,-1577597.14,EUR,Walmart
TXN0000017744,2024-05-08T03:12:03,ACC00009988,Debit,982.68,-1578579.82,JPY,Starbucks
TXN0000017745,2024-05-09T20:32:09,ACC00003195,Credit,1504.04,-1577075.78,EUR,Amazon
TXN0000017746,2024-12-03T11:25:40,ACC00006255,Payment,481.61,-1577557.39,USD,Target
TXN0000017747,2024-06-22T03:53:35,ACC00008283,Transfer,1125.55,-1576431.84,EUR,Target
TXN0000017748,2024-12-28T12:48:14,ACC00004059,Debit,1591.93,-1578023.77,JPY,Grocery
TXN0000017749,2024-06-28T09:47:33,ACC00007893,ATM,1037.8,-1579061.57,JPY,Starbucks
TXN0000017750,2024-08-27T18:39:34,ACC00003364,Payment,813.5,-1579875.07,EUR,Online Store
TXN0000017751,2024-06-27T21:12:14,ACC00009608,Transfer,1057.43,-1578817.64,JPY,Walmart
TXN0000017752,2024-05-11T08:25:11,ACC00002369,ATM,73.61,-1578891.25,JPY,Target
TXN0000017753,2024-09-12T10:04:45,ACC00007326,Transfer,971.05,-1577920.2,JPY,Target
TXN0000017754,2024-03-26T20:43:23,ACC00000809,ATM,560.91,-1578481.11,USD,Amazon
TXN0000017755,2024-08-20T12:45:37,ACC00002741,Credit,799.73,-1577681.38,EUR,Starbucks
TXN0000017756,2024-06-16T10:02:16,ACC00004730,Payment,160.61,-1577841.99,USD,Amazon
TXN0000017757,2024-10-29T05:42:17,ACC00009647,Debit,1859.16,-1579701.15,USD,Amazon
TXN0000017758,2024-06-13T07:18:08,ACC00001859,Credit,411.31,-1579289.84,JPY,Starbucks
TXN0000017759,2024-12-21T14:03:43,ACC00005606,Debit,974.8,-1580264.64,USD,Grocery
TXN0000017760,2024-09-09T06:44:20,ACC00002061,Payment,1479.16,-1581743.8,USD,Online Store
TXN0000017761,2024-11-28T15:34:00,ACC00003280,Transfer,1939.17,-1579804.63,GBP,Starbucks
TXN0000017762,2024-02-05T23:50:29,ACC00002430,Payment,241.38,-1580046.01,EUR,Walmart
TXN0000017763,2024-07-31T11:45:09,ACC00005134,Transfer,533.17,-1579512.84,USD,Grocery
TXN0000017764,2024-09-22T12:03:30,ACC00000554,Debit,1905.58,-1581418.42,JPY,Shell
TXN0000017765,2024-02-17T03:10:13,ACC00003668,Transfer,546.55,-1580871.87,USD,Online Store
TXN0000017766,2024-08-22T19:10:24,ACC00006342,Transfer,1932.79,-1578939.08,JPY,Restaurant
TXN0000017767,2024-08-04T21:59:04,ACC00001360,Debit,1086.52,-1580025.6,GBP,Target
TXN0000017768,2024-06-09T03:16:19,ACC00000807,ATM,896.73,-1580922.33,GBP,Starbucks
TXN0000017769,2024-11-13T14:34:49,ACC00004058,Payment,28.83,-1580951.16,USD,Grocery
TXN0000017770,2024-07-07T23:09:28,ACC00002052,Transfer,650.17,-1580300.99,JPY,Amazon
TXN0000017771,2024-11-29T16:59:18,ACC00000320,Payment,297.46,-1580598.45,USD,Amazon
TXN0000017772,2024-09-22T01:26:59,ACC00000581,Payment,1820.8,-1582419.25,EUR,Walmart
TXN0000017773,2024-02-10T22:48:07,ACC00003973,Credit,1426.55,-1580992.7,GBP,Amazon
TXN0000017774,2024-05-26T05:04:23,ACC00000761,Payment,1691.34,-1582684.04,USD,Grocery
TXN0000017775,2024-09-10T05:16:57,ACC00000563,Credit,705.75,-1581978.29,USD,Target
TXN0000017776,2024-05-01T23:29:36,ACC00000435,Debit,446.65,-1582424.94,JPY,Grocery
TXN0000017777,2024-01-20T04:38:14,ACC00008164,Payment,690.36,-1583115.3,GBP,Online Store
TXN0000017778,2024-03-08T17:59:47,ACC00009307,Debit,689.33,-1583804.63,USD,Target
TXN0000017779,2024-09-24T15:19:44,ACC00003242,Credit,1660.0,-1582144.63,USD,Shell
TXN0000017780,2024-09-18T10:25:05,ACC00007193,Credit,821.64,-1581322.99,GBP,Shell
TXN0000017781,2024-09-25T18:30:31,ACC00001395,Payment,1952.93,-1583275.92,JPY,Grocery
TXN0000017782,2024-10-18T17:29:10,ACC00005880,Transfer,1483.69,-1581792.23,USD,Starbucks
TXN0000017783,2024-10-30T23:54:04,ACC00007567,Debit,412.0,-1582204.23,GBP,Target
TXN0000017784,2024-01-21T23:22:26,ACC00006951,ATM,730.24,-1582934.47,GBP,Walmart
TXN0000017785,2024-11-30T16:28:10,ACC00002258,ATM,874.5,-1583808.97,JPY,Target
TXN0000017786,2024-06-08T21:05:41,ACC00002099,Transfer,439.28,-1583369.69,GBP,Online Store
TXN0000017787,2024-07-03T03:56:25,ACC00009883,Credit,1007.59,-1582362.1,USD,Shell
TXN0000017788,2024-12-19T20:55:39,ACC00007035,ATM,197.58,-1582559.68,GBP,Amazon
TXN0000017789,2024-09-07T22:05:11,ACC00006781,Debit,358.46,-1582918.14,EUR,Restaurant
TXN0000017790,2024-02-05T18:31:32,ACC00003872,Credit,1639.55,-1581278.59,EUR,Target
TXN0000017791,2024-04-23T13:03:13,ACC00007924,Credit,350.1,-1580928.49,GBP,Starbucks
TXN0000017792,2024-05-20T10:25:44,ACC00000119,Debit,1438.37,-1582366.86,JPY,Amazon
TXN0000017793,2024-12-28T21:08:18,ACC00002693,Credit,1904.52,-1580462.34,USD,Target
TXN0000017794,2024-01-23T23:02:13,ACC00004432,Debit,724.19,-1581186.53,USD,Target
TXN0000017795,2024-06-04T23:49:51,ACC00009279,ATM,1015.0,-1582201.53,JPY,Walmart
TXN0000017796,2024-05-30T14:31:53,ACC00004144,Debit,1847.15,-1584048.68,USD,Online Store
TXN0000017797,2024-05-05T21:27:09,ACC00008472,Debit,147.47,-1584196.15,USD,Target
TXN0000017798,2024-06-02T00:31:14,ACC00009618,Transfer,1412.98,-1582783.17,GBP,Online Store
TXN0000017799,2024-01-16T22:39:08,ACC00000604,Credit,1942.75,-1580840.42,GBP,Grocery
TXN0000017800,2024-09-16T05:05:05,ACC00004350,Payment,794.69,-1581635.11,GBP,Online Store
TXN0000017801,2024-08-05T00:12:49,ACC00009478,ATM,1096.02,-1582731.13,EUR,Shell
TXN0000017802,2024-01-17T15:16:20,ACC00006903,Credit,1681.5,-1581049.63,USD,Starbucks
TXN0000017803,2024-05-29T16:01:47,ACC00004777,Payment,107.11,-1581156.74,GBP,Grocery
TXN0000017804,2024-10-02T15:11:40,ACC00000218,ATM,427.34,-1581584.08,GBP,Target
TXN0000017805,2024-08-26T10:44:12,ACC00004557,Transfer,393.83,-1581190.25,JPY,Amazon
TXN0000017806,2024-06-22T14:06:25,ACC00008208,Transfer,115.61,-1581074.64,GBP,Grocery
TXN0000017807,2024-05-13T15:27:31,ACC00006681,Payment,263.17,-1581337.81,GBP,Walmart
TXN0000017808,2024-03-06T17:38:14,ACC00007827,Debit,1545.67,-1582883.48,JPY,Target
TXN0000017809,2024-03-08T14:35:03,ACC00007711,Transfer,1093.99,-1581789.49,EUR,Shell
TXN0000017810,2024-09-05T09:52:18,ACC00005634,Debit,957.87,-1582747.36,EUR,Restaurant
TXN0000017811,2024-05-22T11:10:59,ACC00008146,Transfer,264.29,-1582483.07,GBP,Grocery
TXN0000017812,2024-08-03T02:08:48,ACC00000012,Payment,105.08,-1582588.15,EUR,Target
TXN0000017813,2024-05-30T03:54:47,ACC00001879,Credit,784.93,-1581803.22,GBP,Online Store
TXN0000017814,2024-09-25T13:33:40,ACC00004650,Credit,1401.9,-1580401.32,USD,Amazon
TXN0000017815,2024-08-28T14:44:24,ACC00008596,Credit,1215.06,-1579186.26,JPY,Target
TXN0000017816,2024-06-27T00:56:12,ACC00002322,Transfer,1341.83,-1577844.43,JPY,Walmart
TXN0000017817,2024-01-18T10:13:38,ACC00006747,Transfer,1828.25,-1576016.18,USD,Restaurant
TXN0000017818,2024-04-20T22:40:27,ACC00005669,Payment,1483.16,-1577499.34,GBP,Shell
TXN0000017819,2024-06-13T22:02:13,ACC00006122,Credit,398.54,-1577100.8,USD,Online Store
TXN0000017820,2024-04-07T08:56:35,ACC00006313,Payment,988.98,-1578089.78,GBP,Target
TXN0000017821,2024-06-10T15:39:04,ACC00008179,Transfer,1520.77,-1576569.01,USD,Grocery
TXN0000017822,2024-12-23T11:11:27,ACC00005464,Credit,683.8,-1575885.21,EUR,Grocery
TXN0000017823,2024-03-20T08:11:33,ACC00002528,Debit,1134.88,-1577020.09,GBP,Online Store
TXN0000017824,2024-08-14T10:46:24,ACC00001668,Credit,1773.89,-1575246.2,GBP,Target
TXN0000017825,2024-05-28T08:11:48,ACC00008420,Credit,529.17,-1574717.03,JPY,Walmart
TXN0000017826,2024-10-25T01:49:13,ACC00009286,Payment,302.39,-1575019.42,JPY,Grocery
TXN0000017827,2024-10-18T05:07:12,ACC00005381,ATM,745.16,-1575764.58,GBP,Online Store
TXN0000017828,2024-04-10T02:06:27,ACC00003415,Debit,1638.65,-1577403.23,USD,Shell
TXN0000017829,2024-12-25T16:37:51,ACC00007011,Credit,1640.99,-1575762.24,USD,Target
TXN0000017830,2024-03-29T12:48:15,ACC00008978,Transfer,1732.46,-1574029.78,GBP,Grocery
TXN0000017831,2024-07-06T09:16:58,ACC00003926,Payment,965.04,-1574994.82,USD,Walmart
TXN0000017832,2024-01-23T03:20:07,ACC00002948,ATM,577.14,-1575571.96,USD,Starbucks
TXN0000017833,2024-11-14T17:26:31,ACC00009035,Transfer,877.27,-1574694.69,EUR,Grocery
TXN0000017834,2024-02-06T04:45:38,ACC00008207,Credit,806.29,-1573888.4,EUR,Restaurant
TXN0000017835,2024-01-06T16:27:56,ACC00001930,Transfer,143.22,-1573745.18,USD,Walmart
TXN0000017836,2024-06-22T20:11:38,ACC00004362,Debit,1191.78,-1574936.96,EUR,Online Store
TXN0000017837,2024-04-16T04:40:28,ACC00007946,Transfer,35.49,-1574901.47,JPY,Online Store
TXN0000017838,2024-12-06T11:30:42,ACC00007949,Payment,1788.78,-1576690.25,EUR,Walmart
TXN0000017839,2024-08-02T04:41:27,ACC00007180,Debit,608.01,-1577298.26,USD,Shell
TXN0000017840,2024-01-28T01:18:41,ACC00000532,Credit,339.06,-1576959.2,EUR,Online Store
TXN0000017841,2024-07-16T10:51:10,ACC00002406,Debit,411.62,-1577370.82,USD,Amazon
TXN0000017842,2024-05-23T22:47:58,ACC00003022,Debit,1893.28,-1579264.1,USD,Walmart
TXN0000017843,2024-05-18T18:25:45,ACC00009945,Debit,1689.93,-1580954.03,JPY,Starbucks
TXN0000017844,2024-02-10T20:49:20,ACC00006659,Credit,1442.76,-1579511.27,JPY,Target
TXN0000017845,2024-04-07T20:44:49,ACC00009829,Transfer,1411.96,-1578099.31,USD,Target
TXN0000017846,2024-03-23T04:23:02,ACC00003850,Transfer,589.25,-1577510.06,USD,Walmart
TXN0000017847,2024-12-15T08:11:38,ACC00004948,Debit,1246.32,-1578756.38,EUR,Online Store
TXN0000017848,2024-01-24T18:13:10,ACC00005111,Credit,1565.39,-1577190.99,USD,Amazon
TXN0000017849,2024-03-28T12:44:17,ACC00000492,ATM,753.53,-1577944.52,JPY,Shell
TXN0000017850,2024-08-01T10:12:58,ACC00009032,Credit,1997.02,-1575947.5,USD,Online Store
TXN0000017851,2024-01-20T15:15:41,ACC00006808,Debit,993.27,-1576940.77,JPY,Shell
TXN0000017852,2024-05-17T21:35:47,ACC00001318,Payment,1253.61,-1578194.38,JPY,Online Store
TXN0000017853,2024-02-13T10:03:13,ACC00001117,Credit,1946.25,-1576248.13,USD,Walmart
TXN0000017854,2024-01-01T02:39:09,ACC00003369,Credit,1065.09,-1575183.04,JPY,Walmart
TXN0000017855,2024-09-13T09:59:04,ACC00000861,Credit,556.01,-1574627.03,EUR,Walmart
TXN0000017856,2024-01-04T22:31:43,ACC00003681,Payment,1793.17,-1576420.2,GBP,Amazon
TXN0000017857,2024-02-07T06:44:41,ACC00008483,Payment,1933.11,-1578353.31,JPY,Shell
TXN0000017858,2024-06-21T12:27:41,ACC00000871,Debit,266.1,-1578619.41,EUR,Amazon
TXN0000017859,2024-07-15T16:10:21,ACC00007620,Debit,387.5,-1579006.91,USD,Shell
TXN0000017860,2024-10-16T14:10:27,ACC00007591,Debit,1884.02,-1580890.93,GBP,Grocery
TXN0000017861,2024-03-15T21:30:25,ACC00005450,ATM,250.56,-1581141.49,GBP,Target
TXN0000017862,2024-08-11T16:51:55,ACC00003071,Transfer,1282.74,-1579858.75,GBP,Grocery
TXN0000017863,2024-10-13T01:28:13,ACC00005068,Payment,1267.74,-1581126.49,JPY,Online Store
TXN0000017864,2024-04-02T22:37:22,ACC00008495,Payment,152.02,-1581278.51,GBP,Target
TXN0000017865,2024-11-27T20:32:26,ACC00000162,ATM,1682.5,-1582961.01,EUR,Restaurant
TXN0000017866,2024-04-22T09:07:03,ACC00006303,Debit,1985.03,-1584946.04,GBP,Amazon
TXN0000017867,2024-04-02T05:09:59,ACC00002798,Credit,502.72,-1584443.32,GBP,Walmart
TXN0000017868,2024-04-26T00:40:23,ACC00009888,Payment,735.65,-1585178.97,GBP,Amazon
TXN0000017869,2024-07-06T19:07:06,ACC00009201,Credit,654.25,-1584524.72,JPY,Online Store
TXN0000017870,2024-08-05T05:34:53,ACC00002598,Transfer,489.45,-1584035.27,GBP,Amazon
TXN0000017871,2024-06-23T07:01:15,ACC00008010,Payment,1564.24,-1585599.51,GBP,Online Store
TXN0000017872,2024-05-15T11:01:04,ACC00009705,Transfer,1488.22,-1584111.29,EUR,Walmart
TXN0000017873,2024-08-16T14:24:25,ACC00005448,Credit,1298.94,-1582812.35,JPY,Amazon
TXN0000017874,2024-02-22T14:32:39,ACC00001964,ATM,236.12,-1583048.47,GBP,Restaurant
TXN0000017875,2024-01-12T15:59:53,ACC00008925,Credit,1325.77,-1581722.7,EUR,Starbucks
TXN0000017876,2024-01-04T20:36:56,ACC00008346,ATM,1782.87,-1583505.57,JPY,Amazon
TXN0000017877,2024-12-26T08:24:25,ACC00009812,Payment,26.58,-1583532.15,JPY,Walmart
TXN0000017878,2024-05-12T12:01:04,ACC00002967,Credit,1131.98,-1582400.17,EUR,Amazon
TXN0000017879,2024-01-22T22:25:56,ACC00006402,Payment,486.19,-1582886.36,EUR,Walmart
TXN0000017880,2024-12-06T09:25:27,ACC00004139,Debit,974.14,-1583860.5,USD,Grocery
TXN0000017881,2024-06-04T09:44:37,ACC00006109,Transfer,239.01,-1583621.49,GBP,Target
TXN0000017882,2024-05-09T15:31:16,ACC00007694,Payment,550.81,-1584172.3,GBP,Grocery
TXN0000017883,2024-01-12T07:03:18,ACC00005676,Payment,820.97,-1584993.27,JPY,Amazon
TXN0000017884,2024-06-28T07:50:45,ACC00009511,Debit,1801.68,-1586794.95,USD,Starbucks
TXN0000017885,2024-10-21T03:20:48,ACC00009582,Payment,1078.86,-1587873.81,USD,Shell
TXN0000017886,2024-10-15T23:28:01,ACC00000591,Transfer,320.94,-1587552.87,JPY,Restaurant
TXN0000017887,2024-11-30T11:33:41,ACC00005981,Payment,1549.68,-1589102.55,EUR,Restaurant
TXN0000017888,2024-02-15T14:14:00,ACC00001275,Transfer,1115.04,-1587987.51,USD,Restaurant
TXN0000017889,2024-02-10T23:17:33,ACC00004120,Transfer,1724.94,-1586262.57,GBP,Target
TXN0000017890,2024-01-29T11:20:17,ACC00009911,Credit,1075.85,-1585186.72,USD,Walmart
TXN0000017891,2024-03-02T16:22:22,ACC00005792,ATM,1116.25,-1586302.97,JPY,Restaurant
TXN0000017892,2024-11-18T08:08:59,ACC00008842,ATM,1804.84,-1588107.81,GBP,Target
TXN0000017893,2024-10-07T07:52:19,ACC00000655,Transfer,292.6,-1587815.21,USD,Target
TXN0000017894,2024-05-28T20:08:03,ACC00006111,Payment,275.45,-1588090.66,JPY,Grocery
TXN0000017895,2024-03-31T16:22:02,ACC00004607,Debit,699.5,-1588790.16,USD,Restaurant
TXN0000017896,2024-05-29T17:41:37,ACC00001006,Payment,866.32,-1589656.48,JPY,Amazon
TXN0000017897,2024-07-15T02:43:21,ACC00005308,Payment,1008.12,-1590664.6,USD,Target
TXN0000017898,2024-09-01T05:11:40,ACC00002126,Credit,915.02,-1589749.58,USD,Amazon
TXN0000017899,2024-11-15T14:48:04,ACC00001729,ATM,1505.16,-1591254.74,EUR,Starbucks
TXN0000017900,2024-12-01T18:12:58,ACC00002910,Debit,465.43,-1591720.17,EUR,Online Store
TXN0000017901,2024-08-02T17:21:42,ACC00004464,Debit,531.66,-1592251.83,USD,Grocery
TXN0000017902,2024-09-29T03:25:10,ACC00005896,Credit,1012.87,-1591238.96,EUR,Grocery
TXN0000017903,2024-03-06T15:32:53,ACC00008203,ATM,124.07,-1591363.03,JPY,Amazon
TXN0000017904,2024-09-11T10:44:31,ACC00000923,Debit,1500.34,-1592863.37,GBP,Grocery
TXN0000017905,2024-01-03T15:50:21,ACC00001929,Debit,154.56,-1593017.93,GBP,Starbucks
TXN0000017906,2024-03-28T10:31:13,ACC00006901,Transfer,1150.44,-1591867.49,EUR,Grocery
TXN0000017907,2024-04-12T07:02:49,ACC00001267,Debit,70.07,-1591937.56,JPY,Amazon
TXN0000017908,2024-12-26T03:54:40,ACC00002468,ATM,1064.78,-1593002.34,USD,Starbucks
TXN0000017909,2024-09-30T19:59:55,ACC00000654,ATM,557.94,-1593560.28,GBP,Restaurant
TXN0000017910,2024-03-29T17:15:56,ACC00004846,Transfer,1476.32,-1592083.96,USD,Target
TXN0000017911,2024-04-17T06:09:50,ACC00009981,Transfer,1512.12,-1590571.84,GBP,Shell
TXN0000017912,2024-10-24T23:28:53,ACC00004810,Payment,983.81,-1591555.65,EUR,Amazon
TXN0000017913,2024-06-19T00:07:08,ACC00006370,Transfer,249.34,-1591306.31,USD,Starbucks
TXN0000017914,2024-09-14T04:06:32,ACC00003440,Credit,919.48,-1590386.83,EUR,Starbucks
TXN0000017915,2024-10-17T18:21:22,ACC00001483,Debit,680.77,-1591067.6,JPY,Target
TXN0000017916,2024-08-03T14:41:35,ACC00005810,Credit,1562.62,-1589504.98,USD,Walmart
TXN0000017917,2024-11-21T05:13:48,ACC00004211,Debit,125.36,-1589630.34,USD,Online Store
TXN0000017918,2024-04-08T12:27:02,ACC00001061,ATM,1894.07,-1591524.41,JPY,Starbucks
TXN0000017919,2024-03-14T14:21:52,ACC00000373,Debit,189.35,-1591713.76,EUR,Shell
TXN0000017920,2024-11-08T22:23:33,ACC00003458,Transfer,953.7,-1590760.06,USD,Shell
TXN0000017921,2024-12-09T23:45:49,ACC00007615,Transfer,1823.78,-1588936.28,JPY,Target
TXN0000017922,2024-03-21T05:53:01,ACC00003306,Transfer,1174.27,-1587762.01,GBP,Starbucks
TXN0000017923,2024-12-03T00:11:29,ACC00006025,Debit,1194.89,-1588956.9,JPY,Shell
TXN0000017924,2024-01-08T06:06:57,ACC00005761,ATM,23.39,-1588980.29,EUR,Online Store
TXN0000017925,2024-01-31T11:00:56,ACC00000087,Payment,1290.55,-1590270.84,USD,Shell
TXN0000017926,2024-12-09T04:24:17,ACC00008983,ATM,328.16,-1590599.0,JPY,Online Store
TXN0000017927,2024-09-20T07:01:24,ACC00009487,Transfer,666.94,-1589932.06,JPY,Grocery
TXN0000017928,2024-10-20T07:45:44,ACC00005427,Transfer,1414.92,-1588517.14,USD,Grocery
TXN0000017929,2024-07-09T08:24:59,ACC00002667,Transfer,84.2,-1588432.94,GBP,Starbucks
TXN0000017930,2024-02-09T22:06:45,ACC00007620,Credit,207.01,-1588225.93,JPY,Walmart
TXN0000017931,2024-03-27T04:36:31,ACC00004333,Credit,897.72,-1587328.21,EUR,Online Store
TXN0000017932,2024-07-20T05:32:32,ACC00009828,Debit,846.6,-1588174.81,GBP,Target
TXN0000017933,2024-12-29T21:56:10,ACC00005051,Debit,1562.71,-1589737.52,GBP,Amazon
TXN0000017934,2024-09-05T21:56:40,ACC00000825,Credit,1315.65,-1588421.87,USD,Online Store
TXN0000017935,2024-09-26T13:51:39,ACC00001204,Debit,64.43,-1588486.3,GBP,Walmart
TXN0000017936,2024-06-03T11:21:42,ACC00009260,Payment,1296.18,-1589782.48,USD,Walmart
TXN0000017937,2024-01-03T04:52:05,ACC00007947,Debit,1669.48,-1591451.96,JPY,Online Store
TXN0000017938,2024-05-23T20:42:21,ACC00005648,Debit,458.28,-1591910.24,JPY,Amazon
TXN0000017939,2024-08-28T01:52:54,ACC00005791,Transfer,1780.26,-1590129.98,JPY,Walmart
TXN0000017940,2024-03-28T09:23:45,ACC00009608,Credit,294.8,-1589835.18,USD,Shell
TXN0000017941,2024-03-13T06:38:12,ACC00006041,Credit,1878.2,-1587956.98,EUR,Walmart
TXN0000017942,2024-06-09T11:25:45,ACC00003344,Credit,1575.57,-1586381.41,JPY,Target
TXN0000017943,2024-02-23T23:45:32,ACC00008185,Credit,244.78,-1586136.63,EUR,Walmart
TXN0000017944,2024-06-26T06:35:18,ACC00003747,Payment,593.82,-1586730.45,GBP,Shell
TXN0000017945,2024-02-12T04:53:22,ACC00001767,Transfer,1208.37,-1585522.08,JPY,Amazon
TXN0000017946,2024-03-16T07:21:06,ACC00003804,Transfer,10.96,-1585511.12,GBP,Grocery
TXN0000017947,2024-10-16T10:07:38,ACC00007045,Debit,68.5,-1585579.62,USD,Target
TXN0000017948,2024-04-20T20:19:11,ACC00006850,ATM,1513.35,-1587092.97,USD,Restaurant
TXN0000017949,2024-07-15T17:26:03,ACC00007229,Credit,1732.86,-1585360.11,EUR,Restaurant
TXN0000017950,2024-09-18T02:20:59,ACC00007113,Payment,1446.37,-1586806.48,GBP,Restaurant
TXN0000017951,2024-03-24T11:18:50,ACC00000022,Transfer,1421.04,-1585385.44,EUR,Amazon
TXN0000017952,2024-09-20T21:09:41,ACC00002692,ATM,1549.68,-1586935.12,JPY,Online Store
TXN0000017953,2024-06-13T09:54:30,ACC00008251,Debit,1041.53,-1587976.65,USD,Starbucks
TXN0000017954,2024-07-30T08:16:05,ACC00001488,Transfer,1408.77,-1586567.88,GBP,Target
TXN0000017955,2024-02-26T05:36:43,ACC00001469,Transfer,1683.39,-1584884.49,GBP,Grocery
TXN0000017956,2024-07-04T18:22:45,ACC00005785,ATM,923.76,-1585808.25,USD,Restaurant
TXN0000017957,2024-06-06T04:02:35,ACC00003965,ATM,201.93,-1586010.18,GBP,Starbucks
TXN0000017958,2024-09-22T19:59:17,ACC00008383,Payment,790.07,-1586800.25,JPY,Online Store
TXN0000017959,2024-04-08T22:19:37,ACC00008654,Debit,1557.86,-1588358.11,GBP,Walmart
TXN0000017960,2024-08-08T01:37:50,ACC00006851,ATM,423.16,-1588781.27,JPY,Online Store
TXN0000017961,2024-07-23T19:26:43,ACC00005076,Credit,178.53,-1588602.74,USD,Walmart
TXN0000017962,2024-06-25T18:27:02,ACC00004587,Payment,1658.3,-1590261.04,EUR,Shell
TXN0000017963,2024-11-22T22:59:15,ACC00000175,Transfer,1507.16,-1588753.88,EUR,Online Store
TXN0000017964,2024-01-07T21:37:14,ACC00002042,Payment,72.06,-1588825.94,JPY,Walmart
TXN0000017965,2024-03-13T11:40:38,ACC00006178,ATM,1623.76,-1590449.7,GBP,Walmart
TXN0000017966,2024-11-07T12:22:18,ACC00007165,Transfer,610.34,-1589839.36,USD,Amazon
TXN0000017967,2024-01-28T21:47:19,ACC00001014,Debit,1062.46,-1590901.82,USD,Grocery
TXN0000017968,2024-10-14T20:13:47,ACC00004663,Credit,1780.5,-1589121.32,GBP,Grocery
TXN0000017969,2024-05-24T05:13:03,ACC00007540,Credit,374.42,-1588746.9,JPY,Target
TXN0000017970,2024-09-16T11:43:22,ACC00003488,Transfer,1741.77,-1587005.13,USD,Target
TXN0000017971,2024-03-24T08:32:04,ACC00004778,Transfer,950.43,-1586054.7,EUR,Shell
TXN0000017972,2024-09-12T21:16:11,ACC00007708,Credit,754.36,-1585300.34,JPY,Amazon
TXN0000017973,2024-05-16T05:09:21,ACC00002183,Credit,1555.76,-1583744.58,JPY,Amazon
TXN0000017974,2024-04-26T10:11:12,ACC00009385,Debit,368.38,-1584112.96,JPY,Walmart
TXN0000017975,2024-11-25T01:36:02,ACC00007497,ATM,1410.16,-1585523.12,JPY,Online Store
TXN0000017976,2024-05-27T06:09:10,ACC00005169,ATM,1189.57,-1586712.69,EUR,Amazon
TXN0000017977,2024-07-14T00:59:54,ACC00005839,Transfer,482.39,-1586230.3,USD,Shell
TXN0000017978,2024-05-13T21:18:41,ACC00004068,Transfer,856.42,-1585373.88,JPY,Grocery
TXN0000017979,2024-04-13T08:15:46,ACC00008004,Payment,1920.49,-1587294.37,GBP,Online Store
TXN0000017980,2024-10-18T13:09:37,ACC00002846,Credit,936.31,-1586358.06,GBP,Walmart
TXN0000017981,2024-02-15T16:39:11,ACC00002735,Transfer,109.51,-1586248.55,USD,Shell
TXN0000017982,2024-11-03T00:52:06,ACC00006619,Transfer,927.45,-1585321.1,JPY,Online Store
TXN0000017983,2024-03-24T18:11:50,ACC00006198,Payment,714.23,-1586035.33,JPY,Restaurant
TXN0000017984,2024-08-27T03:45:49,ACC00006404,Debit,425.42,-1586460.75,GBP,Target
TXN0000017985,2024-02-23T04:38:34,ACC00003240,Credit,1873.9,-1584586.85,GBP,Online Store
TXN0000017986,2024-03-19T15:31:40,ACC00007247,ATM,946.52,-1585533.37,JPY,Grocery
TXN0000017987,2024-03-17T17:26:10,ACC00006730,Debit,1674.09,-1587207.46,EUR,Shell
TXN0000017988,2024-12-27T11:29:01,ACC00002175,Transfer,417.03,-1586790.43,GBP,Restaurant
TXN0000017989,2024-05-14T09:31:34,ACC00000417,Transfer,1096.81,-1585693.62,GBP,Walmart
TXN0000017990,2024-01-09T01:30:29,ACC00008703,Transfer,914.37,-1584779.25,GBP,Amazon
TXN0000017991,2024-02-11T19:45:45,ACC00008944,Transfer,1025.3,-1583753.95,JPY,Online Store
TXN0000017992,2024-05-21T23:40:58,ACC00005064,Transfer,1779.66,-1581974.29,USD,Shell
TXN0000017993,2024-01-05T15:33:24,ACC00004703,Credit,1932.89,-1580041.4,EUR,Target
TXN0000017994,2024-03-10T04:55:57,ACC00005814,Credit,1364.62,-1578676.78,GBP,Amazon
TXN0000017995,2024-11-22T21:19:00,ACC00005309,Credit,1584.63,-1577092.15,USD,Shell
TXN0000017996,2024-02-11T18:24:59,ACC00003970,Credit,1953.98,-1575138.17,USD,Starbucks
TXN0000017997,2024-09-18T11:47:20,ACC00002131,Transfer,778.77,-1574359.4,USD,Target
TXN0000017998,2024-07-14T20:30:34,ACC00006283,Transfer,1478.74,-1572880.66,EUR,Target
TXN0000017999,2024-03-12T07:19:21,ACC00007907,Credit,656.7,-1572223.96,EUR,Grocery
TXN0000018000,2024-02-12T05:38:42,ACC00006453,Payment,1781.91,-1574005.87,USD,Online Store
TXN0000018001,2024-01-23T09:35:28,ACC00007646,ATM,662.13,-1574668.0,GBP,Starbucks
TXN0000018002,2024-07-28T10:09:16,ACC00000924,Credit,1305.4,-1573362.6,JPY,Online Store
TXN0000018003,2024-08-08T21:07:41,ACC00007895,ATM,811.66,-1574174.26,EUR,Online Store
TXN0000018004,2024-05-01T08:14:57,ACC00008071,Debit,1267.8,-1575442.06,JPY,Grocery
TXN0000018005,2024-04-20T19:31:47,ACC00005776,ATM,143.16,-1575585.22,GBP,Online Store
TXN0000018006,2024-05-01T13:37:40,ACC00006896,Debit,1006.56,-1576591.78,USD,Amazon
TXN0000018007,2024-10-22T06:58:02,ACC00002760,Credit,1297.87,-1575293.91,USD,Starbucks
TXN0000018008,2024-05-30T12:04:21,ACC00007324,Credit,1999.88,-1573294.03,EUR,Target
TXN0000018009,2024-10-08T16:53:01,ACC00002901,ATM,204.87,-1573498.9,GBP,Online Store
TXN0000018010,2024-12-24T07:15:41,ACC00003461,Debit,1164.81,-1574663.71,JPY,Target
TXN0000018011,2024-09-30T01:41:51,ACC00009003,Credit,1263.87,-1573399.84,USD,Target
TXN0000018012,2024-12-19T13:58:43,ACC00006969,Payment,485.21,-1573885.05,GBP,Grocery
TXN0000018013,2024-07-01T00:29:49,ACC00007805,ATM,767.83,-1574652.88,EUR,Starbucks
TXN0000018014,2024-01-22T14:27:22,ACC00001393,ATM,1187.07,-1575839.95,EUR,Walmart
TXN0000018015,2024-05-10T22:17:09,ACC00003315,Transfer,1552.25,-1574287.7,GBP,Amazon
TXN0000018016,2024-07-29T22:30:52,ACC00009536,Payment,1275.2,-1575562.9,JPY,Starbucks
TXN0000018017,2024-10-06T13:49:19,ACC00001571,Transfer,343.88,-1575219.02,JPY,Shell
TXN0000018018,2024-06-15T18:30:33,ACC00002276,Credit,1705.86,-1573513.16,EUR,Online Store
TXN0000018019,2024-04-15T11:30:27,ACC00001171,Debit,1391.29,-1574904.45,GBP,Starbucks
TXN0000018020,2024-09-18T00:58:18,ACC00002708,Transfer,680.79,-1574223.66,GBP,Target
TXN0000018021,2024-05-25T22:05:26,ACC00000181,Payment,1231.11,-1575454.77,EUR,Grocery
TXN0000018022,2024-01-25T08:20:44,ACC00007781,ATM,1376.78,-1576831.55,EUR,Grocery
TXN0000018023,2024-01-29T19:22:56,ACC00001531,Credit,684.64,-1576146.91,JPY,Shell
TXN0000018024,2024-11-24T07:13:46,ACC00000318,Transfer,903.6,-1575243.31,JPY,Starbucks
TXN0000018025,2024-06-11T16:26:01,ACC00005034,Transfer,844.69,-1574398.62,GBP,Grocery
TXN0000018026,2024-05-07T07:23:47,ACC00005631,ATM,984.71,-1575383.33,GBP,Target
TXN0000018027,2024-05-23T20:43:57,ACC00003432,Payment,1892.25,-1577275.58,JPY,Restaurant
TXN0000018028,2024-05-07T23:43:52,ACC00002915,Payment,264.37,-1577539.95,USD,Amazon
TXN0000018029,2024-02-23T07:09:42,ACC00001405,ATM,1379.57,-1578919.52,USD,Target
TXN0000018030,2024-05-13T02:24:01,ACC00002227,Transfer,720.61,-1578198.91,USD,Online Store
TXN0000018031,2024-08-25T19:31:39,ACC00002241,Payment,125.96,-1578324.87,USD,Amazon
TXN0000018032,2024-07-16T23:14:57,ACC00000550,ATM,360.23,-1578685.1,EUR,Starbucks
TXN0000018033,2024-07-12T06:20:55,ACC00000130,ATM,1129.45,-1579814.55,JPY,Starbucks
TXN0000018034,2024-01-12T11:54:12,ACC00005556,Credit,1953.35,-1577861.2,EUR,Starbucks
TXN0000018035,2024-11-27T23:49:07,ACC00006008,ATM,1102.02,-1578963.22,EUR,Shell
TXN0000018036,2024-08-08T16:50:42,ACC00004607,Payment,1402.53,-1580365.75,USD,Target
TXN0000018037,2024-04-09T10:35:32,ACC00005173,Debit,1090.75,-1581456.5,EUR,Walmart
TXN0000018038,2024-05-14T04:22:40,ACC00000786,Payment,1956.38,-1583412.88,USD,Shell
TXN0000018039,2024-04-04T05:54:38,ACC00004041,Transfer,1626.97,-1581785.91,GBP,Online Store
TXN0000018040,2024-07-20T02:20:22,ACC00006978,Debit,667.8,-1582453.71,JPY,Grocery
TXN0000018041,2024-08-16T09:27:37,ACC00009276,Credit,1698.95,-1580754.76,USD,Amazon
TXN0000018042,2024-01-27T23:54:42,ACC00007945,ATM,256.87,-1581011.63,GBP,Restaurant
TXN0000018043,2024-03-25T03:39:08,ACC00008489,Debit,60.28,-1581071.91,GBP,Shell
TXN0000018044,2024-04-11T04:55:58,ACC00001364,Debit,913.65,-1581985.56,EUR,Grocery
TXN0000018045,2024-04-09T05:31:14,ACC00004745,ATM,1978.03,-1583963.59,JPY,Shell
TXN0000018046,2024-01-25T23:21:20,ACC00006335,Credit,1144.34,-1582819.25,GBP,Shell
TXN0000018047,2024-02-15T03:12:36,ACC00004209,Payment,1395.94,-1584215.19,USD,Shell
TXN0000018048,2024-02-23T14:33:03,ACC00001069,Payment,1375.97,-1585591.16,GBP,Grocery
TXN0000018049,2024-01-31T15:08:07,ACC00002418,Credit,1941.17,-1583649.99,EUR,Restaurant
TXN0000018050,2024-11-07T21:25:53,ACC00009229,Debit,1274.37,-1584924.36,JPY,Target
TXN0000018051,2024-10-14T15:25:20,ACC00000673,Payment,1593.18,-1586517.54,USD,Restaurant
TXN0000018052,2024-09-16T06:22:38,ACC00004848,Transfer,1804.4,-1584713.14,GBP,Grocery
TXN0000018053,2024-04-07T20:39:08,ACC00007322,Transfer,1289.06,-1583424.08,JPY,Grocery
TXN0000018054,2024-11-25T20:34:40,ACC00004187,ATM,1900.09,-1585324.17,USD,Amazon
TXN0000018055,2024-08-20T22:24:30,ACC00001561,Transfer,1275.92,-1584048.25,JPY,Target
TXN0000018056,2024-05-21T07:15:23,ACC00004156,Credit,473.07,-1583575.18,EUR,Restaurant
TXN0000018057,2024-02-15T22:30:34,ACC00001702,Payment,1484.85,-1585060.03,GBP,Shell
TXN0000018058,2024-10-07T20:18:58,ACC00009682,Credit,1505.76,-1583554.27,JPY,Online Store
TXN0000018059,2024-10-01T19:54:50,ACC00001513,Payment,882.73,-1584437.0,EUR,Grocery
TXN0000018060,2024-12-25T23:53:15,ACC00002940,Credit,1831.95,-1582605.05,JPY,Walmart
TXN0000018061,2024-04-12T22:34:49,ACC00003612,Payment,1758.03,-1584363.08,EUR,Shell
TXN0000018062,2024-01-28T15:06:06,ACC00003223,Payment,1435.29,-1585798.37,GBP,Restaurant
TXN0000018063,2024-05-06T01:18:52,ACC00008236,Payment,1255.1,-1587053.47,JPY,Shell
TXN0000018064,2024-05-11T03:47:36,ACC00006357,Debit,1945.5,-1588998.97,USD,Starbucks
TXN0000018065,2024-05-10T00:32:11,ACC00004785,Payment,255.07,-1589254.04,GBP,Target
TXN0000018066,2024-10-21T23:28:57,ACC00001258,Debit,614.91,-1589868.95,JPY,Online Store
TXN0000018067,2024-05-27T05:19:15,ACC00002864,ATM,1540.25,-1591409.2,JPY,Online Store
TXN0000018068,2024-11-01T06:20:59,ACC00009866,Credit,180.78,-1591228.42,EUR,Shell
TXN0000018069,2024-09-04T05:23:22,ACC00000182,Debit,70.97,-1591299.39,USD,Starbucks
TXN0000018070,2024-08-04T16:47:40,ACC00000261,Payment,980.83,-1592280.22,JPY,Shell
TXN0000018071,2024-09-18T10:29:51,ACC00000339,ATM,1393.48,-1593673.7,USD,Walmart
TXN0000018072,2024-04-21T17:33:30,ACC00002059,Transfer,789.12,-1592884.58,USD,Target
TXN0000018073,2024-09-12T13:20:11,ACC00002442,ATM,684.48,-1593569.06,EUR,Online Store
TXN0000018074,2024-05-17T03:12:24,ACC00008580,Debit,1047.92,-1594616.98,GBP,Starbucks
TXN0000018075,2024-08-02T12:11:50,ACC00005783,ATM,1627.17,-1596244.15,USD,Amazon
TXN0000018076,2024-12-27T17:59:34,ACC00009173,Debit,1322.15,-1597566.3,GBP,Restaurant
TXN0000018077,2024-08-19T08:30:02,ACC00005876,Debit,1677.76,-1599244.06,EUR,Grocery
TXN0000018078,2024-05-31T17:19:11,ACC00007722,Transfer,128.85,-1599115.21,USD,Online Store
TXN0000018079,2024-09-25T00:39:06,ACC00008341,ATM,681.23,-1599796.44,GBP,Shell
TXN0000018080,2024-09-05T08:31:08,ACC00005125,ATM,1617.42,-1601413.86,USD,Restaurant
TXN0000018081,2024-02-18T03:35:50,ACC00000742,Debit,1476.65,-1602890.51,EUR,Shell
TXN0000018082,2024-12-06T07:30:24,ACC00009177,ATM,1381.73,-1604272.24,GBP,Walmart
TXN0000018083,2024-12-10T09:08:58,ACC00009701,Debit,452.25,-1604724.49,USD,Online Store
TXN0000018084,2024-07-03T08:15:30,ACC00006331,Credit,567.86,-1604156.63,JPY,Target
TXN0000018085,2024-07-29T20:00:02,ACC00004334,Transfer,566.8,-1603589.83,GBP,Grocery
TXN0000018086,2024-09-21T09:08:18,ACC00006016,Transfer,656.35,-1602933.48,USD,Starbucks
TXN0000018087,2024-06-21T02:41:34,ACC00007340,Credit,161.11,-1602772.37,USD,Starbucks
TXN0000018088,2024-11-25T20:11:20,ACC00005442,Transfer,1069.09,-1601703.28,EUR,Shell
TXN0000018089,2024-09-05T08:05:11,ACC00003251,ATM,1024.4,-1602727.68,JPY,Online Store
TXN0000018090,2024-08-23T06:42:54,ACC00000464,Transfer,1366.99,-1601360.69,USD,Online Store
TXN0000018091,2024-05-01T01:59:03,ACC00002705,Transfer,1429.29,-1599931.4,JPY,Amazon
TXN0000018092,2024-01-09T19:53:38,ACC00001309,Credit,157.16,-1599774.24,GBP,Target
TXN0000018093,2024-12-08T10:15:20,ACC00004707,Debit,523.81,-1600298.05,JPY,Restaurant
TXN0000018094,2024-03-03T16:38:41,ACC00005945,ATM,872.96,-1601171.01,USD,Amazon
TXN0000018095,2024-11-25T22:53:24,ACC00009542,Transfer,822.34,-1600348.67,GBP,Starbucks
TXN0000018096,2024-03-25T12:02:56,ACC00009452,Payment,1706.02,-1602054.69,GBP,Shell
TXN0000018097,2024-01-24T22:43:28,ACC00006158,Debit,1831.11,-1603885.8,GBP,Walmart
TXN0000018098,2024-01-24T22:22:41,ACC00002184,Credit,390.31,-1603495.49,EUR,Amazon
TXN0000018099,2024-02-23T09:42:11,ACC00005503,Transfer,866.91,-1602628.58,USD,Amazon
TXN0000018100,2024-09-22T06:24:45,ACC00005179,Payment,300.43,-1602929.01,USD,Online Store
TXN0000018101,2024-11-21T01:32:28,ACC00008864,Payment,1042.81,-1603971.82,USD,Walmart
TXN0000018102,2024-06-22T23:47:44,ACC00004582,ATM,990.17,-1604961.99,GBP,Online Store
TXN0000018103,2024-11-14T05:51:20,ACC00001058,Transfer,1157.45,-1603804.54,GBP,Restaurant
TXN0000018104,2024-10-13T06:17:39,ACC00008643,Transfer,171.2,-1603633.34,EUR,Target
TXN0000018105,2024-05-25T20:52:02,ACC00008383,Debit,1646.75,-1605280.09,GBP,Walmart
TXN0000018106,2024-11-11T05:32:00,ACC00002255,ATM,1587.17,-1606867.26,USD,Shell
TXN0000018107,2024-06-09T18:04:08,ACC00007247,ATM,1361.73,-1608228.99,GBP,Grocery
TXN0000018108,2024-06-22T21:56:36,ACC00003909,Transfer,885.73,-1607343.26,GBP,Walmart
TXN0000018109,2024-05-27T02:33:08,ACC00001028,ATM,459.21,-1607802.47,GBP,Shell
TXN0000018110,2024-06-16T17:41:54,ACC00001471,Debit,971.18,-1608773.65,GBP,Shell
TXN0000018111,2024-06-14T22:42:02,ACC00002058,Credit,1820.59,-1606953.06,USD,Walmart
TXN0000018112,2024-06-08T05:34:47,ACC00004346,Debit,662.07,-1607615.13,USD,Grocery
TXN0000018113,2024-04-03T00:55:18,ACC00008337,Credit,938.24,-1606676.89,EUR,Walmart
TXN0000018114,2024-07-12T18:26:06,ACC00008211,Transfer,1407.72,-1605269.17,USD,Target
TXN0000018115,2024-11-03T17:31:29,ACC00007928,Credit,1290.78,-1603978.39,EUR,Target
TXN0000018116,2024-01-10T11:36:46,ACC00008953,Debit,647.93,-1604626.32,JPY,Grocery
TXN0000018117,2024-12-01T15:36:23,ACC00000666,Transfer,127.49,-1604498.83,GBP,Shell
TXN0000018118,2024-09-11T23:53:05,ACC00002071,ATM,1648.43,-1606147.26,EUR,Target
TXN0000018119,2024-07-10T06:48:08,ACC00006536,Credit,1750.26,-1604397.0,GBP,Restaurant
TXN0000018120,2024-12-13T14:57:17,ACC00005447,Payment,1451.71,-1605848.71,GBP,Starbucks
TXN0000018121,2024-09-27T13:47:07,ACC00003737,Payment,636.24,-1606484.95,GBP,Online Store
TXN0000018122,2024-08-02T06:06:00,ACC00009131,Credit,898.2,-1605586.75,USD,Restaurant
TXN0000018123,2024-11-12T19:16:18,ACC00004231,Credit,1220.49,-1604366.26,GBP,Starbucks
TXN0000018124,2024-05-25T11:48:50,ACC00005355,Debit,1160.51,-1605526.77,USD,Grocery
TXN0000018125,2024-10-22T04:14:31,ACC00007038,Transfer,1118.76,-1604408.01,JPY,Amazon
TXN0000018126,2024-10-28T15:35:47,ACC00007827,Debit,1413.02,-1605821.03,GBP,Walmart
TXN0000018127,2024-09-09T09:13:08,ACC00003395,Credit,572.63,-1605248.4,EUR,Starbucks
TXN0000018128,2024-02-24T20:01:35,ACC00004447,Debit,930.28,-1606178.68,JPY,Restaurant
TXN0000018129,2024-03-04T00:37:46,ACC00006780,Transfer,403.29,-1605775.39,EUR,Walmart
TXN0000018130,2024-01-13T05:28:04,ACC00008777,Payment,27.04,-1605802.43,EUR,Shell
TXN0000018131,2024-11-13T18:08:24,ACC00009844,Debit,485.14,-1606287.57,USD,Target
TXN0000018132,2024-06-16T04:37:18,ACC00000966,ATM,352.11,-1606639.68,USD,Target
TXN0000018133,2024-11-21T16:05:27,ACC00008574,Credit,1263.96,-1605375.72,GBP,Grocery
TXN0000018134,2024-06-30T14:50:39,ACC00009153,ATM,951.36,-1606327.08,EUR,Shell
TXN0000018135,2024-12-27T20:55:59,ACC00001044,Debit,654.05,-1606981.13,GBP,Grocery
TXN0000018136,2024-07-30T18:05:26,ACC00003108,Transfer,1819.07,-1605162.06,JPY,Amazon
TXN0000018137,2024-06-03T23:12:44,ACC00006953,ATM,519.86,-1605681.92,JPY,Shell
TXN0000018138,2024-11-14T20:49:18,ACC00006952,ATM,189.27,-1605871.19,USD,Restaurant
TXN0000018139,2024-02-19T19:59:47,ACC00007217,Payment,1939.93,-1607811.12,USD,Walmart
TXN0000018140,2024-03-24T04:31:06,ACC00004911,Payment,1687.78,-1609498.9,EUR,Amazon
TXN0000018141,2024-05-28T13:47:00,ACC00005924,ATM,1022.95,-1610521.85,USD,Restaurant
TXN0000018142,2024-11-13T14:44:12,ACC00005355,Credit,1713.45,-1608808.4,EUR,Shell
TXN0000018143,2024-03-20T00:36:33,ACC00009580,Payment,446.69,-1609255.09,EUR,Grocery
TXN0000018144,2024-09-17T13:32:19,ACC00003709,Credit,731.26,-1608523.83,GBP,Amazon
TXN0000018145,2024-07-12T16:38:02,ACC00000610,Credit,1604.28,-1606919.55,EUR,Online Store
TXN0000018146,2024-04-05T14:36:08,ACC00006866,Debit,1184.06,-1608103.61,GBP,Walmart
TXN0000018147,2024-11-17T00:21:13,ACC00003543,Transfer,646.04,-1607457.57,USD,Online Store
TXN0000018148,2024-04-08T08:19:03,ACC00004120,Payment,419.19,-1607876.76,EUR,Walmart
TXN0000018149,2024-01-07T04:04:50,ACC00003246,Payment,1638.29,-1609515.05,GBP,Walmart
TXN0000018150,2024-01-14T04:12:45,ACC00001186,ATM,1625.36,-1611140.41,USD,Amazon
TXN0000018151,2024-10-30T20:06:44,ACC00002864,Debit,45.74,-1611186.15,GBP,Starbucks
TXN0000018152,2024-08-19T15:04:25,ACC00000543,Transfer,1418.31,-1609767.84,GBP,Online Store
TXN0000018153,2024-04-26T15:06:33,ACC00006853,Credit,1035.1,-1608732.74,JPY,Grocery
TXN0000018154,2024-07-23T04:41:14,ACC00004535,Transfer,621.6,-1608111.14,JPY,Amazon
TXN0000018155,2024-11-17T23:28:43,ACC00007068,Transfer,1165.59,-1606945.55,JPY,Starbucks
TXN0000018156,2024-04-29T15:05:51,ACC00005577,Debit,297.74,-1607243.29,GBP,Target
TXN0000018157,2024-07-14T20:48:22,ACC00003899,Transfer,1296.28,-1605947.01,USD,Grocery
TXN0000018158,2024-01-20T06:24:46,ACC00004068,ATM,1761.1,-1607708.11,JPY,Online Store
TXN0000018159,2024-12-09T23:45:40,ACC00007509,Transfer,1711.03,-1605997.08,JPY,Shell
TXN0000018160,2024-05-11T06:13:45,ACC00008168,Credit,199.7,-1605797.38,EUR,Target
TXN0000018161,2024-12-02T19:29:15,ACC00007646,Credit,1669.12,-1604128.26,EUR,Walmart
TXN0000018162,2024-12-16T03:56:00,ACC00003330,ATM,1163.03,-1605291.29,JPY,Online Store
TXN0000018163,2024-12-16T00:21:21,ACC00008681,Payment,42.21,-1605333.5,GBP,Walmart
TXN0000018164,2024-08-06T14:26:08,ACC00009515,ATM,917.96,-1606251.46,JPY,Restaurant
TXN0000018165,2024-06-23T16:46:08,ACC00000873,Debit,464.78,-1606716.24,USD,Grocery
TXN0000018166,2024-09-28T02:20:52,ACC00000634,Payment,1633.05,-1608349.29,JPY,Starbucks
TXN0000018167,2024-11-12T07:10:13,ACC00005507,Debit,1804.15,-1610153.44,JPY,Amazon
TXN0000018168,2024-11-29T03:57:30,ACC00002406,Debit,1170.01,-1611323.45,GBP,Restaurant
TXN0000018169,2024-12-02T20:09:10,ACC00001668,Debit,1929.83,-1613253.28,GBP,Online Store
TXN0000018170,2024-04-05T20:49:34,ACC00001460,ATM,1197.18,-1614450.46,EUR,Grocery
TXN0000018171,2024-10-21T01:38:23,ACC00007539,Transfer,71.47,-1614378.99,JPY,Starbucks
TXN0000018172,2024-07-21T06:55:41,ACC00003908,Transfer,1286.15,-1613092.84,EUR,Starbucks
TXN0000018173,2024-02-21T11:37:27,ACC00006901,ATM,1318.58,-1614411.42,EUR,Starbucks
TXN0000018174,2024-08-16T10:30:16,ACC00005452,Payment,214.45,-1614625.87,USD,Walmart
TXN0000018175,2024-08-10T09:44:50,ACC00008583,ATM,1368.37,-1615994.24,USD,Amazon
TXN0000018176,2024-01-28T11:12:00,ACC00000627,Payment,1210.41,-1617204.65,USD,Restaurant
TXN0000018177,2024-05-06T01:06:48,ACC00008335,Credit,786.15,-1616418.5,GBP,Walmart
TXN0000018178,2024-12-29T00:59:35,ACC00002026,Transfer,55.41,-1616363.09,JPY,Online Store
TXN0000018179,2024-04-26T16:09:37,ACC00003030,Transfer,1577.38,-1614785.71,EUR,Online Store
TXN0000018180,2024-04-30T12:53:57,ACC00008361,ATM,226.95,-1615012.66,JPY,Starbucks
TXN0000018181,2024-05-18T11:34:40,ACC00006932,Credit,1517.25,-1613495.41,EUR,Walmart
TXN0000018182,2024-04-24T23:38:28,ACC00000088,Credit,805.18,-1612690.23,EUR,Online Store
TXN0000018183,2024-10-29T01:11:28,ACC00009470,Transfer,1456.2,-1611234.03,USD,Amazon
TXN0000018184,2024-01-14T12:05:53,ACC00005232,Payment,1148.5,-1612382.53,EUR,Online Store
TXN0000018185,2024-01-22T09:44:39,ACC00008925,Transfer,344.59,-1612037.94,JPY,Shell
TXN0000018186,2024-08-02T06:47:31,ACC00001939,Debit,1423.09,-1613461.03,GBP,Grocery
TXN0000018187,2024-08-23T18:37:34,ACC00008230,ATM,230.02,-1613691.05,EUR,Starbucks
TXN0000018188,2024-05-23T02:59:52,ACC00005289,Credit,1347.27,-1612343.78,EUR,Shell
TXN0000018189,2024-05-05T02:51:20,ACC00001120,Transfer,1563.34,-1610780.44,EUR,Target
TXN0000018190,2024-12-09T11:00:20,ACC00004867,ATM,1106.04,-1611886.48,JPY,Amazon
TXN0000018191,2024-05-07T12:36:02,ACC00002061,Transfer,629.71,-1611256.77,EUR,Amazon
TXN0000018192,2024-10-06T12:43:43,ACC00004966,Debit,982.54,-1612239.31,GBP,Target
TXN0000018193,2024-07-01T19:14:32,ACC00005752,Payment,1258.8,-1613498.11,EUR,Grocery
TXN0000018194,2024-10-05T03:10:52,ACC00005604,ATM,1533.18,-1615031.29,JPY,Grocery
TXN0000018195,2024-10-16T04:41:15,ACC00005538,Credit,1007.69,-1614023.6,USD,Grocery
TXN0000018196,2024-08-07T10:40:51,ACC00003948,Payment,1682.73,-1615706.33,USD,Online Store
TXN0000018197,2024-07-15T19:20:08,ACC00001321,ATM,570.44,-1616276.77,EUR,Walmart
TXN0000018198,2024-11-21T22:51:20,ACC00001547,ATM,1374.71,-1617651.48,JPY,Grocery
TXN0000018199,2024-12-14T16:09:34,ACC00004313,Debit,958.09,-1618609.57,JPY,Starbucks
TXN0000018200,2024-09-12T05:13:38,ACC00008583,Debit,46.74,-1618656.31,USD,Grocery
TXN0000018201,2024-11-23T05:55:25,ACC00001984,Credit,1202.36,-1617453.95,JPY,Target
TXN0000018202,2024-05-29T20:33:08,ACC00006464,Credit,906.45,-1616547.5,USD,Grocery
TXN0000018203,2024-03-03T17:43:55,ACC00005820,Payment,1390.3,-1617937.8,USD,Walmart
TXN0000018204,2024-03-21T10:39:17,ACC00000426,ATM,1895.39,-1619833.19,JPY,Grocery
TXN0000018205,2024-09-23T05:23:05,ACC00002265,Debit,1985.0,-1621818.19,JPY,Target
TXN0000018206,2024-08-18T05:53:23,ACC00001013,Debit,1978.51,-1623796.7,USD,Grocery
TXN0000018207,2024-01-20T00:23:32,ACC00008910,Debit,1301.55,-1625098.25,USD,Walmart
TXN0000018208,2024-04-05T23:58:58,ACC00004844,Credit,514.33,-1624583.92,GBP,Starbucks
TXN0000018209,2024-05-24T21:24:55,ACC00003429,ATM,121.54,-1624705.46,JPY,Amazon
TXN0000018210,2024-12-25T05:10:54,ACC00008520,Credit,1358.53,-1623346.93,GBP,Walmart
TXN0000018211,2024-12-22T13:08:44,ACC00000694,ATM,86.95,-1623433.88,USD,Walmart
TXN0000018212,2024-08-28T13:10:41,ACC00009673,ATM,1246.56,-1624680.44,USD,Grocery
TXN0000018213,2024-04-30T18:43:43,ACC00006475,ATM,361.03,-1625041.47,EUR,Starbucks
TXN0000018214,2024-01-01T20:38:10,ACC00006514,Credit,1992.48,-1623048.99,USD,Restaurant
TXN0000018215,2024-06-16T16:33:04,ACC00009215,Payment,405.12,-1623454.11,JPY,Target
TXN0000018216,2024-02-04T01:43:03,ACC00000948,Debit,144.84,-1623598.95,EUR,Target
TXN0000018217,2024-09-16T00:24:59,ACC00000106,ATM,1414.69,-1625013.64,EUR,Online Store
TXN0000018218,2024-08-07T22:24:41,ACC00004767,Debit,636.68,-1625650.32,EUR,Starbucks
TXN0000018219,2024-02-14T00:15:14,ACC00008262,Payment,1708.95,-1627359.27,JPY,Starbucks
TXN0000018220,2024-02-18T20:43:17,ACC00001926,Credit,1191.0,-1626168.27,USD,Amazon
TXN0000018221,2024-01-11T03:06:03,ACC00006601,ATM,1856.66,-1628024.93,JPY,Target
TXN0000018222,2024-01-28T01:56:47,ACC00002797,Transfer,1790.78,-1626234.15,GBP,Amazon
TXN0000018223,2024-11-08T19:09:02,ACC00002245,ATM,447.38,-1626681.53,USD,Shell
TXN0000018224,2024-07-16T21:41:03,ACC00002253,Payment,263.77,-1626945.3,EUR,Amazon
TXN0000018225,2024-09-20T17:48:39,ACC00002024,Transfer,1932.53,-1625012.77,GBP,Restaurant
TXN0000018226,2024-03-05T19:52:55,ACC00007068,Credit,1616.15,-1623396.62,USD,Walmart
TXN0000018227,2024-08-15T01:07:24,ACC00008968,Debit,1998.62,-1625395.24,EUR,Restaurant
TXN0000018228,2024-01-17T16:52:24,ACC00009273,ATM,1065.87,-1626461.11,EUR,Target
TXN0000018229,2024-07-23T16:40:46,ACC00004163,Payment,1569.13,-1628030.24,EUR,Target
TXN0000018230,2024-10-26T22:36:57,ACC00004485,Transfer,663.68,-1627366.56,GBP,Online Store
TXN0000018231,2024-03-07T18:16:31,ACC00009909,ATM,868.77,-1628235.33,USD,Online Store
TXN0000018232,2024-11-23T13:47:34,ACC00000199,ATM,254.72,-1628490.05,USD,Starbucks
TXN0000018233,2024-07-30T10:57:58,ACC00008101,Transfer,1743.33,-1626746.72,EUR,Starbucks
TXN0000018234,2024-08-16T03:37:55,ACC00007623,Debit,36.29,-1626783.01,USD,Walmart
TXN0000018235,2024-05-26T13:21:32,ACC00004850,Transfer,1390.88,-1625392.13,USD,Target
TXN0000018236,2024-01-16T20:41:28,ACC00008459,Transfer,1822.4,-1623569.73,JPY,Target
TXN0000018237,2024-11-18T15:11:21,ACC00005356,Transfer,789.96,-1622779.77,EUR,Restaurant
TXN0000018238,2024-03-16T22:07:25,ACC00009175,Debit,391.91,-1623171.68,JPY,Amazon
TXN0000018239,2024-03-01T14:55:31,ACC00005683,Payment,492.69,-1623664.37,GBP,Shell
TXN0000018240,2024-09-11T00:15:14,ACC00009413,Debit,809.11,-1624473.48,GBP,Grocery
TXN0000018241,2024-02-20T12:08:38,ACC00006346,Transfer,409.85,-1624063.63,EUR,Amazon
TXN0000018242,2024-11-28T22:47:56,ACC00001445,Payment,1098.54,-1625162.17,USD,Shell
TXN0000018243,2024-10-17T02:50:33,ACC00005726,Credit,509.51,-1624652.66,GBP,Starbucks
TXN0000018244,2024-03-13T08:55:52,ACC00003400,Debit,311.38,-1624964.04,EUR,Target
TXN0000018245,2024-12-07T02:20:07,ACC00006262,Debit,365.08,-1625329.12,JPY,Starbucks
TXN0000018246,2024-11-07T19:39:15,ACC00001870,Transfer,1538.78,-1623790.34,USD,Grocery
TXN0000018247,2024-01-18T06:58:32,ACC00003559,ATM,1950.14,-1625740.48,GBP,Amazon
TXN0000018248,2024-03-18T11:50:04,ACC00001525,Payment,1091.56,-1626832.04,EUR,Walmart
TXN0000018249,2024-04-27T05:29:23,ACC00002862,ATM,78.08,-1626910.12,JPY,Restaurant
TXN0000018250,2024-10-01T12:44:17,ACC00009555,Payment,1471.51,-1628381.63,GBP,Shell
TXN0000018251,2024-12-06T00:43:04,ACC00006989,Transfer,1333.24,-1627048.39,USD,Amazon
TXN0000018252,2024-12-15T00:05:50,ACC00001191,Credit,1440.84,-1625607.55,JPY,Online Store
TXN0000018253,2024-01-09T14:13:13,ACC00008818,Debit,1609.52,-1627217.07,USD,Walmart
TXN0000018254,2024-05-14T09:04:12,ACC00005761,ATM,505.32,-1627722.39,JPY,Amazon
TXN0000018255,2024-08-20T08:10:39,ACC00000317,ATM,871.33,-1628593.72,GBP,Walmart
TXN0000018256,2024-09-24T06:52:03,ACC00000832,ATM,468.43,-1629062.15,EUR,Shell
TXN0000018257,2024-06-01T19:47:24,ACC00005199,Transfer,899.54,-1628162.61,USD,Target
TXN0000018258,2024-02-14T12:25:08,ACC00007235,Payment,928.74,-1629091.35,USD,Amazon
TXN0000018259,2024-07-14T12:38:10,ACC00007169,ATM,820.75,-1629912.1,USD,Shell
TXN0000018260,2024-08-06T20:58:45,ACC00007012,Debit,1875.79,-1631787.89,EUR,Amazon
TXN0000018261,2024-06-13T04:50:13,ACC00008823,ATM,1691.7,-1633479.59,USD,Walmart
TXN0000018262,2024-12-24T12:21:04,ACC00008620,ATM,1589.54,-1635069.13,EUR,Restaurant
TXN0000018263,2024-03-28T20:56:19,ACC00007231,ATM,1602.8,-1636671.93,USD,Grocery
TXN0000018264,2024-07-18T11:51:41,ACC00004554,ATM,762.79,-1637434.72,USD,Walmart
TXN0000018265,2024-01-31T03:13:14,ACC00004391,Payment,1465.13,-1638899.85,JPY,Online Store
TXN0000018266,2024-01-01T20:40:03,ACC00005492,Credit,116.39,-1638783.46,GBP,Starbucks
TXN0000018267,2024-12-09T00:48:22,ACC00002679,ATM,1969.59,-1640753.05,JPY,Amazon
TXN0000018268,2024-10-07T14:45:39,ACC00002976,Debit,1909.4,-1642662.45,GBP,Amazon
TXN0000018269,2024-04-28T10:58:30,ACC00005651,Transfer,1361.85,-1641300.6,USD,Starbucks
TXN0000018270,2024-07-08T20:22:49,ACC00005955,Debit,1160.44,-1642461.04,JPY,Amazon
TXN0000018271,2024-02-15T07:48:31,ACC00002707,Payment,1349.01,-1643810.05,JPY,Walmart
TXN0000018272,2024-06-30T06:34:07,ACC00009694,ATM,1322.87,-1645132.92,JPY,Walmart
TXN0000018273,2024-03-04T08:24:03,ACC00000632,Debit,855.37,-1645988.29,USD,Walmart
TXN0000018274,2024-02-05T08:37:54,ACC00001202,Credit,571.76,-1645416.53,GBP,Starbucks
TXN0000018275,2024-07-10T04:36:19,ACC00005832,ATM,1654.34,-1647070.87,EUR,Amazon
TXN0000018276,2024-12-20T16:34:39,ACC00008303,ATM,706.34,-1647777.21,JPY,Walmart
TXN0000018277,2024-03-23T18:03:57,ACC00008562,ATM,512.49,-1648289.7,USD,Starbucks
TXN0000018278,2024-05-11T13:47:03,ACC00009301,Payment,155.83,-1648445.53,GBP,Restaurant
TXN0000018279,2024-09-11T11:31:24,ACC00005121,Debit,1324.88,-1649770.41,EUR,Amazon
TXN0000018280,2024-08-10T09:52:43,ACC00004951,ATM,1919.12,-1651689.53,USD,Amazon
TXN0000018281,2024-01-08T02:37:28,ACC00001748,ATM,1493.16,-1653182.69,EUR,Shell
TXN0000018282,2024-10-19T18:10:03,ACC00006224,Payment,18.92,-1653201.61,JPY,Starbucks
TXN0000018283,2024-02-14T22:06:05,ACC00007728,ATM,1201.08,-1654402.69,EUR,Online Store
TXN0000018284,2024-10-16T04:42:05,ACC00005995,ATM,1421.7,-1655824.39,EUR,Restaurant
TXN0000018285,2024-12-10T23:49:11,ACC00003252,Debit,806.91,-1656631.3,GBP,Grocery
TXN0000018286,2024-12-23T04:19:49,ACC00005040,Debit,959.57,-1657590.87,GBP,Restaurant
TXN0000018287,2024-08-14T01:12:30,ACC00006690,Credit,359.02,-1657231.85,GBP,Amazon
TXN0000018288,2024-10-28T11:35:07,ACC00000804,Credit,1627.78,-1655604.07,JPY,Amazon
TXN0000018289,2024-04-24T18:14:58,ACC00005469,Payment,1200.53,-1656804.6,EUR,Restaurant
TXN0000018290,2024-12-13T15:23:36,ACC00002213,ATM,45.19,-1656849.79,GBP,Walmart
TXN0000018291,2024-05-07T21:17:10,ACC00007032,ATM,123.49,-1656973.28,JPY,Target
TXN0000018292,2024-10-31T06:25:07,ACC00008274,Payment,1052.16,-1658025.44,EUR,Restaurant
TXN0000018293,2024-09-20T12:16:10,ACC00003643,Debit,1566.54,-1659591.98,USD,Amazon
TXN0000018294,2024-10-12T12:01:53,ACC00009978,Payment,513.92,-1660105.9,JPY,Grocery
TXN0000018295,2024-05-28T00:29:29,ACC00007159,ATM,654.84,-1660760.74,JPY,Target
TXN0000018296,2024-06-22T11:48:57,ACC00003411,Payment,1111.67,-1661872.41,GBP,Walmart
TXN0000018297,2024-06-22T08:55:43,ACC00005967,Debit,1264.7,-1663137.11,GBP,Restaurant
TXN0000018298,2024-11-13T22:41:52,ACC00008610,Payment,1315.81,-1664452.92,EUR,Shell
TXN0000018299,2024-01-24T04:31:03,ACC00004593,ATM,1959.8,-1666412.72,JPY,Walmart
TXN0000018300,2024-08-15T05:09:52,ACC00003616,Transfer,682.88,-1665729.84,JPY,Target
TXN0000018301,2024-09-05T21:26:19,ACC00008663,Transfer,1155.0,-1664574.84,USD,Walmart
TXN0000018302,2024-12-13T07:27:25,ACC00007828,Payment,601.14,-1665175.98,GBP,Online Store
TXN0000018303,2024-01-12T04:29:00,ACC00007630,Transfer,1679.61,-1663496.37,USD,Amazon
TXN0000018304,2024-04-15T06:32:44,ACC00002458,Credit,1960.51,-1661535.86,USD,Amazon
TXN0000018305,2024-04-13T21:11:02,ACC00006560,Debit,1979.28,-1663515.14,GBP,Shell
TXN0000018306,2024-11-17T10:55:50,ACC00001959,Debit,276.75,-1663791.89,EUR,Restaurant
TXN0000018307,2024-07-12T17:33:56,ACC00006292,Debit,1624.33,-1665416.22,GBP,Walmart
TXN0000018308,2024-06-06T19:54:01,ACC00006428,Credit,584.8,-1664831.42,GBP,Shell
TXN0000018309,2024-05-15T11:22:20,ACC00009240,Debit,1230.3,-1666061.72,USD,Walmart
TXN0000018310,2024-07-31T08:24:19,ACC00000939,ATM,1731.43,-1667793.15,USD,Online Store
TXN0000018311,2024-02-16T11:02:21,ACC00001903,ATM,757.0,-1668550.15,GBP,Walmart
TXN0000018312,2024-07-05T17:48:08,ACC00008026,Payment,776.57,-1669326.72,EUR,Target
TXN0000018313,2024-08-20T11:47:58,ACC00005563,Credit,61.49,-1669265.23,EUR,Grocery
TXN0000018314,2024-11-02T11:09:49,ACC00002851,Credit,617.38,-1668647.85,GBP,Shell
TXN0000018315,2024-11-21T10:24:16,ACC00007293,Payment,1359.3,-1670007.15,EUR,Online Store
TXN0000018316,2024-02-19T20:57:30,ACC00001850,ATM,1931.4,-1671938.55,USD,Restaurant
TXN0000018317,2024-04-22T17:54:13,ACC00009379,ATM,594.07,-1672532.62,USD,Shell
TXN0000018318,2024-11-01T04:19:47,ACC00005268,Debit,781.02,-1673313.64,JPY,Online Store
TXN0000018319,2024-09-10T08:29:41,ACC00009584,Payment,1692.5,-1675006.14,JPY,Target
TXN0000018320,2024-04-16T21:52:28,ACC00005641,Transfer,516.24,-1674489.9,USD,Shell
TXN0000018321,2024-07-21T22:26:45,ACC00000342,Transfer,951.15,-1673538.75,EUR,Grocery
TXN0000018322,2024-07-29T04:12:12,ACC00003423,Debit,1032.21,-1674570.96,JPY,Restaurant
TXN0000018323,2024-02-18T12:38:32,ACC00002081,Transfer,1545.96,-1673025.0,JPY,Starbucks
TXN0000018324,2024-01-16T04:17:29,ACC00004049,Transfer,813.93,-1672211.07,EUR,Shell
TXN0000018325,2024-08-25T05:32:36,ACC00008564,Debit,1573.89,-1673784.96,GBP,Target
TXN0000018326,2024-02-03T09:55:31,ACC00008647,Debit,1360.06,-1675145.02,GBP,Walmart
TXN0000018327,2024-05-26T12:02:02,ACC00003116,Debit,229.62,-1675374.64,GBP,Amazon
TXN0000018328,2024-11-07T03:04:35,ACC00006346,ATM,1182.98,-1676557.62,JPY,Walmart
TXN0000018329,2024-10-12T22:50:40,ACC00000023,Credit,1771.73,-1674785.89,EUR,Grocery
TXN0000018330,2024-02-07T21:28:45,ACC00004361,Credit,1585.75,-1673200.14,EUR,Online Store
TXN0000018331,2024-05-04T06:23:50,ACC00006112,Transfer,1156.2,-1672043.94,GBP,Target
TXN0000018332,2024-03-26T23:58:31,ACC00000528,Debit,466.9,-1672510.84,EUR,Target
TXN0000018333,2024-07-11T02:12:16,ACC00008329,Credit,303.26,-1672207.58,JPY,Target
TXN0000018334,2024-05-21T04:31:50,ACC00007282,Transfer,1736.42,-1670471.16,USD,Online Store
TXN0000018335,2024-04-30T13:26:58,ACC00000492,Debit,1551.48,-1672022.64,USD,Online Store
TXN0000018336,2024-01-25T15:04:54,ACC00002419,Payment,1162.83,-1673185.47,USD,Walmart
TXN0000018337,2024-03-21T17:55:16,ACC00007257,Payment,862.93,-1674048.4,EUR,Target
TXN0000018338,2024-06-01T04:22:06,ACC00008163,ATM,809.22,-1674857.62,EUR,Grocery
TXN0000018339,2024-02-25T15:57:47,ACC00003805,Debit,665.27,-1675522.89,EUR,Starbucks
TXN0000018340,2024-01-10T20:17:30,ACC00000103,Transfer,1732.39,-1673790.5,EUR,Target
TXN0000018341,2024-06-06T07:54:22,ACC00000636,Transfer,74.28,-1673716.22,JPY,Shell
TXN0000018342,2024-05-17T23:02:36,ACC00000871,ATM,1925.37,-1675641.59,EUR,Starbucks
TXN0000018343,2024-07-27T10:32:27,ACC00006510,Transfer,1867.07,-1673774.52,EUR,Shell
TXN0000018344,2024-05-12T01:48:34,ACC00002260,Payment,121.46,-1673895.98,EUR,Shell
TXN0000018345,2024-09-25T12:22:17,ACC00004995,ATM,1883.05,-1675779.03,GBP,Restaurant
TXN0000018346,2024-04-27T11:34:29,ACC00005160,Transfer,1384.38,-1674394.65,JPY,Shell
TXN0000018347,2024-01-31T20:06:31,ACC00008281,Credit,376.2,-1674018.45,GBP,Amazon
TXN0000018348,2024-10-23T15:35:20,ACC00004590,Credit,722.7,-1673295.75,EUR,Starbucks
TXN0000018349,2024-12-25T08:51:30,ACC00001318,Payment,103.44,-1673399.19,EUR,Online Store
TXN0000018350,2024-11-01T02:56:29,ACC00001786,Debit,459.32,-1673858.51,GBP,Starbucks
TXN0000018351,2024-08-25T12:57:11,ACC00001385,Debit,985.6,-1674844.11,USD,Restaurant
TXN0000018352,2024-10-30T01:16:55,ACC00007837,ATM,732.99,-1675577.1,EUR,Grocery
TXN0000018353,2024-11-29T03:20:35,ACC00006392,Payment,1660.59,-1677237.69,GBP,Amazon
TXN0000018354,2024-08-11T16:37:43,ACC00006738,Debit,183.64,-1677421.33,USD,Online Store
TXN0000018355,2024-10-14T11:26:33,ACC00003925,Transfer,1845.97,-1675575.36,EUR,Restaurant
TXN0000018356,2024-09-21T07:50:38,ACC00005464,Payment,1664.02,-1677239.38,EUR,Walmart
TXN0000018357,2024-08-19T20:16:11,ACC00006855,Debit,1524.05,-1678763.43,EUR,Online Store
TXN0000018358,2024-07-09T16:13:28,ACC00004424,Debit,347.83,-1679111.26,EUR,Starbucks
TXN0000018359,2024-03-17T10:04:54,ACC00009428,Payment,575.97,-1679687.23,GBP,Restaurant
TXN0000018360,2024-12-28T23:38:12,ACC00006541,Credit,1372.02,-1678315.21,JPY,Online Store
TXN0000018361,2024-06-06T16:03:09,ACC00001088,Transfer,798.73,-1677516.48,JPY,Shell
TXN0000018362,2024-05-01T21:43:55,ACC00002615,ATM,119.96,-1677636.44,EUR,Online Store
TXN0000018363,2024-12-21T07:53:46,ACC00001671,Payment,1921.0,-1679557.44,EUR,Restaurant
TXN0000018364,2024-09-20T19:55:41,ACC00006644,Debit,1058.02,-1680615.46,GBP,Walmart
TXN0000018365,2024-09-17T05:23:25,ACC00000984,Transfer,1495.8,-1679119.66,EUR,Amazon
TXN0000018366,2024-09-17T21:27:02,ACC00003075,Credit,127.98,-1678991.68,EUR,Target
TXN0000018367,2024-11-24T16:57:36,ACC00001124,Debit,271.64,-1679263.32,GBP,Restaurant
TXN0000018368,2024-01-24T19:57:01,ACC00000254,Transfer,1861.1,-1677402.22,USD,Grocery
TXN0000018369,2024-10-20T15:46:35,ACC00003737,Credit,458.9,-1676943.32,EUR,Walmart
TXN0000018370,2024-11-12T16:14:12,ACC00000153,Credit,425.52,-1676517.8,JPY,Amazon
TXN0000018371,2024-03-20T07:37:58,ACC00001229,Payment,1510.95,-1678028.75,EUR,Amazon
TXN0000018372,2024-08-13T09:40:41,ACC00000305,Payment,1071.2,-1679099.95,EUR,Grocery
TXN0000018373,2024-03-29T10:31:28,ACC00003466,Credit,52.44,-1679047.51,EUR,Walmart
TXN0000018374,2024-11-28T15:03:52,ACC00000184,Credit,1026.71,-1678020.8,EUR,Target
TXN0000018375,2024-10-27T07:54:25,ACC00005299,Payment,469.85,-1678490.65,USD,Target
TXN0000018376,2024-07-24T01:38:56,ACC00006851,ATM,1333.39,-1679824.04,GBP,Shell
TXN0000018377,2024-09-12T01:10:03,ACC00008517,Credit,623.78,-1679200.26,EUR,Online Store
TXN0000018378,2024-05-18T00:37:37,ACC00001398,Credit,1580.01,-1677620.25,GBP,Online Store
TXN0000018379,2024-08-21T22:25:12,ACC00001524,Payment,1488.76,-1679109.01,USD,Walmart
TXN0000018380,2024-02-23T03:31:59,ACC00003667,Transfer,1737.4,-1677371.61,USD,Online Store
TXN0000018381,2024-12-08T09:54:36,ACC00008903,Credit,503.55,-1676868.06,USD,Target
TXN0000018382,2024-01-18T02:03:54,ACC00003557,ATM,1875.67,-1678743.73,GBP,Target
TXN0000018383,2024-10-26T05:37:31,ACC00002773,Transfer,1523.62,-1677220.11,USD,Grocery
TXN0000018384,2024-09-22T10:41:24,ACC00003124,Credit,1787.3,-1675432.81,USD,Starbucks
TXN0000018385,2024-08-04T06:52:57,ACC00004170,ATM,1907.67,-1677340.48,JPY,Target
TXN0000018386,2024-11-23T01:04:39,ACC00009946,ATM,1382.77,-1678723.25,GBP,Starbucks
TXN0000018387,2024-12-22T05:11:28,ACC00004007,Transfer,1723.17,-1677000.08,JPY,Online Store
TXN0000018388,2024-07-20T04:37:42,ACC00004108,Debit,1739.5,-1678739.58,JPY,Online Store
TXN0000018389,2024-09-07T16:51:16,ACC00003221,Transfer,924.04,-1677815.54,GBP,Online Store
TXN0000018390,2024-01-12T06:39:32,ACC00007401,Transfer,1399.57,-1676415.97,JPY,Walmart
TXN0000018391,2024-10-18T06:16:28,ACC00005452,Debit,1520.1,-1677936.07,USD,Amazon
TXN0000018392,2024-01-01T16:43:02,ACC00006630,Transfer,768.16,-1677167.91,USD,Amazon
TXN0000018393,2024-08-24T12:21:24,ACC00008155,Credit,1027.56,-1676140.35,USD,Restaurant
TXN0000018394,2024-08-28T09:34:36,ACC00005067,Transfer,1782.21,-1674358.14,EUR,Starbucks
TXN0000018395,2024-03-31T12:06:06,ACC00005443,ATM,1611.01,-1675969.15,JPY,Target
TXN0000018396,2024-06-27T09:15:03,ACC00001652,Payment,1212.49,-1677181.64,GBP,Grocery
TXN0000018397,2024-10-31T12:37:22,ACC00004110,Transfer,1975.25,-1675206.39,USD,Target
TXN0000018398,2024-10-06T20:43:12,ACC00006123,Debit,1558.28,-1676764.67,GBP,Target
TXN0000018399,2024-04-19T20:55:23,ACC00009950,Credit,884.3,-1675880.37,JPY,Restaurant
TXN0000018400,2024-12-06T17:02:38,ACC00004650,ATM,920.34,-1676800.71,EUR,Starbucks
TXN0000018401,2024-01-07T19:46:27,ACC00009625,Payment,1114.99,-1677915.7,JPY,Starbucks
TXN0000018402,2024-06-24T13:38:41,ACC00006492,Debit,830.64,-1678746.34,GBP,Walmart
TXN0000018403,2024-09-17T13:35:47,ACC00001625,Payment,1700.02,-1680446.36,EUR,Shell
TXN0000018404,2024-01-16T21:01:21,ACC00003150,ATM,1874.52,-1682320.88,USD,Walmart
TXN0000018405,2024-11-21T02:32:42,ACC00008870,Debit,598.5,-1682919.38,USD,Restaurant
TXN0000018406,2024-06-19T11:14:49,ACC00004494,ATM,1906.71,-1684826.09,EUR,Online Store
TXN0000018407,2024-12-30T17:56:47,ACC00003151,Payment,671.09,-1685497.18,USD,Walmart
TXN0000018408,2024-04-11T20:57:05,ACC00008946,Credit,529.91,-1684967.27,EUR,Grocery
TXN0000018409,2024-08-01T10:19:06,ACC00004328,Payment,1293.51,-1686260.78,GBP,Amazon
TXN0000018410,2024-10-22T08:45:53,ACC00000788,ATM,1740.35,-1688001.13,USD,Amazon
TXN0000018411,2024-04-05T10:57:45,ACC00000162,Transfer,1645.02,-1686356.11,EUR,Shell
TXN0000018412,2024-09-16T22:58:54,ACC00009319,Transfer,757.47,-1685598.64,USD,Shell
TXN0000018413,2024-09-29T11:43:55,ACC00000954,Debit,641.4,-1686240.04,GBP,Grocery
TXN0000018414,2024-12-07T18:08:23,ACC00001012,Debit,604.31,-1686844.35,GBP,Starbucks
TXN0000018415,2024-12-16T18:36:39,ACC00007593,Transfer,1366.04,-1685478.31,GBP,Online Store
TXN0000018416,2024-11-10T18:29:39,ACC00009707,Transfer,973.17,-1684505.14,GBP,Walmart
TXN0000018417,2024-03-31T09:25:25,ACC00001456,Debit,1946.57,-1686451.71,EUR,Grocery
TXN0000018418,2024-06-18T14:41:01,ACC00004887,Debit,651.26,-1687102.97,JPY,Starbucks
TXN0000018419,2024-01-25T08:49:26,ACC00001859,ATM,75.57,-1687178.54,JPY,Grocery
TXN0000018420,2024-10-13T01:31:17,ACC00002424,Payment,1039.77,-1688218.31,JPY,Walmart
TXN0000018421,2024-12-12T11:24:18,ACC00009120,Debit,1552.97,-1689771.28,GBP,Starbucks
TXN0000018422,2024-04-03T22:14:35,ACC00001307,Transfer,665.92,-1689105.36,EUR,Amazon
TXN0000018423,2024-04-28T11:34:02,ACC00006720,Transfer,1818.62,-1687286.74,GBP,Restaurant
TXN0000018424,2024-07-01T05:18:12,ACC00007213,ATM,503.15,-1687789.89,JPY,Walmart
TXN0000018425,2024-09-01T21:44:51,ACC00009863,Payment,1125.57,-1688915.46,USD,Shell
TXN0000018426,2024-12-05T20:14:12,ACC00004338,Payment,664.59,-1689580.05,GBP,Amazon
TXN0000018427,2024-01-24T18:26:17,ACC00009026,ATM,764.34,-1690344.39,USD,Grocery
TXN0000018428,2024-03-16T00:26:38,ACC00002594,ATM,164.01,-1690508.4,JPY,Target
TXN0000018429,2024-03-24T00:06:43,ACC00009300,Payment,305.53,-1690813.93,JPY,Target
TXN0000018430,2024-05-13T19:54:06,ACC00009711,Credit,1294.58,-1689519.35,GBP,Grocery
TXN0000018431,2024-02-08T07:07:38,ACC00007079,Payment,1143.81,-1690663.16,GBP,Restaurant
TXN0000018432,2024-07-03T18:50:37,ACC00006840,ATM,108.77,-1690771.93,JPY,Online Store
TXN0000018433,2024-01-16T01:11:32,ACC00007668,ATM,58.05,-1690829.98,GBP,Target
TXN0000018434,2024-06-29T05:14:00,ACC00007901,ATM,526.58,-1691356.56,JPY,Online Store
TXN0000018435,2024-05-12T07:54:12,ACC00005887,Debit,169.52,-1691526.08,EUR,Restaurant
TXN0000018436,2024-12-24T17:29:59,ACC00005358,ATM,1153.28,-1692679.36,GBP,Amazon
TXN0000018437,2024-06-20T11:09:42,ACC00005403,Transfer,1147.31,-1691532.05,JPY,Walmart
TXN0000018438,2024-07-25T20:44:31,ACC00003977,Payment,1172.09,-1692704.14,USD,Walmart
TXN0000018439,2024-02-10T05:39:57,ACC00000618,Debit,1766.28,-1694470.42,EUR,Amazon
TXN0000018440,2024-03-01T04:44:35,ACC00008165,ATM,699.96,-1695170.38,EUR,Target
TXN0000018441,2024-09-06T15:48:37,ACC00006149,Transfer,20.58,-1695149.8,JPY,Online Store
TXN0000018442,2024-05-25T16:29:09,ACC00003176,ATM,812.63,-1695962.43,EUR,Target
TXN0000018443,2024-05-25T23:47:01,ACC00007084,Payment,1303.69,-1697266.12,GBP,Amazon
TXN0000018444,2024-05-20T11:44:07,ACC00008481,Credit,1821.63,-1695444.49,USD,Shell
TXN0000018445,2024-07-24T18:32:03,ACC00008811,Payment,1296.3,-1696740.79,JPY,Grocery
TXN0000018446,2024-04-15T14:00:01,ACC00000421,Payment,153.6,-1696894.39,GBP,Shell
TXN0000018447,2024-07-27T23:43:35,ACC00001926,Credit,1234.84,-1695659.55,USD,Grocery
TXN0000018448,2024-05-30T00:51:00,ACC00009101,ATM,81.02,-1695740.57,EUR,Starbucks
TXN0000018449,2024-12-23T03:10:45,ACC00007485,Payment,152.57,-1695893.14,GBP,Restaurant
TXN0000018450,2024-05-11T05:48:34,ACC00008130,Debit,713.92,-1696607.06,EUR,Walmart
TXN0000018451,2024-07-16T13:32:30,ACC00006712,Debit,1065.5,-1697672.56,JPY,Online Store
TXN0000018452,2024-12-26T07:02:49,ACC00006174,Payment,1361.06,-1699033.62,GBP,Online Store
TXN0000018453,2024-12-02T05:38:02,ACC00002622,Debit,353.46,-1699387.08,USD,Grocery
TXN0000018454,2024-08-05T21:46:52,ACC00001931,Credit,67.47,-1699319.61,EUR,Walmart
TXN0000018455,2024-10-27T17:29:48,ACC00009523,Payment,1346.08,-1700665.69,JPY,Starbucks
TXN0000018456,2024-10-01T14:58:11,ACC00001778,Credit,561.81,-1700103.88,USD,Amazon
TXN0000018457,2024-10-24T15:00:13,ACC00004033,ATM,1239.14,-1701343.02,USD,Shell
TXN0000018458,2024-07-28T20:59:49,ACC00004645,Credit,602.83,-1700740.19,EUR,Restaurant
TXN0000018459,2024-08-21T17:56:14,ACC00007763,Payment,241.87,-1700982.06,USD,Amazon
TXN0000018460,2024-12-20T18:18:17,ACC00006269,Payment,852.01,-1701834.07,JPY,Starbucks
TXN0000018461,2024-12-04T23:55:06,ACC00003136,Transfer,1295.0,-1700539.07,EUR,Restaurant
TXN0000018462,2024-07-27T11:08:01,ACC00009346,ATM,126.5,-1700665.57,JPY,Target
TXN0000018463,2024-12-12T06:20:37,ACC00006157,Payment,384.86,-1701050.43,EUR,Walmart
TXN0000018464,2024-07-04T01:07:38,ACC00001201,Transfer,863.07,-1700187.36,JPY,Restaurant
TXN0000018465,2024-03-08T04:30:21,ACC00002473,ATM,1686.95,-1701874.31,GBP,Grocery
TXN0000018466,2024-03-05T08:19:52,ACC00003395,Debit,1132.96,-1703007.27,USD,Shell
TXN0000018467,2024-02-10T05:55:27,ACC00006112,Debit,1419.84,-1704427.11,JPY,Restaurant
TXN0000018468,2024-12-15T08:37:46,ACC00004744,ATM,1627.56,-1706054.67,JPY,Target
TXN0000018469,2024-09-30T04:41:22,ACC00005206,Transfer,1939.93,-1704114.74,USD,Shell
TXN0000018470,2024-05-06T05:18:35,ACC00001492,ATM,129.37,-1704244.11,JPY,Online Store
TXN0000018471,2024-02-04T17:30:09,ACC00008784,Debit,903.41,-1705147.52,EUR,Online Store
TXN0000018472,2024-04-25T01:39:39,ACC00003721,Payment,217.42,-1705364.94,USD,Shell
TXN0000018473,2024-04-10T12:16:44,ACC00004535,ATM,387.57,-1705752.51,GBP,Shell
TXN0000018474,2024-05-16T20:49:42,ACC00005147,Credit,1538.54,-1704213.97,USD,Shell
TXN0000018475,2024-03-08T00:48:00,ACC00000717,Transfer,1007.68,-1703206.29,JPY,Target
TXN0000018476,2024-03-26T00:28:09,ACC00009520,Debit,1041.06,-1704247.35,EUR,Grocery
TXN0000018477,2024-08-10T08:26:10,ACC00004230,Payment,1149.85,-1705397.2,JPY,Starbucks
TXN0000018478,2024-04-22T09:07:27,ACC00008648,Transfer,758.71,-1704638.49,JPY,Starbucks
TXN0000018479,2024-05-31T02:51:57,ACC00001728,Payment,476.7,-1705115.19,USD,Amazon
TXN0000018480,2024-11-09T19:28:20,ACC00005765,Credit,1345.59,-1703769.6,JPY,Walmart
TXN0000018481,2024-06-06T12:24:37,ACC00005810,Debit,1694.88,-1705464.48,JPY,Online Store
TXN0000018482,2024-10-22T15:05:18,ACC00009185,Credit,575.87,-1704888.61,GBP,Walmart
TXN0000018483,2024-08-17T08:50:58,ACC00005012,Payment,782.71,-1705671.32,GBP,Shell
TXN0000018484,2024-02-29T12:19:03,ACC00007490,ATM,354.08,-1706025.4,JPY,Walmart
TXN0000018485,2024-06-14T01:24:05,ACC00009726,ATM,715.24,-1706740.64,USD,Starbucks
TXN0000018486,2024-06-17T19:02:47,ACC00000252,ATM,1879.88,-1708620.52,USD,Walmart
TXN0000018487,2024-05-21T17:05:30,ACC00009392,Transfer,1206.44,-1707414.08,JPY,Starbucks
TXN0000018488,2024-03-03T18:14:12,ACC00007194,Payment,16.27,-1707430.35,JPY,Restaurant
TXN0000018489,2024-11-18T09:15:44,ACC00005956,ATM,1904.24,-1709334.59,GBP,Online Store
TXN0000018490,2024-12-18T21:29:17,ACC00002042,ATM,834.8,-1710169.39,USD,Restaurant
TXN0000018491,2024-08-11T10:26:41,ACC00004872,Payment,474.83,-1710644.22,USD,Walmart
TXN0000018492,2024-05-15T00:10:18,ACC00008436,Credit,204.92,-1710439.3,JPY,Target
TXN0000018493,2024-05-24T20:20:53,ACC00006187,ATM,514.28,-1710953.58,JPY,Grocery
TXN0000018494,2024-10-29T18:28:59,ACC00004752,Transfer,1072.88,-1709880.7,EUR,Walmart
TXN0000018495,2024-05-31T11:31:05,ACC00008474,Payment,489.83,-1710370.53,USD,Amazon
TXN0000018496,2024-08-10T07:26:10,ACC00007460,Credit,719.54,-1709650.99,GBP,Grocery
TXN0000018497,2024-09-13T05:18:38,ACC00001960,Credit,214.7,-1709436.29,JPY,Online Store
TXN0000018498,2024-03-13T06:43:34,ACC00001067,Transfer,1978.52,-1707457.77,GBP,Shell
TXN0000018499,2024-05-01T18:04:18,ACC00002753,Payment,278.85,-1707736.62,USD,Walmart
TXN0000018500,2024-03-10T13:00:03,ACC00000891,ATM,488.66,-1708225.28,JPY,Amazon
TXN0000018501,2024-04-03T00:11:43,ACC00000039,Debit,667.48,-1708892.76,EUR,Amazon
TXN0000018502,2024-03-01T19:04:11,ACC00004176,Debit,644.04,-1709536.8,GBP,Restaurant
TXN0000018503,2024-11-20T11:56:34,ACC00002122,Transfer,1612.36,-1707924.44,EUR,Target
TXN0000018504,2024-09-16T23:08:40,ACC00006840,Payment,190.71,-1708115.15,GBP,Target
TXN0000018505,2024-08-20T14:12:14,ACC00004909,Transfer,86.02,-1708029.13,GBP,Restaurant
TXN0000018506,2024-07-16T14:52:38,ACC00000301,Payment,619.71,-1708648.84,EUR,Online Store
TXN0000018507,2024-04-06T09:03:25,ACC00005083,Debit,1970.75,-1710619.59,USD,Shell
TXN0000018508,2024-06-08T11:00:54,ACC00008198,Debit,738.92,-1711358.51,GBP,Amazon
TXN0000018509,2024-05-11T12:39:41,ACC00009784,Transfer,1493.44,-1709865.07,GBP,Grocery
TXN0000018510,2024-10-17T16:28:16,ACC00008242,Transfer,1605.86,-1708259.21,EUR,Starbucks
TXN0000018511,2024-05-12T03:03:51,ACC00007022,Transfer,770.1,-1707489.11,JPY,Restaurant
TXN0000018512,2024-04-02T02:29:20,ACC00003470,Payment,953.63,-1708442.74,GBP,Shell
TXN0000018513,2024-09-21T00:01:52,ACC00000532,Payment,443.33,-1708886.07,EUR,Online Store
TXN0000018514,2024-02-06T18:15:40,ACC00008084,Debit,1678.61,-1710564.68,USD,Shell
TXN0000018515,2024-06-09T18:35:49,ACC00000751,Debit,627.66,-1711192.34,JPY,Grocery
TXN0000018516,2024-12-05T19:39:41,ACC00005862,Debit,78.57,-1711270.91,GBP,Shell
TXN0000018517,2024-06-10T12:12:05,ACC00005647,Credit,817.16,-1710453.75,GBP,Walmart
TXN0000018518,2024-12-23T23:04:01,ACC00007005,Payment,833.08,-1711286.83,JPY,Online Store
TXN0000018519,2024-06-29T05:13:31,ACC00003167,Debit,809.07,-1712095.9,JPY,Amazon
TXN0000018520,2024-08-31T12:36:00,ACC00006419,Payment,667.38,-1712763.28,EUR,Walmart
TXN0000018521,2024-05-07T12:22:14,ACC00007451,Credit,858.94,-1711904.34,JPY,Target
TXN0000018522,2024-10-23T11:14:45,ACC00002935,Transfer,1103.79,-1710800.55,EUR,Restaurant
TXN0000018523,2024-11-21T13:00:18,ACC00005467,Transfer,475.24,-1710325.31,EUR,Online Store
TXN0000018524,2024-02-09T22:32:52,ACC00005615,Credit,1684.32,-1708640.99,GBP,Online Store
TXN0000018525,2024-09-12T10:15:29,ACC00005635,ATM,1670.81,-1710311.8,EUR,Grocery
TXN0000018526,2024-10-16T07:23:31,ACC00007546,Payment,1649.89,-1711961.69,EUR,Restaurant
TXN0000018527,2024-08-26T06:28:00,ACC00003665,ATM,1472.98,-1713434.67,JPY,Restaurant
TXN0000018528,2024-11-28T03:28:24,ACC00006986,Payment,580.02,-1714014.69,GBP,Starbucks
TXN0000018529,2024-06-06T12:57:30,ACC00008352,ATM,1912.02,-1715926.71,EUR,Starbucks
TXN0000018530,2024-10-16T06:28:25,ACC00008826,Transfer,1487.53,-1714439.18,JPY,Shell
TXN0000018531,2024-11-27T11:04:34,ACC00003299,Credit,1814.98,-1712624.2,GBP,Walmart
TXN0000018532,2024-06-11T04:23:54,ACC00007666,Debit,1641.03,-1714265.23,JPY,Grocery
TXN0000018533,2024-12-10T07:23:21,ACC00001071,Credit,354.38,-1713910.85,JPY,Shell
TXN0000018534,2024-11-23T11:11:48,ACC00003500,Credit,940.88,-1712969.97,USD,Shell
TXN0000018535,2024-07-31T15:45:58,ACC00002866,Payment,56.03,-1713026.0,GBP,Amazon
TXN0000018536,2024-01-20T12:05:27,ACC00008284,ATM,938.46,-1713964.46,JPY,Online Store
TXN0000018537,2024-11-24T23:19:47,ACC00008897,Payment,1826.86,-1715791.32,USD,Grocery
TXN0000018538,2024-04-06T11:00:33,ACC00003871,Credit,1381.33,-1714409.99,JPY,Target
TXN0000018539,2024-11-14T01:33:23,ACC00006583,Credit,332.87,-1714077.12,EUR,Online Store
TXN0000018540,2024-09-02T16:40:56,ACC00001456,Payment,760.53,-1714837.65,EUR,Online Store
TXN0000018541,2024-04-30T17:32:01,ACC00001528,Transfer,1007.65,-1713830.0,JPY,Amazon
TXN0000018542,2024-03-11T04:16:20,ACC00005266,Payment,167.52,-1713997.52,USD,Starbucks
TXN0000018543,2024-08-14T02:55:52,ACC00004866,Debit,1797.07,-1715794.59,EUR,Starbucks
TXN0000018544,2024-05-15T00:56:24,ACC00004510,Debit,1172.62,-1716967.21,USD,Restaurant
TXN0000018545,2024-02-23T09:57:22,ACC00009329,Credit,1243.26,-1715723.95,EUR,Starbucks
TXN0000018546,2024-05-26T17:55:44,ACC00006350,Payment,49.23,-1715773.18,EUR,Restaurant
TXN0000018547,2024-03-30T18:57:08,ACC00003450,Debit,1984.81,-1717757.99,GBP,Amazon
TXN0000018548,2024-09-25T01:23:59,ACC00004757,ATM,1760.36,-1719518.35,JPY,Starbucks
TXN0000018549,2024-03-24T15:26:29,ACC00005871,Debit,1721.97,-1721240.32,GBP,Starbucks
TXN0000018550,2024-04-19T22:27:07,ACC00004219,ATM,691.67,-1721931.99,GBP,Amazon
TXN0000018551,2024-09-17T21:23:01,ACC00008880,Debit,177.17,-1722109.16,EUR,Target
TXN0000018552,2024-10-30T02:05:04,ACC00005102,ATM,1791.25,-1723900.41,USD,Online Store
TXN0000018553,2024-03-10T06:24:47,ACC00007393,Debit,1173.3,-1725073.71,USD,Walmart
TXN0000018554,2024-09-17T23:00:14,ACC00007445,ATM,1728.88,-1726802.59,EUR,Walmart
TXN0000018555,2024-08-18T15:15:04,ACC00007679,Payment,851.64,-1727654.23,GBP,Amazon
TXN0000018556,2024-11-02T10:00:49,ACC00006302,ATM,1893.2,-1729547.43,EUR,Grocery
TXN0000018557,2024-01-03T18:24:12,ACC00002544,Transfer,1483.03,-1728064.4,USD,Starbucks
TXN0000018558,2024-09-18T11:26:45,ACC00007179,Credit,879.09,-1727185.31,EUR,Online Store
TXN0000018559,2024-07-06T14:51:39,ACC00005108,Payment,1103.9,-1728289.21,GBP,Starbucks
TXN0000018560,2024-03-13T03:09:31,ACC00009875,Debit,1049.33,-1729338.54,USD,Amazon
TXN0000018561,2024-07-21T08:31:39,ACC00002949,ATM,282.55,-1729621.09,JPY,Target
TXN0000018562,2024-08-02T21:56:53,ACC00009955,ATM,114.99,-1729736.08,GBP,Grocery
TXN0000018563,2024-08-24T05:38:56,ACC00009254,Credit,591.75,-1729144.33,USD,Walmart
TXN0000018564,2024-08-23T17:13:20,ACC00000388,Transfer,217.75,-1728926.58,EUR,Starbucks
TXN0000018565,2024-05-07T04:16:09,ACC00006206,ATM,987.73,-1729914.31,JPY,Restaurant
TXN0000018566,2024-03-15T09:43:21,ACC00000841,Transfer,550.91,-1729363.4,JPY,Starbucks
TXN0000018567,2024-05-25T23:12:04,ACC00008549,Payment,1238.75,-1730602.15,USD,Starbucks
TXN0000018568,2024-01-02T02:26:16,ACC00003689,Debit,1517.93,-1732120.08,JPY,Walmart
TXN0000018569,2024-11-25T03:54:21,ACC00003382,Payment,335.87,-1732455.95,USD,Shell
TXN0000018570,2024-04-11T20:28:06,ACC00000826,ATM,1450.37,-1733906.32,JPY,Starbucks
TXN0000018571,2024-11-22T23:16:00,ACC00001893,Payment,447.3,-1734353.62,JPY,Shell
TXN0000018572,2024-02-08T17:41:52,ACC00004887,Payment,1254.34,-1735607.96,JPY,Grocery
TXN0000018573,2024-04-07T16:07:35,ACC00005729,Payment,491.3,-1736099.26,JPY,Grocery
TXN0000018574,2024-03-21T21:43:31,ACC00008559,Transfer,1134.26,-1734965.0,EUR,Restaurant
TXN0000018575,2024-04-10T09:22:57,ACC00006368,Debit,1704.82,-1736669.82,EUR,Grocery
TXN0000018576,2024-03-03T18:54:18,ACC00007608,Payment,1063.38,-1737733.2,JPY,Walmart
TXN0000018577,2024-01-04T10:05:19,ACC00006467,Transfer,798.16,-1736935.04,GBP,Restaurant
TXN0000018578,2024-07-01T17:09:47,ACC00007283,ATM,1987.54,-1738922.58,USD,Starbucks
TXN0000018579,2024-11-02T16:56:51,ACC00004037,ATM,1013.9,-1739936.48,GBP,Online Store
TXN0000018580,2024-09-04T14:15:55,ACC00008937,Transfer,1025.86,-1738910.62,USD,Online Store
TXN0000018581,2024-08-15T16:47:15,ACC00009059,Payment,1537.21,-1740447.83,USD,Target
TXN0000018582,2024-08-08T06:32:51,ACC00002349,Debit,394.98,-1740842.81,EUR,Shell
TXN0000018583,2024-05-12T09:37:09,ACC00003776,Payment,408.08,-1741250.89,JPY,Target
TXN0000018584,2024-12-07T18:19:07,ACC00000089,Debit,1890.44,-1743141.33,USD,Online Store
TXN0000018585,2024-04-07T18:08:35,ACC00004928,ATM,845.11,-1743986.44,USD,Restaurant
TXN0000018586,2024-12-21T15:54:43,ACC00008147,Credit,1753.55,-1742232.89,EUR,Walmart
TXN0000018587,2024-01-09T12:56:17,ACC00002368,Debit,167.65,-1742400.54,JPY,Shell
TXN0000018588,2024-09-09T07:26:44,ACC00008467,Payment,998.39,-1743398.93,GBP,Shell
TXN0000018589,2024-03-06T12:58:42,ACC00005381,ATM,1446.69,-1744845.62,GBP,Online Store
TXN0000018590,2024-08-27T17:11:36,ACC00002199,ATM,1315.64,-1746161.26,JPY,Target
TXN0000018591,2024-07-30T03:10:39,ACC00009882,Credit,1942.3,-1744218.96,GBP,Online Store
TXN0000018592,2024-11-29T17:13:54,ACC00000426,Payment,1451.47,-1745670.43,GBP,Amazon
TXN0000018593,2024-09-08T03:46:58,ACC00003933,Transfer,1065.68,-1744604.75,JPY,Shell
TXN0000018594,2024-11-15T15:11:25,ACC00000860,ATM,1552.32,-1746157.07,EUR,Target
TXN0000018595,2024-08-02T14:13:48,ACC00006972,Debit,776.3,-1746933.37,GBP,Target
TXN0000018596,2024-06-17T16:40:50,ACC00000868,Debit,1851.95,-1748785.32,GBP,Restaurant
TXN0000018597,2024-12-20T19:45:14,ACC00003238,Debit,1988.45,-1750773.77,EUR,Amazon
TXN0000018598,2024-09-06T15:39:13,ACC00005023,Credit,1616.71,-1749157.06,EUR,Shell
TXN0000018599,2024-01-13T00:22:31,ACC00001235,Debit,1664.03,-1750821.09,EUR,Grocery
TXN0000018600,2024-02-29T09:18:27,ACC00001735,Payment,1315.63,-1752136.72,USD,Restaurant
TXN0000018601,2024-08-28T00:57:01,ACC00006142,Debit,274.28,-1752411.0,EUR,Target
TXN0000018602,2024-02-11T00:37:33,ACC00009760,ATM,1351.99,-1753762.99,USD,Restaurant
TXN0000018603,2024-05-20T05:15:31,ACC00001407,Payment,1730.39,-1755493.38,JPY,Walmart
TXN0000018604,2024-02-08T20:47:00,ACC00003153,Payment,368.21,-1755861.59,USD,Amazon
TXN0000018605,2024-03-23T23:15:58,ACC00007183,Credit,1189.66,-1754671.93,GBP,Walmart
TXN0000018606,2024-06-28T11:49:37,ACC00001941,ATM,1266.4,-1755938.33,EUR,Target
TXN0000018607,2024-06-16T14:03:39,ACC00003869,Credit,655.66,-1755282.67,JPY,Online Store
TXN0000018608,2024-07-07T20:08:57,ACC00008942,ATM,687.37,-1755970.04,USD,Shell
TXN0000018609,2024-08-30T12:38:44,ACC00007673,Transfer,664.77,-1755305.27,USD,Shell
TXN0000018610,2024-08-14T05:24:39,ACC00003124,Transfer,692.04,-1754613.23,EUR,Amazon
TXN0000018611,2024-07-08T12:46:13,ACC00008061,Payment,994.38,-1755607.61,GBP,Shell
TXN0000018612,2024-12-02T12:30:53,ACC00008215,Payment,503.42,-1756111.03,GBP,Starbucks
TXN0000018613,2024-08-27T08:44:31,ACC00007079,Payment,1037.41,-1757148.44,USD,Target
TXN0000018614,2024-07-05T23:46:00,ACC00004926,ATM,484.78,-1757633.22,JPY,Target
TXN0000018615,2024-02-29T16:59:42,ACC00002737,Transfer,1267.5,-1756365.72,USD,Shell
TXN0000018616,2024-10-28T21:10:53,ACC00003132,Payment,921.34,-1757287.06,GBP,Starbucks
TXN0000018617,2024-08-19T22:25:09,ACC00006809,ATM,1271.59,-1758558.65,USD,Restaurant
TXN0000018618,2024-02-06T12:46:26,ACC00004124,Credit,238.48,-1758320.17,JPY,Target
TXN0000018619,2024-06-10T21:25:08,ACC00000458,Debit,162.68,-1758482.85,EUR,Amazon
TXN0000018620,2024-12-19T21:03:29,ACC00003069,ATM,1406.37,-1759889.22,JPY,Starbucks
TXN0000018621,2024-08-02T20:58:07,ACC00006821,Debit,557.51,-1760446.73,USD,Walmart
TXN0000018622,2024-01-12T12:36:28,ACC00006695,Debit,1427.02,-1761873.75,GBP,Starbucks
TXN0000018623,2024-03-19T03:43:11,ACC00003690,Transfer,1703.22,-1760170.53,JPY,Starbucks
TXN0000018624,2024-05-07T16:28:37,ACC00002175,ATM,540.9,-1760711.43,GBP,Restaurant
TXN0000018625,2024-03-01T05:47:42,ACC00009536,Payment,1261.7,-1761973.13,EUR,Walmart
TXN0000018626,2024-10-31T16:09:08,ACC00007299,Credit,1148.2,-1760824.93,EUR,Walmart
TXN0000018627,2024-02-29T13:26:51,ACC00000797,Debit,630.8,-1761455.73,EUR,Amazon
TXN0000018628,2024-04-02T05:21:44,ACC00008114,Transfer,1544.92,-1759910.81,GBP,Starbucks
TXN0000018629,2024-05-31T09:01:24,ACC00004056,Transfer,1763.28,-1758147.53,JPY,Restaurant
TXN0000018630,2024-08-06T21:25:37,ACC00007829,Debit,1613.9,-1759761.43,JPY,Walmart
TXN0000018631,2024-03-20T09:35:17,ACC00003394,ATM,1372.18,-1761133.61,USD,Shell
TXN0000018632,2024-04-03T19:46:24,ACC00007233,Payment,1518.22,-1762651.83,EUR,Online Store
TXN0000018633,2024-05-04T04:34:52,ACC00004973,Credit,502.16,-1762149.67,JPY,Shell
TXN0000018634,2024-02-27T00:22:44,ACC00001083,ATM,721.45,-1762871.12,USD,Target
TXN0000018635,2024-11-27T09:06:41,ACC00004649,Transfer,581.02,-1762290.1,GBP,Walmart
TXN0000018636,2024-12-07T03:55:24,ACC00002278,Transfer,661.76,-1761628.34,GBP,Shell
TXN0000018637,2024-06-25T18:56:39,ACC00006467,Credit,1662.63,-1759965.71,USD,Amazon
TXN0000018638,2024-06-26T17:45:10,ACC00005408,ATM,380.45,-1760346.16,JPY,Walmart
TXN0000018639,2024-10-14T14:38:22,ACC00008240,Transfer,1216.65,-1759129.51,GBP,Amazon
TXN0000018640,2024-11-15T15:47:49,ACC00006325,Debit,1232.24,-1760361.75,GBP,Target
TXN0000018641,2024-09-05T10:15:35,ACC00008150,Debit,1057.14,-1761418.89,USD,Online Store
TXN0000018642,2024-01-18T22:22:20,ACC00002438,ATM,654.82,-1762073.71,USD,Starbucks
TXN0000018643,2024-06-06T18:28:09,ACC00003899,Credit,148.88,-1761924.83,EUR,Target
TXN0000018644,2024-12-19T11:42:03,ACC00000852,Payment,876.91,-1762801.74,EUR,Restaurant
TXN0000018645,2024-04-28T02:38:29,ACC00008314,Credit,386.52,-1762415.22,JPY,Shell
TXN0000018646,2024-12-04T12:16:29,ACC00002383,Debit,405.28,-1762820.5,JPY,Restaurant
TXN0000018647,2024-01-03T01:24:42,ACC00000105,ATM,1141.92,-1763962.42,GBP,Target
TXN0000018648,2024-10-13T03:10:10,ACC00005658,Payment,1000.93,-1764963.35,GBP,Starbucks
TXN0000018649,2024-08-12T16:55:43,ACC00008759,Credit,275.05,-1764688.3,EUR,Starbucks
TXN0000018650,2024-09-21T20:47:44,ACC00002578,Credit,1557.73,-1763130.57,JPY,Amazon
TXN0000018651,2024-06-06T00:54:47,ACC00009664,Debit,1587.95,-1764718.52,USD,Restaurant
TXN0000018652,2024-08-19T15:38:20,ACC00003145,Credit,60.88,-1764657.64,USD,Restaurant
TXN0000018653,2024-10-20T11:59:06,ACC00009872,Credit,1025.03,-1763632.61,EUR,Starbucks
TXN0000018654,2024-01-01T17:32:49,ACC00007064,Debit,864.37,-1764496.98,GBP,Walmart
TXN0000018655,2024-07-22T01:33:22,ACC00000848,ATM,1409.26,-1765906.24,GBP,Restaurant
TXN0000018656,2024-11-17T16:04:28,ACC00004522,ATM,1116.8,-1767023.04,USD,Target
TXN0000018657,2024-09-19T16:25:56,ACC00005306,Credit,1801.53,-1765221.51,JPY,Amazon
TXN0000018658,2024-04-04T04:14:49,ACC00002195,Transfer,1166.99,-1764054.52,USD,Walmart
TXN0000018659,2024-07-08T11:45:52,ACC00000068,Credit,902.01,-1763152.51,GBP,Amazon
TXN0000018660,2024-02-08T07:34:45,ACC00007527,Debit,1495.96,-1764648.47,GBP,Grocery
TXN0000018661,2024-05-28T04:11:48,ACC00007417,Payment,601.9,-1765250.37,GBP,Online Store
TXN0000018662,2024-08-08T09:35:26,ACC00005094,Credit,1839.35,-1763411.02,GBP,Amazon
TXN0000018663,2024-03-04T06:07:10,ACC00008412,ATM,1678.27,-1765089.29,GBP,Amazon
TXN0000018664,2024-04-19T10:18:13,ACC00003633,Debit,721.62,-1765810.91,USD,Walmart
TXN0000018665,2024-01-29T13:29:50,ACC00002557,ATM,189.42,-1766000.33,JPY,Shell
TXN0000018666,2024-02-17T07:21:15,ACC00007303,Debit,982.25,-1766982.58,USD,Target
TXN0000018667,2024-08-01T18:34:03,ACC00008735,Transfer,749.99,-1766232.59,USD,Amazon
TXN0000018668,2024-07-14T06:11:52,ACC00006026,Payment,57.2,-1766289.79,EUR,Shell
TXN0000018669,2024-11-10T09:21:29,ACC00001290,Debit,493.43,-1766783.22,JPY,Grocery
TXN0000018670,2024-07-03T18:54:16,ACC00007628,Transfer,953.1,-1765830.12,JPY,Grocery
TXN0000018671,2024-03-10T07:51:27,ACC00003523,Payment,1955.91,-1767786.03,JPY,Amazon
TXN0000018672,2024-04-02T00:33:53,ACC00000915,Payment,591.32,-1768377.35,EUR,Restaurant
TXN0000018673,2024-03-27T11:47:22,ACC00007601,Transfer,545.78,-1767831.57,JPY,Online Store
TXN0000018674,2024-05-21T06:59:21,ACC00005453,Credit,399.26,-1767432.31,GBP,Shell
TXN0000018675,2024-12-04T23:02:56,ACC00005463,ATM,1817.94,-1769250.25,USD,Starbucks
TXN0000018676,2024-12-13T02:15:46,ACC00000891,Credit,498.03,-1768752.22,JPY,Starbucks
TXN0000018677,2024-07-09T07:16:12,ACC00009716,Payment,1097.95,-1769850.17,EUR,Restaurant
TXN0000018678,2024-11-22T16:26:47,ACC00004309,Debit,148.95,-1769999.12,GBP,Grocery
TXN0000018679,2024-07-22T03:19:30,ACC00007578,Payment,412.82,-1770411.94,USD,Restaurant
TXN0000018680,2024-08-01T18:35:41,ACC00008294,Debit,45.1,-1770457.04,EUR,Amazon
TXN0000018681,2024-08-18T21:59:08,ACC00005905,Payment,513.54,-1770970.58,JPY,Online Store
TXN0000018682,2024-10-17T20:04:43,ACC00003693,Payment,1971.04,-1772941.62,EUR,Starbucks
TXN0000018683,2024-07-04T21:41:46,ACC00003545,Credit,1194.62,-1771747.0,USD,Grocery
TXN0000018684,2024-05-22T07:28:49,ACC00005270,Debit,575.86,-1772322.86,JPY,Grocery
TXN0000018685,2024-08-18T11:38:48,ACC00001722,Credit,1882.13,-1770440.73,EUR,Walmart
TXN0000018686,2024-09-18T21:54:02,ACC00005278,Transfer,208.57,-1770232.16,EUR,Shell
TXN0000018687,2024-12-30T09:07:17,ACC00009996,Debit,1141.08,-1771373.24,GBP,Starbucks
TXN0000018688,2024-11-25T01:44:48,ACC00001539,Credit,88.33,-1771284.91,JPY,Walmart
TXN0000018689,2024-10-31T10:09:02,ACC00007947,Payment,194.35,-1771479.26,EUR,Walmart
TXN0000018690,2024-03-20T20:50:07,ACC00001100,Transfer,1865.85,-1769613.41,JPY,Restaurant
TXN0000018691,2024-12-08T09:42:17,ACC00006709,Payment,1189.89,-1770803.3,USD,Restaurant
TXN0000018692,2024-09-14T07:56:22,ACC00004615,Credit,1259.78,-1769543.52,JPY,Shell
TXN0000018693,2024-08-15T19:27:08,ACC00003274,Transfer,945.76,-1768597.76,EUR,Shell
TXN0000018694,2024-12-27T23:15:27,ACC00005149,Debit,1010.55,-1769608.31,USD,Target
TXN0000018695,2024-09-21T03:36:24,ACC00004721,Debit,1988.71,-1771597.02,EUR,Amazon
TXN0000018696,2024-10-25T02:34:15,ACC00008293,Transfer,1206.35,-1770390.67,JPY,Amazon
TXN0000018697,2024-02-11T19:01:27,ACC00004591,Payment,535.8,-1770926.47,EUR,Starbucks
TXN0000018698,2024-09-20T18:20:54,ACC00008794,Debit,608.43,-1771534.9,EUR,Online Store
TXN0000018699,2024-09-30T12:14:28,ACC00006273,Credit,1536.85,-1769998.05,GBP,Target
TXN0000018700,2024-10-23T23:15:38,ACC00008099,Credit,168.16,-1769829.89,EUR,Shell
TXN0000018701,2024-03-27T03:50:48,ACC00007868,Payment,1015.02,-1770844.91,USD,Grocery
TXN0000018702,2024-01-08T19:57:18,ACC00008230,Credit,1856.39,-1768988.52,GBP,Starbucks
TXN0000018703,2024-09-29T11:58:03,ACC00005101,Transfer,1779.71,-1767208.81,GBP,Amazon
TXN0000018704,2024-03-08T09:15:16,ACC00000140,Debit,1203.62,-1768412.43,EUR,Starbucks
TXN0000018705,2024-03-28T16:05:42,ACC00001776,Credit,441.64,-1767970.79,USD,Shell
TXN0000018706,2024-02-10T05:33:18,ACC00001254,Debit,1838.02,-1769808.81,EUR,Target
TXN0000018707,2024-02-27T01:04:33,ACC00008714,Payment,1519.18,-1771327.99,JPY,Online Store
TXN0000018708,2024-10-01T09:44:58,ACC00000968,Transfer,1163.31,-1770164.68,EUR,Amazon
TXN0000018709,2024-05-16T21:15:04,ACC00006821,ATM,1931.92,-1772096.6,EUR,Grocery
TXN0000018710,2024-08-25T00:24:00,ACC00003086,Debit,1860.03,-1773956.63,JPY,Target
TXN0000018711,2024-01-21T01:28:43,ACC00004075,Payment,721.2,-1774677.83,USD,Grocery
TXN0000018712,2024-11-17T02:30:23,ACC00006494,Credit,817.27,-1773860.56,JPY,Grocery
TXN0000018713,2024-12-15T11:43:36,ACC00000227,Debit,190.77,-1774051.33,EUR,Starbucks
TXN0000018714,2024-03-26T10:53:17,ACC00005747,ATM,508.3,-1774559.63,EUR,Starbucks
TXN0000018715,2024-11-14T08:43:58,ACC00006484,Credit,1182.3,-1773377.33,USD,Walmart
TXN0000018716,2024-08-26T11:05:41,ACC00004253,Credit,70.53,-1773306.8,JPY,Target
TXN0000018717,2024-06-18T12:53:59,ACC00001009,Transfer,1270.82,-1772035.98,EUR,Target
TXN0000018718,2024-06-22T06:45:55,ACC00002878,Transfer,552.84,-1771483.14,JPY,Restaurant
TXN0000018719,2024-07-01T13:37:37,ACC00006863,ATM,1619.47,-1773102.61,JPY,Target
TXN0000018720,2024-03-14T07:27:13,ACC00008252,Payment,515.68,-1773618.29,GBP,Online Store
TXN0000018721,2024-11-03T01:19:58,ACC00000669,Debit,828.19,-1774446.48,EUR,Grocery
TXN0000018722,2024-12-07T15:23:18,ACC00004028,Transfer,367.12,-1774079.36,JPY,Starbucks
TXN0000018723,2024-04-23T01:29:22,ACC00005883,ATM,552.18,-1774631.54,GBP,Amazon
TXN0000018724,2024-03-02T01:10:17,ACC00009961,Credit,500.6,-1774130.94,GBP,Online Store
TXN0000018725,2024-10-24T00:53:28,ACC00009966,Debit,1799.69,-1775930.63,GBP,Amazon
TXN0000018726,2024-06-17T12:29:07,ACC00009264,Debit,1922.89,-1777853.52,EUR,Restaurant
TXN0000018727,2024-07-06T13:41:44,ACC00004175,Transfer,816.6,-1777036.92,EUR,Target
TXN0000018728,2024-03-07T13:33:17,ACC00005519,ATM,953.73,-1777990.65,JPY,Online Store
TXN0000018729,2024-06-23T11:17:47,ACC00009407,ATM,1282.75,-1779273.4,EUR,Shell
TXN0000018730,2024-10-15T16:17:55,ACC00009934,Debit,213.08,-1779486.48,JPY,Restaurant
TXN0000018731,2024-12-12T17:49:38,ACC00002097,Credit,1061.54,-1778424.94,GBP,Amazon
TXN0000018732,2024-11-10T04:06:14,ACC00001115,ATM,505.78,-1778930.72,USD,Walmart
TXN0000018733,2024-09-07T20:59:55,ACC00000261,Debit,452.3,-1779383.02,GBP,Walmart
TXN0000018734,2024-02-17T15:22:13,ACC00007286,ATM,969.52,-1780352.54,EUR,Walmart
TXN0000018735,2024-08-23T12:54:22,ACC00009187,Debit,1308.24,-1781660.78,USD,Walmart
TXN0000018736,2024-10-30T17:49:02,ACC00004839,Payment,1215.87,-1782876.65,USD,Restaurant
TXN0000018737,2024-01-06T02:53:13,ACC00001900,Credit,1481.03,-1781395.62,EUR,Walmart
TXN0000018738,2024-01-01T10:25:21,ACC00000944,Credit,912.49,-1780483.13,JPY,Target
TXN0000018739,2024-07-30T06:22:55,ACC00004558,ATM,136.9,-1780620.03,USD,Walmart
TXN0000018740,2024-12-21T15:56:47,ACC00004558,Payment,905.14,-1781525.17,USD,Amazon
TXN0000018741,2024-03-28T03:10:11,ACC00002694,Credit,1064.08,-1780461.09,GBP,Restaurant
TXN0000018742,2024-01-28T06:19:53,ACC00000315,Debit,1639.81,-1782100.9,GBP,Online Store
TXN0000018743,2024-09-04T06:21:29,ACC00006508,Credit,639.3,-1781461.6,GBP,Amazon
TXN0000018744,2024-07-19T14:11:23,ACC00008498,Credit,904.73,-1780556.87,JPY,Online Store
TXN0000018745,2024-02-12T01:48:19,ACC00006347,Payment,1718.08,-1782274.95,GBP,Grocery
TXN0000018746,2024-06-22T12:07:58,ACC00001534,Credit,1751.13,-1780523.82,GBP,Shell
TXN0000018747,2024-03-28T12:50:18,ACC00006797,ATM,1263.15,-1781786.97,EUR,Amazon
TXN0000018748,2024-01-24T18:06:46,ACC00003988,Debit,932.73,-1782719.7,GBP,Target
TXN0000018749,2024-02-10T08:10:49,ACC00000791,Credit,1557.04,-1781162.66,USD,Walmart
TXN0000018750,2024-03-28T01:45:56,ACC00009458,Credit,1800.96,-1779361.7,GBP,Walmart
TXN0000018751,2024-07-18T03:33:32,ACC00005112,Debit,995.19,-1780356.89,EUR,Walmart
TXN0000018752,2024-12-22T14:38:19,ACC00001492,Payment,1755.86,-1782112.75,JPY,Shell
TXN0000018753,2024-10-13T12:28:55,ACC00009972,Transfer,905.61,-1781207.14,GBP,Restaurant
TXN0000018754,2024-06-15T15:29:07,ACC00004426,ATM,527.9,-1781735.04,JPY,Amazon
TXN0000018755,2024-03-02T15:41:42,ACC00000064,Credit,501.82,-1781233.22,EUR,Shell
TXN0000018756,2024-09-30T10:56:51,ACC00002352,ATM,178.82,-1781412.04,USD,Target
TXN0000018757,2024-04-01T20:04:31,ACC00000507,Transfer,1580.68,-1779831.36,USD,Grocery
TXN0000018758,2024-09-20T05:55:12,ACC00000217,Credit,780.96,-1779050.4,EUR,Shell
TXN0000018759,2024-02-07T03:00:26,ACC00006639,Payment,89.89,-1779140.29,USD,Grocery
TXN0000018760,2024-12-13T16:19:08,ACC00000587,Credit,851.91,-1778288.38,JPY,Online Store
TXN0000018761,2024-07-26T00:22:15,ACC00004309,ATM,1559.04,-1779847.42,GBP,Shell
TXN0000018762,2024-05-11T07:22:49,ACC00001806,Credit,802.45,-1779044.97,USD,Restaurant
TXN0000018763,2024-04-29T16:02:39,ACC00002675,Transfer,14.04,-1779030.93,USD,Starbucks
TXN0000018764,2024-10-13T11:24:31,ACC00009790,ATM,273.2,-1779304.13,EUR,Shell
TXN0000018765,2024-08-14T19:33:39,ACC00007702,Payment,385.29,-1779689.42,JPY,Starbucks
TXN0000018766,2024-10-12T23:55:13,ACC00006501,Payment,1166.29,-1780855.71,GBP,Online Store
TXN0000018767,2024-11-03T09:19:20,ACC00006410,Debit,549.41,-1781405.12,GBP,Target
TXN0000018768,2024-06-19T12:39:19,ACC00003835,Transfer,1943.67,-1779461.45,GBP,Starbucks
TXN0000018769,2024-03-25T20:24:59,ACC00002363,ATM,737.63,-1780199.08,GBP,Amazon
TXN0000018770,2024-07-01T11:50:03,ACC00001543,Transfer,1124.04,-1779075.04,USD,Amazon
TXN0000018771,2024-06-21T06:23:12,ACC00009014,Transfer,440.09,-1778634.95,JPY,Amazon
TXN0000018772,2024-03-12T19:21:04,ACC00003658,Transfer,1406.78,-1777228.17,GBP,Restaurant
TXN0000018773,2024-05-27T11:12:34,ACC00007914,Transfer,1271.17,-1775957.0,JPY,Shell
TXN0000018774,2024-04-10T07:49:41,ACC00004408,Credit,859.12,-1775097.88,EUR,Shell
TXN0000018775,2024-02-20T14:47:48,ACC00006907,Debit,1817.3,-1776915.18,GBP,Starbucks
TXN0000018776,2024-09-05T01:57:54,ACC00005279,ATM,650.05,-1777565.23,JPY,Shell
TXN0000018777,2024-05-02T22:44:34,ACC00006618,Payment,669.65,-1778234.88,EUR,Shell
TXN0000018778,2024-01-16T02:31:53,ACC00005965,ATM,55.92,-1778290.8,USD,Grocery
TXN0000018779,2024-11-29T18:46:55,ACC00004896,ATM,1426.24,-1779717.04,EUR,Restaurant
TXN0000018780,2024-03-13T08:27:42,ACC00006922,Credit,1738.03,-1777979.01,EUR,Restaurant
TXN0000018781,2024-01-09T12:49:00,ACC00000264,ATM,1078.33,-1779057.34,JPY,Shell
TXN0000018782,2024-08-03T11:12:57,ACC00000908,Debit,668.51,-1779725.85,GBP,Amazon
TXN0000018783,2024-01-25T05:22:04,ACC00003899,Transfer,916.23,-1778809.62,JPY,Walmart
TXN0000018784,2024-04-11T09:59:07,ACC00006836,ATM,509.05,-1779318.67,GBP,Amazon
TXN0000018785,2024-09-28T17:57:50,ACC00006029,Payment,797.63,-1780116.3,USD,Restaurant
TXN0000018786,2024-11-29T21:21:52,ACC00006935,Credit,684.44,-1779431.86,EUR,Grocery
TXN0000018787,2024-05-10T19:52:40,ACC00006887,ATM,1566.05,-1780997.91,USD,Shell
TXN0000018788,2024-10-18T00:00:33,ACC00009160,Debit,1782.99,-1782780.9,JPY,Restaurant
TXN0000018789,2024-09-17T21:33:48,ACC00004564,Payment,1860.86,-1784641.76,GBP,Restaurant
TXN0000018790,2024-05-02T10:44:17,ACC00005745,ATM,1859.38,-1786501.14,JPY,Grocery
TXN0000018791,2024-02-08T02:58:04,ACC00001020,ATM,1399.5,-1787900.64,GBP,Restaurant
TXN0000018792,2024-01-13T02:11:39,ACC00002450,Debit,1981.43,-1789882.07,GBP,Online Store
TXN0000018793,2024-05-17T19:48:51,ACC00006843,Payment,287.5,-1790169.57,GBP,Walmart
TXN0000018794,2024-11-02T14:38:52,ACC00006009,Debit,871.93,-1791041.5,USD,Restaurant
TXN0000018795,2024-07-15T15:35:05,ACC00002241,Payment,1679.99,-1792721.49,USD,Starbucks
TXN0000018796,2024-07-24T18:17:54,ACC00000928,Transfer,246.84,-1792474.65,EUR,Shell
TXN0000018797,2024-09-30T10:11:46,ACC00002976,ATM,439.57,-1792914.22,GBP,Target
TXN0000018798,2024-03-18T12:24:36,ACC00008573,Credit,1307.43,-1791606.79,JPY,Shell
TXN0000018799,2024-09-19T08:14:44,ACC00008411,Credit,1847.6,-1789759.19,JPY,Restaurant
TXN0000018800,2024-05-24T23:17:58,ACC00005395,Transfer,864.37,-1788894.82,EUR,Grocery
TXN0000018801,2024-01-06T18:53:32,ACC00002369,Credit,1019.54,-1787875.28,GBP,Target
TXN0000018802,2024-08-01T03:04:11,ACC00004334,Payment,1158.53,-1789033.81,EUR,Shell
TXN0000018803,2024-04-12T02:33:01,ACC00004696,Credit,165.7,-1788868.11,JPY,Amazon
TXN0000018804,2024-11-29T23:29:39,ACC00004828,Debit,376.7,-1789244.81,USD,Online Store
TXN0000018805,2024-05-24T08:44:48,ACC00009371,ATM,1706.95,-1790951.76,USD,Starbucks
TXN0000018806,2024-11-29T02:39:32,ACC00001726,Transfer,1713.28,-1789238.48,USD,Walmart
TXN0000018807,2024-03-29T01:18:40,ACC00007645,Credit,1303.43,-1787935.05,USD,Target
TXN0000018808,2024-01-17T17:27:07,ACC00008099,Credit,1499.65,-1786435.4,JPY,Online Store
TXN0000018809,2024-04-02T13:21:34,ACC00005168,ATM,1704.05,-1788139.45,USD,Amazon
TXN0000018810,2024-02-10T03:04:15,ACC00001166,ATM,1398.88,-1789538.33,JPY,Grocery
TXN0000018811,2024-08-11T14:30:46,ACC00006937,Debit,1701.35,-1791239.68,JPY,Online Store
TXN0000018812,2024-05-03T10:17:40,ACC00008172,Debit,1932.02,-1793171.7,EUR,Target
TXN0000018813,2024-06-06T06:04:31,ACC00004160,Payment,491.57,-1793663.27,JPY,Restaurant
TXN0000018814,2024-01-04T02:47:05,ACC00000885,Debit,175.29,-1793838.56,JPY,Walmart
TXN0000018815,2024-04-22T07:31:55,ACC00005620,Credit,326.57,-1793511.99,USD,Starbucks
TXN0000018816,2024-06-21T18:40:10,ACC00008801,Payment,1181.58,-1794693.57,JPY,Starbucks
TXN0000018817,2024-09-14T00:07:11,ACC00008551,Payment,1088.67,-1795782.24,USD,Target
TXN0000018818,2024-08-02T07:18:59,ACC00008721,Debit,567.58,-1796349.82,GBP,Shell
TXN0000018819,2024-08-02T00:30:31,ACC00008239,Credit,89.81,-1796260.01,GBP,Shell
TXN0000018820,2024-03-24T18:23:52,ACC00003362,Transfer,697.8,-1795562.21,JPY,Restaurant
TXN0000018821,2024-12-14T14:29:17,ACC00008332,Debit,164.18,-1795726.39,EUR,Online Store
TXN0000018822,2024-04-13T02:20:33,ACC00002646,Payment,490.36,-1796216.75,EUR,Grocery
TXN0000018823,2024-07-10T08:33:59,ACC00006923,Transfer,546.93,-1795669.82,JPY,Restaurant
TXN0000018824,2024-01-24T01:57:54,ACC00008990,Debit,1846.46,-1797516.28,GBP,Shell
TXN0000018825,2024-12-08T22:55:04,ACC00009934,Credit,1340.24,-1796176.04,JPY,Online Store
TXN0000018826,2024-09-21T08:00:11,ACC00006798,Transfer,1564.74,-1794611.3,JPY,Target
TXN0000018827,2024-09-01T10:31:50,ACC00008000,Credit,1494.73,-1793116.57,EUR,Starbucks
TXN0000018828,2024-05-07T21:34:26,ACC00003941,Credit,27.43,-1793089.14,EUR,Target
TXN0000018829,2024-05-14T09:31:14,ACC00000631,Transfer,1546.61,-1791542.53,JPY,Amazon
TXN0000018830,2024-07-31T18:25:35,ACC00003526,Payment,531.28,-1792073.81,GBP,Grocery
TXN0000018831,2024-07-20T13:19:28,ACC00007891,ATM,829.38,-1792903.19,EUR,Grocery
TXN0000018832,2024-09-01T01:22:41,ACC00008226,Debit,1275.89,-1794179.08,GBP,Amazon
TXN0000018833,2024-05-19T13:13:43,ACC00007853,Debit,1147.73,-1795326.81,JPY,Restaurant
TXN0000018834,2024-11-05T19:07:36,ACC00003404,Credit,1849.91,-1793476.9,USD,Online Store
TXN0000018835,2024-11-24T21:48:07,ACC00007341,Transfer,1320.21,-1792156.69,EUR,Grocery
TXN0000018836,2024-02-08T10:38:17,ACC00003978,Payment,228.85,-1792385.54,JPY,Online Store
TXN0000018837,2024-02-19T11:51:13,ACC00002288,Payment,881.81,-1793267.35,EUR,Walmart
TXN0000018838,2024-02-07T19:24:15,ACC00002320,Credit,1989.47,-1791277.88,JPY,Shell
TXN0000018839,2024-04-13T05:56:49,ACC00007284,Credit,1902.18,-1789375.7,EUR,Grocery
TXN0000018840,2024-08-23T16:23:52,ACC00000707,Debit,1915.09,-1791290.79,GBP,Amazon
TXN0000018841,2024-08-11T05:44:56,ACC00008761,Credit,1029.54,-1790261.25,EUR,Online Store
TXN0000018842,2024-02-23T13:21:59,ACC00003706,Credit,738.08,-1789523.17,USD,Online Store
TXN0000018843,2024-06-01T00:13:02,ACC00006713,Debit,1025.85,-1790549.02,EUR,Starbucks
TXN0000018844,2024-11-20T00:33:36,ACC00000072,ATM,1024.16,-1791573.18,EUR,Walmart
TXN0000018845,2024-06-08T22:44:10,ACC00003398,Debit,1228.53,-1792801.71,USD,Starbucks
TXN0000018846,2024-03-14T17:23:28,ACC00009773,Payment,1457.1,-1794258.81,USD,Walmart
TXN0000018847,2024-03-10T07:53:23,ACC00002133,Payment,1498.33,-1795757.14,USD,Restaurant
TXN0000018848,2024-07-17T01:46:25,ACC00009958,Transfer,975.51,-1794781.63,GBP,Grocery
TXN0000018849,2024-12-17T03:18:32,ACC00008217,Debit,1146.79,-1795928.42,GBP,Amazon
TXN0000018850,2024-11-09T09:07:06,ACC00007469,Payment,1922.12,-1797850.54,GBP,Grocery
TXN0000018851,2024-11-06T11:38:01,ACC00009522,Credit,204.4,-1797646.14,JPY,Grocery
TXN0000018852,2024-12-28T18:23:44,ACC00005676,Payment,1371.9,-1799018.04,USD,Starbucks
TXN0000018853,2024-05-14T19:48:51,ACC00004088,ATM,1023.94,-1800041.98,EUR,Starbucks
TXN0000018854,2024-09-20T01:31:51,ACC00001939,Debit,135.91,-1800177.89,JPY,Online Store
TXN0000018855,2024-12-24T13:09:21,ACC00006028,Credit,1510.63,-1798667.26,USD,Starbucks
TXN0000018856,2024-01-12T02:41:39,ACC00003368,Transfer,1970.32,-1796696.94,USD,Shell
TXN0000018857,2024-06-19T13:47:09,ACC00005294,Credit,1074.4,-1795622.54,USD,Walmart
TXN0000018858,2024-08-18T17:46:03,ACC00002672,Transfer,1000.9,-1794621.64,USD,Online Store
TXN0000018859,2024-05-03T10:27:02,ACC00009869,Payment,1191.51,-1795813.15,USD,Online Store
TXN0000018860,2024-04-09T18:53:43,ACC00004330,Credit,1594.23,-1794218.92,EUR,Target
TXN0000018861,2024-10-05T02:27:55,ACC00001510,Transfer,1152.78,-1793066.14,GBP,Walmart
TXN0000018862,2024-06-02T06:04:32,ACC00000260,Payment,1017.34,-1794083.48,USD,Amazon
TXN0000018863,2024-09-09T22:07:07,ACC00003290,Transfer,729.29,-1793354.19,GBP,Restaurant
TXN0000018864,2024-12-24T03:31:40,ACC00003260,Payment,987.74,-1794341.93,EUR,Walmart
TXN0000018865,2024-08-27T19:13:31,ACC00001993,Debit,86.16,-1794428.09,GBP,Target
TXN0000018866,2024-09-03T06:26:50,ACC00007629,Debit,1564.24,-1795992.33,USD,Amazon
TXN0000018867,2024-03-30T05:29:21,ACC00001687,Payment,453.83,-1796446.16,USD,Target
TXN0000018868,2024-12-09T06:22:37,ACC00000228,Payment,1756.92,-1798203.08,JPY,Grocery
TXN0000018869,2024-07-19T15:22:52,ACC00008372,Transfer,545.09,-1797657.99,JPY,Shell
TXN0000018870,2024-12-29T08:48:20,ACC00009876,Debit,1374.24,-1799032.23,GBP,Online Store
TXN0000018871,2024-04-20T23:59:29,ACC00004201,Payment,1095.93,-1800128.16,USD,Starbucks
TXN0000018872,2024-07-14T10:18:09,ACC00007896,ATM,772.02,-1800900.18,USD,Starbucks
TXN0000018873,2024-11-25T16:04:00,ACC00001014,Payment,1478.47,-1802378.65,EUR,Amazon
TXN0000018874,2024-05-13T08:46:50,ACC00004426,ATM,422.38,-1802801.03,EUR,Amazon
TXN0000018875,2024-11-04T20:11:15,ACC00002792,Credit,561.72,-1802239.31,USD,Amazon
TXN0000018876,2024-12-19T12:22:31,ACC00000312,Debit,1952.9,-1804192.21,GBP,Walmart
TXN0000018877,2024-12-08T07:52:49,ACC00003088,Payment,1422.44,-1805614.65,GBP,Restaurant
TXN0000018878,2024-08-16T10:39:03,ACC00003590,Transfer,820.03,-1804794.62,EUR,Walmart
TXN0000018879,2024-03-16T09:41:42,ACC00006844,Debit,86.48,-1804881.1,JPY,Grocery
TXN0000018880,2024-06-01T19:46:50,ACC00002761,Debit,795.01,-1805676.11,EUR,Restaurant
TXN0000018881,2024-01-13T13:16:46,ACC00007738,Credit,948.94,-1804727.17,EUR,Target
TXN0000018882,2024-05-24T02:15:31,ACC00000404,Payment,677.59,-1805404.76,USD,Online Store
TXN0000018883,2024-04-09T04:22:20,ACC00007465,Payment,370.48,-1805775.24,USD,Walmart
TXN0000018884,2024-11-15T04:32:41,ACC00003174,Credit,1803.48,-1803971.76,EUR,Online Store
TXN0000018885,2024-08-31T21:44:15,ACC00009548,Credit,1974.61,-1801997.15,JPY,Online Store
TXN0000018886,2024-05-22T15:57:54,ACC00006058,Debit,785.55,-1802782.7,GBP,Starbucks
TXN0000018887,2024-04-19T12:29:32,ACC00008448,Transfer,1141.75,-1801640.95,JPY,Target
TXN0000018888,2024-05-13T02:32:05,ACC00005211,Transfer,1509.56,-1800131.39,GBP,Walmart
TXN0000018889,2024-03-17T00:22:17,ACC00009930,Payment,1282.52,-1801413.91,EUR,Amazon
TXN0000018890,2024-04-04T10:58:21,ACC00008754,ATM,1413.99,-1802827.9,GBP,Online Store
TXN0000018891,2024-02-03T18:55:50,ACC00001907,Payment,612.96,-1803440.86,GBP,Starbucks
TXN0000018892,2024-08-23T02:09:55,ACC00005281,Credit,766.61,-1802674.25,EUR,Amazon
TXN0000018893,2024-08-02T16:47:50,ACC00004291,Payment,1469.65,-1804143.9,JPY,Target
TXN0000018894,2024-11-04T20:10:11,ACC00004267,Payment,393.08,-1804536.98,GBP,Target
TXN0000018895,2024-06-27T20:05:07,ACC00007060,Payment,55.11,-1804592.09,USD,Grocery
TXN0000018896,2024-06-18T17:59:33,ACC00004333,ATM,820.42,-1805412.51,USD,Starbucks
TXN0000018897,2024-06-10T22:13:28,ACC00007747,Transfer,1437.43,-1803975.08,GBP,Target
TXN0000018898,2024-05-17T13:06:40,ACC00009074,Credit,1711.64,-1802263.44,EUR,Target
TXN0000018899,2024-10-09T18:05:40,ACC00003165,Debit,1895.71,-1804159.15,USD,Walmart
TXN0000018900,2024-09-26T02:31:40,ACC00009155,Debit,377.91,-1804537.06,EUR,Target
TXN0000018901,2024-01-12T07:36:11,ACC00004193,Debit,496.55,-1805033.61,EUR,Restaurant
TXN0000018902,2024-10-01T16:50:36,ACC00006654,ATM,1642.7,-1806676.31,GBP,Restaurant
TXN0000018903,2024-07-10T09:34:03,ACC00008330,Payment,689.82,-1807366.13,JPY,Starbucks
TXN0000018904,2024-08-26T08:08:05,ACC00002525,ATM,1730.41,-1809096.54,USD,Amazon
TXN0000018905,2024-08-26T13:56:55,ACC00007842,ATM,822.15,-1809918.69,EUR,Grocery
TXN0000018906,2024-06-10T00:32:17,ACC00005796,ATM,1980.19,-1811898.88,GBP,Target
TXN0000018907,2024-12-06T11:01:30,ACC00002108,Payment,1735.42,-1813634.3,EUR,Shell
TXN0000018908,2024-10-22T19:38:49,ACC00003471,Transfer,239.94,-1813394.36,USD,Grocery
TXN0000018909,2024-01-06T08:19:00,ACC00003194,ATM,417.51,-1813811.87,EUR,Amazon
TXN0000018910,2024-09-11T03:12:00,ACC00007013,Transfer,1736.81,-1812075.06,GBP,Shell
TXN0000018911,2024-10-21T07:39:20,ACC00009401,Debit,1639.81,-1813714.87,JPY,Amazon
TXN0000018912,2024-08-16T05:00:58,ACC00008658,Credit,280.08,-1813434.79,EUR,Walmart
TXN0000018913,2024-02-01T15:29:22,ACC00001134,Debit,1618.7,-1815053.49,USD,Restaurant
TXN0000018914,2024-07-29T07:12:32,ACC00008665,ATM,1758.14,-1816811.63,GBP,Walmart
TXN0000018915,2024-09-12T17:20:39,ACC00007090,ATM,1297.12,-1818108.75,EUR,Target
TXN0000018916,2024-12-20T15:50:36,ACC00002288,ATM,517.75,-1818626.5,JPY,Starbucks
TXN0000018917,2024-10-15T11:02:29,ACC00000600,Payment,427.25,-1819053.75,JPY,Grocery
TXN0000018918,2024-04-23T20:16:58,ACC00008091,Credit,825.84,-1818227.91,USD,Online Store
TXN0000018919,2024-06-28T14:47:12,ACC00006556,Payment,203.94,-1818431.85,USD,Online Store
TXN0000018920,2024-10-31T09:48:52,ACC00009179,Debit,827.79,-1819259.64,JPY,Grocery
TXN0000018921,2024-10-10T19:19:54,ACC00005380,ATM,256.93,-1819516.57,USD,Restaurant
TXN0000018922,2024-09-26T12:59:21,ACC00007248,Payment,806.77,-1820323.34,GBP,Walmart
TXN0000018923,2024-03-23T08:13:58,ACC00001941,Payment,1303.48,-1821626.82,USD,Walmart
TXN0000018924,2024-11-12T01:54:05,ACC00007019,Payment,1448.28,-1823075.1,JPY,Restaurant
TXN0000018925,2024-10-06T10:11:24,ACC00003085,ATM,1264.35,-1824339.45,EUR,Starbucks
TXN0000018926,2024-12-09T17:40:17,ACC00006159,ATM,1327.39,-1825666.84,GBP,Target
TXN0000018927,2024-09-29T07:12:56,ACC00009886,Debit,824.09,-1826490.93,USD,Restaurant
TXN0000018928,2024-12-15T22:54:28,ACC00004685,Payment,1725.08,-1828216.01,USD,Shell
TXN0000018929,2024-05-04T15:54:00,ACC00002687,Payment,864.16,-1829080.17,USD,Target
TXN0000018930,2024-03-20T18:59:49,ACC00004000,Transfer,932.89,-1828147.28,JPY,Walmart
TXN0000018931,2024-09-10T14:32:38,ACC00009616,Debit,182.48,-1828329.76,GBP,Target
TXN0000018932,2024-08-29T05:54:24,ACC00008874,Credit,1893.13,-1826436.63,JPY,Walmart
TXN0000018933,2024-07-25T00:12:45,ACC00002073,Payment,714.26,-1827150.89,GBP,Amazon
TXN0000018934,2024-08-16T18:47:58,ACC00004103,Credit,357.08,-1826793.81,USD,Grocery
TXN0000018935,2024-04-30T17:30:26,ACC00004228,Transfer,1578.0,-1825215.81,USD,Online Store
TXN0000018936,2024-12-14T19:10:21,ACC00000592,ATM,720.3,-1825936.11,USD,Walmart
TXN0000018937,2024-06-14T18:08:26,ACC00005827,Payment,1888.09,-1827824.2,JPY,Amazon
TXN0000018938,2024-07-22T01:08:22,ACC00003309,Transfer,529.8,-1827294.4,EUR,Walmart
TXN0000018939,2024-02-21T01:48:07,ACC00006687,Debit,1558.34,-1828852.74,USD,Grocery
TXN0000018940,2024-04-19T03:17:56,ACC00004890,Payment,697.96,-1829550.7,EUR,Starbucks
TXN0000018941,2024-09-19T23:22:53,ACC00008662,Credit,474.2,-1829076.5,USD,Shell
TXN0000018942,2024-02-03T20:37:07,ACC00002888,Transfer,844.93,-1828231.57,JPY,Grocery
TXN0000018943,2024-10-15T21:54:43,ACC00008095,Debit,1207.21,-1829438.78,USD,Target
TXN0000018944,2024-01-25T07:43:27,ACC00008093,Payment,10.53,-1829449.31,EUR,Restaurant
TXN0000018945,2024-10-09T02:36:51,ACC00007994,Transfer,144.39,-1829304.92,USD,Restaurant
TXN0000018946,2024-03-07T21:28:28,ACC00003206,Payment,1304.76,-1830609.68,GBP,Restaurant
TXN0000018947,2024-03-11T11:21:12,ACC00001246,Debit,1807.82,-1832417.5,JPY,Shell
TXN0000018948,2024-01-14T12:44:04,ACC00000721,ATM,1846.87,-1834264.37,GBP,Target
TXN0000018949,2024-12-01T12:10:54,ACC00001580,Debit,156.99,-1834421.36,USD,Walmart
TXN0000018950,2024-03-03T22:46:45,ACC00003139,Debit,107.32,-1834528.68,EUR,Grocery
TXN0000018951,2024-05-06T03:23:19,ACC00006912,Credit,1000.14,-1833528.54,GBP,Grocery
TXN0000018952,2024-01-28T13:01:09,ACC00004353,Payment,1344.01,-1834872.55,GBP,Amazon
TXN0000018953,2024-02-17T03:46:03,ACC00005445,Debit,733.93,-1835606.48,GBP,Starbucks
TXN0000018954,2024-08-13T21:32:12,ACC00000002,Transfer,872.96,-1834733.52,USD,Restaurant
TXN0000018955,2024-01-29T10:46:20,ACC00007729,ATM,1591.81,-1836325.33,JPY,Grocery
TXN0000018956,2024-03-17T03:15:26,ACC00008771,ATM,578.0,-1836903.33,GBP,Restaurant
TXN0000018957,2024-10-10T05:44:18,ACC00002612,ATM,1435.5,-1838338.83,USD,Starbucks
TXN0000018958,2024-10-16T19:44:21,ACC00004863,Credit,1525.75,-1836813.08,USD,Amazon
TXN0000018959,2024-11-25T16:34:03,ACC00002410,Debit,354.08,-1837167.16,GBP,Online Store
TXN0000018960,2024-09-25T23:24:44,ACC00005979,Payment,198.47,-1837365.63,EUR,Shell
TXN0000018961,2024-04-20T12:04:41,ACC00000939,Payment,1178.18,-1838543.81,JPY,Online Store
TXN0000018962,2024-10-23T01:45:04,ACC00003293,Credit,698.72,-1837845.09,GBP,Target
TXN0000018963,2024-05-31T07:16:16,ACC00004199,ATM,609.84,-1838454.93,JPY,Target
TXN0000018964,2024-11-06T16:33:47,ACC00005678,Payment,1562.38,-1840017.31,JPY,Walmart
TXN0000018965,2024-03-17T11:21:07,ACC00000948,Payment,679.33,-1840696.64,EUR,Shell
TXN0000018966,2024-04-02T18:22:51,ACC00004610,Payment,1819.98,-1842516.62,JPY,Walmart
TXN0000018967,2024-07-22T11:11:39,ACC00000869,Credit,192.91,-1842323.71,JPY,Shell
TXN0000018968,2024-08-04T04:47:24,ACC00001823,Credit,623.58,-1841700.13,USD,Online Store
TXN0000018969,2024-11-01T17:55:47,ACC00006551,Transfer,1096.24,-1840603.89,GBP,Online Store
TXN0000018970,2024-06-13T06:30:09,ACC00002816,Payment,1135.21,-1841739.1,GBP,Walmart
TXN0000018971,2024-09-14T13:29:43,ACC00001912,Debit,797.77,-1842536.87,EUR,Shell
TXN0000018972,2024-04-04T11:07:12,ACC00004993,ATM,91.73,-1842628.6,EUR,Restaurant
TXN0000018973,2024-12-25T17:57:46,ACC00002634,Debit,679.41,-1843308.01,JPY,Shell
TXN0000018974,2024-10-21T21:16:54,ACC00000979,Debit,1147.83,-1844455.84,JPY,Online Store
TXN0000018975,2024-12-20T21:49:18,ACC00002766,Payment,584.19,-1845040.03,USD,Grocery
TXN0000018976,2024-11-26T22:26:13,ACC00006820,Credit,631.37,-1844408.66,EUR,Online Store
TXN0000018977,2024-05-12T01:04:46,ACC00003949,Transfer,873.85,-1843534.81,USD,Walmart
TXN0000018978,2024-02-06T00:17:16,ACC00008371,Debit,1626.03,-1845160.84,USD,Shell
TXN0000018979,2024-04-24T16:14:29,ACC00007848,Transfer,487.59,-1844673.25,USD,Starbucks
TXN0000018980,2024-10-05T22:44:02,ACC00003271,Transfer,1844.23,-1842829.02,JPY,Shell
TXN0000018981,2024-02-17T09:15:58,ACC00003966,Debit,462.85,-1843291.87,EUR,Online Store
TXN0000018982,2024-12-13T12:15:23,ACC00003676,Debit,1146.84,-1844438.71,USD,Restaurant
TXN0000018983,2024-06-12T00:01:38,ACC00006800,Credit,453.61,-1843985.1,GBP,Online Store
TXN0000018984,2024-08-10T12:01:15,ACC00007946,Transfer,1457.07,-1842528.03,GBP,Online Store
TXN0000018985,2024-05-11T02:08:18,ACC00006163,ATM,1212.31,-1843740.34,GBP,Grocery
TXN0000018986,2024-03-11T01:33:50,ACC00009152,Credit,1485.65,-1842254.69,GBP,Amazon
TXN0000018987,2024-01-04T02:30:22,ACC00008381,Debit,1425.93,-1843680.62,USD,Amazon
TXN0000018988,2024-12-08T12:46:34,ACC00001910,Payment,255.43,-1843936.05,USD,Amazon
TXN0000018989,2024-01-31T20:39:07,ACC00007439,Debit,987.13,-1844923.18,JPY,Restaurant
TXN0000018990,2024-06-14T05:47:45,ACC00007580,Transfer,270.9,-1844652.28,USD,Restaurant
TXN0000018991,2024-11-28T05:32:18,ACC00009705,Transfer,788.63,-1843863.65,JPY,Online Store
TXN0000018992,2024-11-22T17:24:00,ACC00008822,Credit,1230.19,-1842633.46,JPY,Amazon
TXN0000018993,2024-06-02T04:08:48,ACC00004567,ATM,153.82,-1842787.28,JPY,Target
TXN0000018994,2024-01-29T07:14:19,ACC00001105,Transfer,1346.41,-1841440.87,USD,Restaurant
TXN0000018995,2024-04-27T09:00:24,ACC00007607,Payment,149.44,-1841590.31,EUR,Target
TXN0000018996,2024-04-26T00:04:49,ACC00004868,Payment,1156.82,-1842747.13,EUR,Walmart
TXN0000018997,2024-07-14T18:50:52,ACC00005609,Transfer,1816.96,-1840930.17,GBP,Starbucks
TXN0000018998,2024-03-30T21:36:05,ACC00004145,Debit,1844.45,-1842774.62,USD,Target
TXN0000018999,2024-08-22T05:31:49,ACC00000577,Credit,15.37,-1842759.25,USD,Amazon
TXN0000019000,2024-10-31T14:56:16,ACC00000661,Transfer,1682.27,-1841076.98,USD,Target
TXN0000019001,2024-09-03T08:15:07,ACC00002952,Debit,1320.66,-1842397.64,GBP,Amazon
TXN0000019002,2024-02-22T20:31:16,ACC00009311,ATM,195.74,-1842593.38,EUR,Online Store
TXN0000019003,2024-12-02T14:06:12,ACC00002255,ATM,896.54,-1843489.92,JPY,Restaurant
TXN0000019004,2024-12-14T13:17:19,ACC00003630,Debit,1069.72,-1844559.64,JPY,Grocery
TXN0000019005,2024-12-19T10:54:47,ACC00005869,Debit,770.57,-1845330.21,EUR,Online Store
TXN0000019006,2024-01-03T05:29:02,ACC00008500,ATM,816.39,-1846146.6,JPY,Amazon
TXN0000019007,2024-02-29T02:37:23,ACC00001878,Transfer,1456.72,-1844689.88,EUR,Amazon
TXN0000019008,2024-04-29T14:18:22,ACC00001246,Payment,1655.36,-1846345.24,EUR,Target
TXN0000019009,2024-05-16T03:11:44,ACC00005287,ATM,892.1,-1847237.34,GBP,Online Store
TXN0000019010,2024-10-06T23:47:16,ACC00009640,Payment,1318.48,-1848555.82,EUR,Amazon
TXN0000019011,2024-04-30T23:51:30,ACC00009518,ATM,123.56,-1848679.38,JPY,Walmart
TXN0000019012,2024-03-17T18:19:36,ACC00008113,Payment,375.36,-1849054.74,EUR,Grocery
TXN0000019013,2024-01-01T19:02:02,ACC00008367,Credit,34.09,-1849020.65,EUR,Restaurant
TXN0000019014,2024-08-10T05:32:10,ACC00003757,Credit,809.84,-1848210.81,EUR,Restaurant
TXN0000019015,2024-06-04T08:09:03,ACC00008528,Transfer,93.72,-1848117.09,JPY,Restaurant
TXN0000019016,2024-12-18T21:12:27,ACC00001868,Debit,423.12,-1848540.21,EUR,Starbucks
TXN0000019017,2024-04-27T23:18:50,ACC00008122,ATM,1560.88,-1850101.09,GBP,Target
TXN0000019018,2024-06-12T21:55:20,ACC00004950,Payment,1258.15,-1851359.24,JPY,Restaurant
TXN0000019019,2024-09-19T09:47:23,ACC00000693,Debit,1139.88,-1852499.12,EUR,Walmart
TXN0000019020,2024-12-19T11:22:07,ACC00009533,Debit,1109.69,-1853608.81,USD,Walmart
TXN0000019021,2024-06-24T03:08:13,ACC00002886,Debit,1017.43,-1854626.24,JPY,Starbucks
TXN0000019022,2024-04-05T20:12:50,ACC00005419,ATM,736.61,-1855362.85,USD,Online Store
TXN0000019023,2024-05-13T21:19:22,ACC00007922,Transfer,106.35,-1855256.5,EUR,Amazon
TXN0000019024,2024-05-03T01:37:37,ACC00005722,Credit,438.09,-1854818.41,EUR,Grocery
TXN0000019025,2024-12-06T11:59:59,ACC00006575,Transfer,647.88,-1854170.53,JPY,Online Store
TXN0000019026,2024-01-19T01:25:08,ACC00002967,Debit,21.86,-1854192.39,JPY,Grocery
TXN0000019027,2024-01-11T19:54:32,ACC00005806,Transfer,1479.94,-1852712.45,EUR,Target
TXN0000019028,2024-10-23T17:11:12,ACC00008230,ATM,1030.44,-1853742.89,GBP,Target
TXN0000019029,2024-07-20T05:24:06,ACC00009650,Credit,660.76,-1853082.13,USD,Starbucks
TXN0000019030,2024-12-04T18:08:35,ACC00002923,ATM,234.71,-1853316.84,EUR,Target
TXN0000019031,2024-05-26T10:40:38,ACC00004501,ATM,685.32,-1854002.16,JPY,Shell
TXN0000019032,2024-06-04T16:24:27,ACC00008117,Payment,1946.9,-1855949.06,USD,Grocery
TXN0000019033,2024-01-20T18:18:01,ACC00004376,Payment,1780.7,-1857729.76,USD,Online Store
TXN0000019034,2024-05-19T00:15:28,ACC00009044,Debit,756.39,-1858486.15,USD,Restaurant
TXN0000019035,2024-04-04T03:04:55,ACC00006101,Debit,850.59,-1859336.74,GBP,Amazon
TXN0000019036,2024-03-16T15:28:40,ACC00002653,Payment,1212.74,-1860549.48,JPY,Walmart
TXN0000019037,2024-09-24T14:50:44,ACC00005318,Debit,933.66,-1861483.14,USD,Walmart
TXN0000019038,2024-10-07T17:11:31,ACC00003544,Payment,27.24,-1861510.38,JPY,Target
TXN0000019039,2024-09-24T19:27:20,ACC00003443,Credit,1268.13,-1860242.25,JPY,Grocery
TXN0000019040,2024-04-08T07:31:06,ACC00009295,Payment,69.4,-1860311.65,JPY,Online Store
TXN0000019041,2024-05-11T04:38:29,ACC00007630,Payment,789.79,-1861101.44,JPY,Target
TXN0000019042,2024-03-31T21:58:56,ACC00008516,Credit,471.49,-1860629.95,JPY,Online Store
TXN0000019043,2024-12-03T23:59:59,ACC00000876,Credit,961.92,-1859668.03,EUR,Starbucks
TXN0000019044,2024-09-16T22:13:59,ACC00009625,Credit,692.03,-1858976.0,JPY,Amazon
TXN0000019045,2024-12-22T21:23:35,ACC00006092,Debit,1620.15,-1860596.15,GBP,Shell
TXN0000019046,2024-06-13T08:31:24,ACC00003551,Transfer,1568.53,-1859027.62,EUR,Shell
TXN0000019047,2024-09-24T08:41:28,ACC00001178,Debit,1129.17,-1860156.79,JPY,Target
TXN0000019048,2024-10-17T04:32:37,ACC00005476,Payment,673.89,-1860830.68,USD,Walmart
TXN0000019049,2024-09-24T21:02:55,ACC00004151,Payment,809.17,-1861639.85,JPY,Online Store
TXN0000019050,2024-01-23T20:19:45,ACC00001153,Debit,617.14,-1862256.99,EUR,Walmart
TXN0000019051,2024-08-08T07:16:09,ACC00003308,ATM,815.75,-1863072.74,USD,Walmart
TXN0000019052,2024-12-29T10:57:26,ACC00008653,Transfer,226.16,-1862846.58,GBP,Amazon
TXN0000019053,2024-07-18T09:39:59,ACC00002102,Credit,435.31,-1862411.27,JPY,Starbucks
TXN0000019054,2024-06-01T03:28:28,ACC00007408,Credit,982.42,-1861428.85,GBP,Walmart
TXN0000019055,2024-09-29T06:04:44,ACC00006230,Payment,1857.34,-1863286.19,GBP,Starbucks
TXN0000019056,2024-09-06T00:44:47,ACC00001892,Payment,1680.6,-1864966.79,USD,Walmart
TXN0000019057,2024-07-21T07:24:07,ACC00004493,Debit,557.66,-1865524.45,GBP,Restaurant
TXN0000019058,2024-09-08T18:22:13,ACC00000723,Credit,1812.01,-1863712.44,USD,Target
TXN0000019059,2024-01-25T14:38:39,ACC00002381,Debit,1638.99,-1865351.43,GBP,Amazon
TXN0000019060,2024-01-31T17:19:35,ACC00009573,ATM,1352.65,-1866704.08,EUR,Restaurant
TXN0000019061,2024-02-24T21:07:57,ACC00005820,Payment,1487.4,-1868191.48,EUR,Amazon
TXN0000019062,2024-04-12T01:45:05,ACC00008379,Transfer,186.67,-1868004.81,USD,Online Store
TXN0000019063,2024-05-13T12:15:26,ACC00005945,Payment,726.52,-1868731.33,EUR,Grocery
TXN0000019064,2024-07-19T18:38:56,ACC00007739,Transfer,1474.25,-1867257.08,USD,Walmart
TXN0000019065,2024-02-26T11:03:44,ACC00002582,Credit,637.18,-1866619.9,USD,Walmart
TXN0000019066,2024-12-07T05:18:09,ACC00009558,Transfer,868.67,-1865751.23,GBP,Online Store
TXN0000019067,2024-06-05T19:21:21,ACC00003571,Debit,715.09,-1866466.32,JPY,Online Store
TXN0000019068,2024-01-30T17:17:10,ACC00003408,Debit,1053.57,-1867519.89,GBP,Restaurant
TXN0000019069,2024-01-20T01:26:29,ACC00001033,Transfer,1170.04,-1866349.85,JPY,Online Store
TXN0000019070,2024-09-27T21:16:30,ACC00001154,ATM,670.24,-1867020.09,EUR,Online Store
TXN0000019071,2024-05-11T11:30:53,ACC00004757,Transfer,1070.97,-1865949.12,JPY,Walmart
TXN0000019072,2024-03-18T06:06:48,ACC00005319,Transfer,413.63,-1865535.49,EUR,Starbucks
TXN0000019073,2024-08-11T11:15:45,ACC00005540,Payment,397.72,-1865933.21,GBP,Shell
TXN0000019074,2024-04-14T12:42:46,ACC00002388,Payment,698.63,-1866631.84,GBP,Online Store
TXN0000019075,2024-11-22T14:56:57,ACC00008988,Debit,480.78,-1867112.62,USD,Walmart
TXN0000019076,2024-10-13T15:29:10,ACC00008339,Credit,1731.12,-1865381.5,GBP,Target
TXN0000019077,2024-08-10T16:28:57,ACC00008874,Transfer,998.36,-1864383.14,GBP,Online Store
TXN0000019078,2024-10-17T08:32:29,ACC00004778,Debit,702.08,-1865085.22,USD,Online Store
TXN0000019079,2024-05-20T09:23:24,ACC00006468,Credit,901.07,-1864184.15,EUR,Target
TXN0000019080,2024-07-18T23:32:14,ACC00004590,Debit,1958.96,-1866143.11,JPY,Target
TXN0000019081,2024-07-07T15:55:12,ACC00002926,ATM,630.14,-1866773.25,GBP,Shell
TXN0000019082,2024-12-27T09:55:15,ACC00001304,ATM,694.09,-1867467.34,EUR,Target
TXN0000019083,2024-09-24T01:53:07,ACC00008070,Transfer,112.12,-1867355.22,JPY,Online Store
TXN0000019084,2024-08-01T12:33:38,ACC00005907,Debit,1418.09,-1868773.31,EUR,Restaurant
TXN0000019085,2024-09-28T18:37:41,ACC00005535,Debit,1930.1,-1870703.41,USD,Walmart
TXN0000019086,2024-05-30T01:05:42,ACC00006271,Debit,1315.48,-1872018.89,EUR,Amazon
TXN0000019087,2024-09-10T23:05:32,ACC00007712,Debit,1843.09,-1873861.98,GBP,Target
TXN0000019088,2024-11-19T18:07:31,ACC00004479,Transfer,413.0,-1873448.98,EUR,Amazon
TXN0000019089,2024-05-26T18:19:50,ACC00000886,Debit,1580.29,-1875029.27,EUR,Walmart
TXN0000019090,2024-06-12T21:41:11,ACC00009755,Debit,948.83,-1875978.1,JPY,Online Store
TXN0000019091,2024-01-18T14:35:54,ACC00000908,ATM,322.8,-1876300.9,EUR,Starbucks
TXN0000019092,2024-01-12T06:53:58,ACC00001822,ATM,1086.49,-1877387.39,USD,Online Store
TXN0000019093,2024-08-27T07:07:01,ACC00004125,Credit,1266.64,-1876120.75,GBP,Grocery
TXN0000019094,2024-09-30T05:51:30,ACC00008598,Debit,529.86,-1876650.61,GBP,Restaurant
TXN0000019095,2024-06-05T19:55:16,ACC00006695,Credit,445.19,-1876205.42,USD,Restaurant
TXN0000019096,2024-02-24T04:25:47,ACC00009137,Transfer,438.1,-1875767.32,EUR,Target
TXN0000019097,2024-09-27T17:38:48,ACC00007400,Credit,1412.36,-1874354.96,GBP,Starbucks
TXN0000019098,2024-03-29T14:27:25,ACC00003385,ATM,391.81,-1874746.77,USD,Online Store
TXN0000019099,2024-11-19T22:13:57,ACC00000553,ATM,1891.7,-1876638.47,USD,Shell
TXN0000019100,2024-04-07T22:21:50,ACC00009744,Transfer,1019.42,-1875619.05,EUR,Amazon
TXN0000019101,2024-07-06T13:30:38,ACC00001505,ATM,227.36,-1875846.41,GBP,Restaurant
TXN0000019102,2024-07-14T11:19:30,ACC00007676,Debit,1574.89,-1877421.3,EUR,Grocery
TXN0000019103,2024-01-18T10:50:26,ACC00008661,Credit,1418.03,-1876003.27,JPY,Restaurant
TXN0000019104,2024-02-06T09:47:35,ACC00009566,Debit,1357.52,-1877360.79,JPY,Target
TXN0000019105,2024-11-13T15:32:33,ACC00004342,Debit,1901.83,-1879262.62,JPY,Grocery
TXN0000019106,2024-02-20T02:33:04,ACC00004062,Payment,250.65,-1879513.27,JPY,Walmart
TXN0000019107,2024-03-28T16:37:25,ACC00002423,Debit,133.13,-1879646.4,GBP,Amazon
TXN0000019108,2024-08-11T06:17:15,ACC00004543,Payment,1077.29,-1880723.69,EUR,Amazon
TXN0000019109,2024-04-20T06:00:19,ACC00001318,Transfer,1969.91,-1878753.78,EUR,Target
TXN0000019110,2024-11-20T21:40:15,ACC00009000,Transfer,1766.27,-1876987.51,JPY,Amazon
TXN0000019111,2024-01-07T06:39:07,ACC00008477,Credit,1392.63,-1875594.88,JPY,Grocery
TXN0000019112,2024-10-17T03:41:54,ACC00004151,Debit,954.1,-1876548.98,JPY,Starbucks
TXN0000019113,2024-02-22T16:37:12,ACC00004461,Payment,1409.3,-1877958.28,USD,Shell
TXN0000019114,2024-10-09T03:41:35,ACC00005810,ATM,1241.26,-1879199.54,GBP,Online Store
TXN0000019115,2024-11-09T23:22:10,ACC00003251,Transfer,217.26,-1878982.28,JPY,Walmart
TXN0000019116,2024-08-28T06:13:57,ACC00000257,Payment,1901.22,-1880883.5,GBP,Starbucks
TXN0000019117,2024-10-16T04:23:14,ACC00008276,Debit,51.88,-1880935.38,EUR,Grocery
TXN0000019118,2024-02-18T19:44:14,ACC00001605,Transfer,1906.87,-1879028.51,GBP,Online Store
TXN0000019119,2024-07-03T11:36:56,ACC00002554,Payment,1732.86,-1880761.37,JPY,Amazon
TXN0000019120,2024-05-29T22:12:32,ACC00006687,Credit,123.92,-1880637.45,USD,Walmart
TXN0000019121,2024-01-19T04:04:06,ACC00001208,Debit,585.24,-1881222.69,JPY,Online Store
TXN0000019122,2024-08-16T09:55:36,ACC00009085,ATM,1692.87,-1882915.56,EUR,Amazon
TXN0000019123,2024-11-20T13:57:10,ACC00002484,Payment,839.87,-1883755.43,JPY,Walmart
TXN0000019124,2024-05-09T20:48:58,ACC00005484,Debit,586.32,-1884341.75,USD,Online Store
TXN0000019125,2024-08-26T15:14:11,ACC00009214,Transfer,1599.91,-1882741.84,EUR,Shell
TXN0000019126,2024-07-14T18:24:29,ACC00007516,ATM,1808.21,-1884550.05,GBP,Starbucks
TXN0000019127,2024-08-03T13:16:47,ACC00005982,Payment,233.03,-1884783.08,USD,Target
TXN0000019128,2024-04-14T19:14:33,ACC00006967,Credit,580.09,-1884202.99,JPY,Amazon
TXN0000019129,2024-12-21T22:54:43,ACC00005764,Debit,1091.93,-1885294.92,EUR,Online Store
TXN0000019130,2024-07-21T18:54:40,ACC00002762,Payment,1619.07,-1886913.99,GBP,Grocery
TXN0000019131,2024-07-14T00:53:25,ACC00001729,Credit,933.18,-1885980.81,GBP,Starbucks
TXN0000019132,2024-10-24T00:10:54,ACC00008510,Payment,1759.57,-1887740.38,GBP,Online Store
TXN0000019133,2024-09-28T20:24:06,ACC00002250,Transfer,196.01,-1887544.37,GBP,Restaurant
TXN0000019134,2024-04-14T12:07:02,ACC00007990,Debit,1402.28,-1888946.65,JPY,Walmart
TXN0000019135,2024-10-01T01:17:09,ACC00008474,Transfer,1055.69,-1887890.96,JPY,Restaurant
TXN0000019136,2024-01-12T21:50:12,ACC00001449,Payment,638.08,-1888529.04,USD,Amazon
TXN0000019137,2024-08-21T10:17:27,ACC00006694,Credit,665.66,-1887863.38,JPY,Amazon
TXN0000019138,2024-01-05T19:53:46,ACC00004738,Transfer,694.71,-1887168.67,USD,Restaurant
TXN0000019139,2024-12-13T02:08:18,ACC00007699,Transfer,91.65,-1887077.02,EUR,Walmart
TXN0000019140,2024-06-16T17:37:08,ACC00007825,Credit,1383.55,-1885693.47,USD,Amazon
TXN0000019141,2024-11-26T13:14:07,ACC00009053,Debit,1981.8,-1887675.27,EUR,Amazon
TXN0000019142,2024-03-19T17:05:37,ACC00007543,Debit,688.79,-1888364.06,GBP,Target
TXN0000019143,2024-07-28T04:34:09,ACC00001364,ATM,354.84,-1888718.9,EUR,Amazon
TXN0000019144,2024-07-03T01:33:48,ACC00006227,Credit,318.47,-1888400.43,GBP,Restaurant
TXN0000019145,2024-03-11T00:55:08,ACC00002873,Credit,673.04,-1887727.39,GBP,Starbucks
TXN0000019146,2024-05-27T01:10:39,ACC00003574,ATM,35.95,-1887763.34,EUR,Target
TXN0000019147,2024-08-22T16:19:16,ACC00005255,Credit,823.94,-1886939.4,GBP,Shell
TXN0000019148,2024-05-31T00:18:24,ACC00009075,ATM,505.54,-1887444.94,GBP,Target
TXN0000019149,2024-10-28T05:42:47,ACC00008032,ATM,1508.97,-1888953.91,JPY,Amazon
TXN0000019150,2024-11-01T22:57:28,ACC00007858,Payment,374.26,-1889328.17,USD,Walmart
TXN0000019151,2024-03-05T16:28:22,ACC00001661,Payment,1909.1,-1891237.27,EUR,Grocery
TXN0000019152,2024-02-08T08:23:24,ACC00000269,Transfer,1947.3,-1889289.97,JPY,Amazon
TXN0000019153,2024-06-29T17:04:30,ACC00005674,Debit,300.7,-1889590.67,GBP,Restaurant
TXN0000019154,2024-05-06T11:24:40,ACC00006814,Debit,974.53,-1890565.2,GBP,Shell
TXN0000019155,2024-01-19T15:25:53,ACC00004807,Debit,826.88,-1891392.08,GBP,Target
TXN0000019156,2024-06-10T05:04:49,ACC00008101,Credit,746.23,-1890645.85,JPY,Restaurant
TXN0000019157,2024-05-26T06:18:28,ACC00006525,Transfer,1686.57,-1888959.28,EUR,Shell
TXN0000019158,2024-03-27T15:47:57,ACC00006264,Transfer,1738.43,-1887220.85,JPY,Walmart
TXN0000019159,2024-03-01T21:10:06,ACC00004977,Payment,1206.16,-1888427.01,USD,Amazon
TXN0000019160,2024-02-18T23:14:50,ACC00007273,Transfer,1444.99,-1886982.02,EUR,Grocery
TXN0000019161,2024-03-29T10:20:00,ACC00002145,ATM,928.6,-1887910.62,JPY,Amazon
TXN0000019162,2024-09-19T08:55:10,ACC00002299,Transfer,1689.94,-1886220.68,EUR,Grocery
TXN0000019163,2024-11-06T20:35:42,ACC00005680,Debit,491.33,-1886712.01,JPY,Amazon
TXN0000019164,2024-10-11T02:59:31,ACC00000469,ATM,684.9,-1887396.91,USD,Target
TXN0000019165,2024-11-09T20:50:25,ACC00002833,Credit,1171.72,-1886225.19,USD,Target
TXN0000019166,2024-11-30T02:19:49,ACC00000205,ATM,1306.12,-1887531.31,GBP,Amazon
TXN0000019167,2024-11-02T23:32:22,ACC00004774,Transfer,375.38,-1887155.93,JPY,Grocery
TXN0000019168,2024-04-27T10:37:30,ACC00002264,Debit,1088.51,-1888244.44,GBP,Amazon
TXN0000019169,2024-04-02T02:57:27,ACC00000444,ATM,510.11,-1888754.55,USD,Amazon
TXN0000019170,2024-08-27T11:02:03,ACC00004752,Debit,1819.58,-1890574.13,JPY,Starbucks
TXN0000019171,2024-06-11T03:06:50,ACC00008026,Payment,1468.83,-1892042.96,GBP,Restaurant
TXN0000019172,2024-06-28T07:11:08,ACC00000564,Debit,1438.05,-1893481.01,EUR,Walmart
TXN0000019173,2024-01-07T17:55:20,ACC00008961,Credit,1194.08,-1892286.93,USD,Starbucks
TXN0000019174,2024-10-23T18:12:43,ACC00006313,Credit,256.01,-1892030.92,GBP,Walmart
TXN0000019175,2024-12-07T10:07:02,ACC00002398,Debit,1095.75,-1893126.67,GBP,Online Store
TXN0000019176,2024-02-24T00:38:38,ACC00008157,Payment,833.06,-1893959.73,USD,Starbucks
TXN0000019177,2024-10-09T00:39:42,ACC00005258,Credit,629.11,-1893330.62,JPY,Amazon
TXN0000019178,2024-02-06T14:21:18,ACC00003836,Debit,1616.17,-1894946.79,USD,Shell
TXN0000019179,2024-08-16T19:38:06,ACC00009359,Payment,862.97,-1895809.76,USD,Grocery
TXN0000019180,2024-05-03T21:08:32,ACC00000460,ATM,971.96,-1896781.72,JPY,Amazon
TXN0000019181,2024-03-19T05:45:02,ACC00007663,Transfer,1174.05,-1895607.67,EUR,Starbucks
TXN0000019182,2024-10-03T16:53:19,ACC00003285,ATM,750.11,-1896357.78,EUR,Restaurant
TXN0000019183,2024-03-26T07:55:29,ACC00006583,Payment,302.93,-1896660.71,GBP,Grocery
TXN0000019184,2024-11-13T14:16:05,ACC00002309,ATM,178.74,-1896839.45,GBP,Shell
TXN0000019185,2024-11-11T14:39:56,ACC00001583,ATM,1941.15,-1898780.6,GBP,Starbucks
TXN0000019186,2024-04-26T20:07:51,ACC00005878,Payment,263.47,-1899044.07,JPY,Walmart
TXN0000019187,2024-03-20T16:20:22,ACC00006946,Transfer,55.73,-1898988.34,JPY,Online Store
TXN0000019188,2024-05-27T18:11:11,ACC00001627,ATM,446.0,-1899434.34,USD,Walmart
TXN0000019189,2024-12-04T09:29:38,ACC00000230,ATM,715.79,-1900150.13,EUR,Target
TXN0000019190,2024-05-17T10:39:09,ACC00008406,Transfer,1179.08,-1898971.05,GBP,Starbucks
TXN0000019191,2024-12-01T15:56:25,ACC00008414,Debit,140.78,-1899111.83,JPY,Shell
TXN0000019192,2024-11-01T10:01:12,ACC00001855,Payment,327.08,-1899438.91,GBP,Starbucks
TXN0000019193,2024-08-25T18:43:01,ACC00006709,Payment,1330.95,-1900769.86,USD,Amazon
TXN0000019194,2024-06-13T19:20:08,ACC00008841,Debit,480.85,-1901250.71,GBP,Walmart
TXN0000019195,2024-07-20T09:08:35,ACC00004433,Transfer,1079.58,-1900171.13,GBP,Online Store
TXN0000019196,2024-02-11T05:55:08,ACC00009945,ATM,155.98,-1900327.11,USD,Restaurant
TXN0000019197,2024-06-26T01:10:28,ACC00003338,Transfer,1357.62,-1898969.49,EUR,Shell
TXN0000019198,2024-07-05T02:52:41,ACC00007902,Credit,887.03,-1898082.46,USD,Amazon
TXN0000019199,2024-07-15T04:37:42,ACC00001041,Transfer,1816.23,-1896266.23,USD,Grocery
TXN0000019200,2024-07-08T01:23:24,ACC00000192,Payment,572.12,-1896838.35,USD,Amazon
TXN0000019201,2024-04-19T07:24:19,ACC00004949,Debit,1702.52,-1898540.87,JPY,Shell
TXN0000019202,2024-04-20T12:13:51,ACC00000104,Payment,1584.28,-1900125.15,EUR,Grocery
TXN0000019203,2024-05-29T08:00:44,ACC00006617,ATM,1834.35,-1901959.5,EUR,Target
TXN0000019204,2024-04-18T14:53:55,ACC00004461,Transfer,247.29,-1901712.21,JPY,Target
TXN0000019205,2024-12-14T22:58:59,ACC00004490,Debit,1467.38,-1903179.59,USD,Amazon
TXN0000019206,2024-11-04T03:02:01,ACC00000160,Debit,1528.23,-1904707.82,USD,Starbucks
TXN0000019207,2024-07-18T08:35:35,ACC00005380,Transfer,83.92,-1904623.9,EUR,Starbucks
TXN0000019208,2024-08-18T21:26:29,ACC00004115,Payment,936.71,-1905560.61,JPY,Amazon
TXN0000019209,2024-08-10T01:59:59,ACC00005968,Transfer,1500.29,-1904060.32,JPY,Target
TXN0000019210,2024-07-10T05:51:30,ACC00002865,Debit,1029.49,-1905089.81,EUR,Grocery
TXN0000019211,2024-01-25T08:41:58,ACC00000811,Payment,1875.56,-1906965.37,EUR,Target
TXN0000019212,2024-08-27T04:31:56,ACC00008179,Payment,1345.11,-1908310.48,USD,Grocery
TXN0000019213,2024-07-14T05:27:00,ACC00005712,Transfer,762.37,-1907548.11,EUR,Restaurant
TXN0000019214,2024-10-21T23:42:03,ACC00005695,Payment,838.41,-1908386.52,USD,Amazon
TXN0000019215,2024-09-14T17:05:17,ACC00004714,ATM,1106.88,-1909493.4,JPY,Shell
TXN0000019216,2024-07-04T13:35:22,ACC00002609,Credit,1677.09,-1907816.31,JPY,Grocery
TXN0000019217,2024-01-05T14:56:22,ACC00005744,Credit,504.08,-1907312.23,GBP,Grocery
TXN0000019218,2024-04-25T20:47:51,ACC00004993,ATM,1658.32,-1908970.55,GBP,Walmart
TXN0000019219,2024-10-17T11:31:11,ACC00006893,Debit,715.64,-1909686.19,GBP,Starbucks
TXN0000019220,2024-04-07T19:06:44,ACC00007663,Debit,1187.24,-1910873.43,EUR,Target
TXN0000019221,2024-02-22T09:56:12,ACC00001760,Debit,1951.17,-1912824.6,GBP,Starbucks
TXN0000019222,2024-03-05T15:29:57,ACC00001635,Transfer,1033.1,-1911791.5,JPY,Target
TXN0000019223,2024-05-04T02:03:32,ACC00002554,Debit,1989.24,-1913780.74,USD,Amazon
TXN0000019224,2024-06-17T20:26:22,ACC00003039,Transfer,1310.46,-1912470.28,JPY,Amazon
TXN0000019225,2024-11-04T06:59:18,ACC00008288,Transfer,1474.76,-1910995.52,JPY,Grocery
TXN0000019226,2024-03-09T10:05:51,ACC00004370,Credit,109.41,-1910886.11,USD,Amazon
TXN0000019227,2024-09-26T05:43:49,ACC00006467,Credit,143.94,-1910742.17,USD,Target
TXN0000019228,2024-12-07T15:20:05,ACC00007995,Credit,368.81,-1910373.36,EUR,Online Store
TXN0000019229,2024-02-06T03:44:23,ACC00009915,Debit,484.84,-1910858.2,GBP,Grocery
TXN0000019230,2024-03-01T23:23:11,ACC00004763,Debit,1390.95,-1912249.15,JPY,Starbucks
TXN0000019231,2024-05-29T00:31:55,ACC00005315,ATM,1229.52,-1913478.67,EUR,Grocery
TXN0000019232,2024-05-21T18:51:10,ACC00005716,Transfer,1280.53,-1912198.14,USD,Online Store
TXN0000019233,2024-10-01T17:20:21,ACC00005769,Credit,1182.69,-1911015.45,USD,Grocery
TXN0000019234,2024-10-15T19:47:32,ACC00009772,Credit,364.55,-1910650.9,JPY,Amazon
TXN0000019235,2024-04-02T10:21:45,ACC00006805,Debit,336.29,-1910987.19,JPY,Amazon
TXN0000019236,2024-12-02T00:32:42,ACC00002438,Credit,886.37,-1910100.82,USD,Walmart
TXN0000019237,2024-01-26T07:36:44,ACC00004991,Transfer,1451.58,-1908649.24,GBP,Starbucks
TXN0000019238,2024-07-15T19:42:45,ACC00002491,Payment,1487.56,-1910136.8,JPY,Target
TXN0000019239,2024-05-23T04:42:26,ACC00003857,Payment,281.03,-1910417.83,USD,Target
TXN0000019240,2024-08-10T06:42:04,ACC00008017,Credit,1668.14,-1908749.69,JPY,Shell
TXN0000019241,2024-08-11T05:09:53,ACC00001197,Transfer,20.68,-1908729.01,JPY,Online Store
TXN0000019242,2024-10-31T06:27:31,ACC00004750,Debit,1080.14,-1909809.15,EUR,Target
TXN0000019243,2024-11-08T20:07:23,ACC00009154,Transfer,984.27,-1908824.88,USD,Shell
TXN0000019244,2024-12-17T00:09:28,ACC00001640,Debit,1147.01,-1909971.89,GBP,Grocery
TXN0000019245,2024-06-06T20:16:15,ACC00002748,Payment,55.04,-1910026.93,JPY,Grocery
TXN0000019246,2024-10-30T09:22:45,ACC00000965,Debit,688.91,-1910715.84,JPY,Starbucks
TXN0000019247,2024-07-25T14:39:27,ACC00002786,Transfer,483.29,-1910232.55,GBP,Grocery
TXN0000019248,2024-06-24T02:08:34,ACC00009756,Transfer,1383.25,-1908849.3,EUR,Shell
TXN0000019249,2024-06-27T17:58:57,ACC00001369,Credit,1022.14,-1907827.16,USD,Grocery
TXN0000019250,2024-07-04T08:28:03,ACC00004976,ATM,1090.39,-1908917.55,JPY,Shell
TXN0000019251,2024-05-12T03:21:53,ACC00004894,Debit,1376.38,-1910293.93,GBP,Amazon
TXN0000019252,2024-10-24T10:46:52,ACC00007458,Debit,16.94,-1910310.87,JPY,Walmart
TXN0000019253,2024-06-25T15:18:54,ACC00002148,ATM,1557.27,-1911868.14,USD,Walmart
TXN0000019254,2024-01-06T02:25:14,ACC00006746,ATM,1384.52,-1913252.66,JPY,Shell
TXN0000019255,2024-07-20T04:18:16,ACC00007837,Payment,55.15,-1913307.81,GBP,Restaurant
TXN0000019256,2024-07-18T22:34:40,ACC00000457,Payment,156.18,-1913463.99,EUR,Target
TXN0000019257,2024-01-01T16:35:31,ACC00003428,Debit,601.29,-1914065.28,GBP,Target
TXN0000019258,2024-07-06T08:14:21,ACC00001750,Debit,377.12,-1914442.4,USD,Shell
TXN0000019259,2024-06-27T17:32:11,ACC00006951,Debit,204.85,-1914647.25,USD,Target
TXN0000019260,2024-05-30T22:55:29,ACC00004006,Credit,661.08,-1913986.17,USD,Amazon
TXN0000019261,2024-03-26T06:33:59,ACC00008386,Payment,1203.98,-1915190.15,USD,Amazon
TXN0000019262,2024-12-16T20:19:52,ACC00004513,Debit,1769.3,-1916959.45,EUR,Online Store
TXN0000019263,2024-05-10T18:51:57,ACC00008369,ATM,1462.18,-1918421.63,GBP,Grocery
TXN0000019264,2024-03-22T23:37:15,ACC00002254,Debit,1931.84,-1920353.47,EUR,Grocery
TXN0000019265,2024-04-14T02:41:13,ACC00001207,Transfer,403.15,-1919950.32,JPY,Amazon
TXN0000019266,2024-03-23T16:38:51,ACC00009384,Debit,1137.14,-1921087.46,GBP,Walmart
TXN0000019267,2024-11-13T16:07:48,ACC00005989,Payment,1484.38,-1922571.84,USD,Amazon
TXN0000019268,2024-11-01T07:20:45,ACC00009470,Payment,1128.36,-1923700.2,GBP,Starbucks
TXN0000019269,2024-04-09T20:18:51,ACC00005138,Transfer,1443.1,-1922257.1,JPY,Online Store
TXN0000019270,2024-09-12T08:35:08,ACC00004349,Transfer,982.19,-1921274.91,JPY,Target
TXN0000019271,2024-01-04T23:33:11,ACC00005313,Debit,178.81,-1921453.72,USD,Target
TXN0000019272,2024-09-11T07:35:40,ACC00006961,Payment,624.61,-1922078.33,USD,Grocery
TXN0000019273,2024-04-25T20:38:20,ACC00007096,Transfer,1989.82,-1920088.51,EUR,Starbucks
TXN0000019274,2024-05-29T23:25:21,ACC00000966,Debit,77.3,-1920165.81,JPY,Walmart
TXN0000019275,2024-07-25T13:04:15,ACC00004287,Credit,866.28,-1919299.53,EUR,Restaurant
TXN0000019276,2024-10-25T20:50:23,ACC00009440,Payment,1051.18,-1920350.71,EUR,Walmart
TXN0000019277,2024-12-30T14:21:59,ACC00007713,ATM,1560.5,-1921911.21,JPY,Amazon
TXN0000019278,2024-02-24T22:40:05,ACC00004639,ATM,114.53,-1922025.74,EUR,Shell
TXN0000019279,2024-10-09T09:26:59,ACC00005774,Transfer,580.61,-1921445.13,EUR,Amazon
TXN0000019280,2024-12-07T22:40:52,ACC00001930,Debit,33.48,-1921478.61,EUR,Grocery
TXN0000019281,2024-04-23T11:45:05,ACC00007277,ATM,320.11,-1921798.72,EUR,Target
TXN0000019282,2024-03-15T00:12:52,ACC00009819,Payment,1153.16,-1922951.88,JPY,Walmart
TXN0000019283,2024-11-05T06:38:03,ACC00002403,Debit,1397.02,-1924348.9,GBP,Starbucks
TXN0000019284,2024-08-08T04:52:59,ACC00009426,ATM,1808.57,-1926157.47,GBP,Walmart
TXN0000019285,2024-09-10T16:14:12,ACC00003270,Credit,655.64,-1925501.83,GBP,Restaurant
TXN0000019286,2024-12-08T18:15:16,ACC00004395,Credit,1557.44,-1923944.39,USD,Grocery
TXN0000019287,2024-02-23T08:32:24,ACC00009522,Payment,1111.87,-1925056.26,USD,Online Store
TXN0000019288,2024-03-03T22:53:34,ACC00001715,ATM,166.51,-1925222.77,EUR,Grocery
TXN0000019289,2024-07-21T08:52:27,ACC00002090,ATM,880.14,-1926102.91,EUR,Online Store
TXN0000019290,2024-01-03T18:10:05,ACC00002235,ATM,1108.05,-1927210.96,GBP,Starbucks
TXN0000019291,2024-08-29T18:44:25,ACC00003819,Transfer,1053.26,-1926157.7,JPY,Online Store
TXN0000019292,2024-07-21T07:05:23,ACC00009468,Debit,1677.45,-1927835.15,GBP,Shell
TXN0000019293,2024-11-21T01:22:39,ACC00001418,Payment,1068.99,-1928904.14,USD,Grocery
TXN0000019294,2024-05-09T05:09:23,ACC00006495,Credit,1278.34,-1927625.8,EUR,Restaurant
TXN0000019295,2024-02-14T00:25:38,ACC00004079,Credit,1914.23,-1925711.57,EUR,Walmart
TXN0000019296,2024-07-11T14:58:34,ACC00008281,Transfer,495.47,-1925216.1,GBP,Amazon
TXN0000019297,2024-09-03T01:07:59,ACC00003201,ATM,593.86,-1925809.96,GBP,Restaurant
TXN0000019298,2024-03-10T04:58:34,ACC00008069,Credit,46.95,-1925763.01,USD,Online Store
TXN0000019299,2024-12-16T03:04:07,ACC00006176,ATM,943.87,-1926706.88,EUR,Shell
TXN0000019300,2024-10-11T13:26:45,ACC00001209,Debit,559.15,-1927266.03,EUR,Restaurant
TXN0000019301,2024-07-09T16:39:53,ACC00006659,Credit,52.2,-1927213.83,USD,Grocery
TXN0000019302,2024-08-28T07:32:49,ACC00000287,Debit,824.04,-1928037.87,EUR,Restaurant
TXN0000019303,2024-11-08T03:26:37,ACC00007085,Credit,1279.88,-1926757.99,JPY,Shell
TXN0000019304,2024-09-03T21:37:25,ACC00005497,Credit,937.64,-1925820.35,GBP,Shell
TXN0000019305,2024-02-26T07:22:50,ACC00000837,Payment,78.06,-1925898.41,EUR,Grocery
TXN0000019306,2024-10-04T08:43:23,ACC00000558,Credit,644.82,-1925253.59,USD,Shell
TXN0000019307,2024-02-01T05:02:58,ACC00002902,ATM,1210.32,-1926463.91,JPY,Starbucks
TXN0000019308,2024-03-09T09:06:11,ACC00005816,Debit,1964.28,-1928428.19,JPY,Restaurant
TXN0000019309,2024-12-10T13:36:02,ACC00002314,ATM,23.48,-1928451.67,JPY,Amazon
TXN0000019310,2024-10-19T12:10:29,ACC00000045,ATM,1584.2,-1930035.87,JPY,Restaurant
TXN0000019311,2024-06-29T06:26:02,ACC00004081,Debit,1052.85,-1931088.72,USD,Starbucks
TXN0000019312,2024-02-17T20:27:27,ACC00001104,Transfer,114.04,-1930974.68,USD,Amazon
TXN0000019313,2024-03-23T00:13:08,ACC00007099,Payment,1159.99,-1932134.67,EUR,Walmart
TXN0000019314,2024-12-18T18:09:56,ACC00003283,Payment,1048.27,-1933182.94,USD,Grocery
TXN0000019315,2024-06-02T15:39:02,ACC00008558,Transfer,889.25,-1932293.69,EUR,Walmart
TXN0000019316,2024-04-11T10:36:38,ACC00006960,ATM,53.87,-1932347.56,JPY,Grocery
TXN0000019317,2024-09-01T00:55:03,ACC00002910,Transfer,159.01,-1932188.55,GBP,Amazon
TXN0000019318,2024-06-25T07:38:10,ACC00000844,Transfer,1638.95,-1930549.6,USD,Walmart
TXN0000019319,2024-10-08T23:07:55,ACC00000065,Payment,811.76,-1931361.36,EUR,Starbucks
TXN0000019320,2024-09-11T21:59:20,ACC00006829,Credit,858.82,-1930502.54,JPY,Online Store
TXN0000019321,2024-09-10T07:18:19,ACC00000684,Debit,674.05,-1931176.59,USD,Grocery
TXN0000019322,2024-12-04T13:42:47,ACC00001981,Debit,607.0,-1931783.59,JPY,Restaurant
TXN0000019323,2024-11-27T01:21:34,ACC00001415,Debit,1578.01,-1933361.6,USD,Online Store
TXN0000019324,2024-10-31T07:58:06,ACC00003149,Debit,1889.34,-1935250.94,GBP,Starbucks
TXN0000019325,2024-01-05T12:22:18,ACC00005465,Payment,1459.68,-1936710.62,GBP,Online Store
TXN0000019326,2024-05-24T22:29:12,ACC00006429,Credit,1306.16,-1935404.46,JPY,Grocery
TXN0000019327,2024-08-29T04:37:13,ACC00001928,Debit,1576.55,-1936981.01,JPY,Starbucks
TXN0000019328,2024-11-24T15:05:32,ACC00006760,Debit,915.28,-1937896.29,GBP,Target
TXN0000019329,2024-07-16T10:07:23,ACC00006156,Payment,1761.78,-1939658.07,GBP,Shell
TXN0000019330,2024-03-20T01:28:18,ACC00004423,ATM,1714.85,-1941372.92,USD,Restaurant
TXN0000019331,2024-11-12T15:00:42,ACC00005624,Debit,107.28,-1941480.2,GBP,Online Store
TXN0000019332,2024-12-19T02:42:30,ACC00000355,Payment,353.7,-1941833.9,EUR,Online Store
TXN0000019333,2024-04-16T03:19:52,ACC00007601,Payment,14.38,-1941848.28,JPY,Grocery
TXN0000019334,2024-06-01T13:57:12,ACC00001485,Payment,1493.46,-1943341.74,USD,Shell
TXN0000019335,2024-02-17T17:40:37,ACC00005173,Credit,220.47,-1943121.27,JPY,Online Store
TXN0000019336,2024-11-22T08:07:20,ACC00001735,Debit,1535.9,-1944657.17,GBP,Target
TXN0000019337,2024-03-22T21:32:33,ACC00008716,Payment,426.72,-1945083.89,EUR,Starbucks
TXN0000019338,2024-04-21T20:59:47,ACC00001659,ATM,513.73,-1945597.62,EUR,Starbucks
TXN0000019339,2024-09-10T15:46:47,ACC00003185,Transfer,242.6,-1945355.02,GBP,Amazon
TXN0000019340,2024-09-18T23:39:55,ACC00007397,Transfer,1546.41,-1943808.61,EUR,Online Store
TXN0000019341,2024-08-10T17:05:58,ACC00003311,ATM,982.42,-1944791.03,USD,Amazon
TXN0000019342,2024-03-17T19:19:01,ACC00002622,Transfer,1120.72,-1943670.31,GBP,Online Store
TXN0000019343,2024-09-01T06:45:14,ACC00000151,Credit,1761.9,-1941908.41,USD,Restaurant
TXN0000019344,2024-03-26T06:08:34,ACC00006342,Payment,1350.96,-1943259.37,JPY,Walmart
TXN0000019345,2024-12-12T23:08:21,ACC00001760,Transfer,1025.6,-1942233.77,JPY,Starbucks
TXN0000019346,2024-06-16T05:21:14,ACC00006892,Debit,1762.09,-1943995.86,JPY,Restaurant
TXN0000019347,2024-06-26T16:41:01,ACC00008019,Debit,394.58,-1944390.44,JPY,Shell
TXN0000019348,2024-06-02T18:46:22,ACC00002834,Credit,237.87,-1944152.57,EUR,Grocery
TXN0000019349,2024-01-16T15:12:25,ACC00004781,Debit,1640.97,-1945793.54,GBP,Grocery
TXN0000019350,2024-03-20T05:07:03,ACC00002903,ATM,1462.81,-1947256.35,EUR,Grocery
TXN0000019351,2024-02-19T10:24:27,ACC00001541,Payment,402.02,-1947658.37,USD,Amazon
TXN0000019352,2024-08-23T06:50:44,ACC00007282,Credit,592.75,-1947065.62,EUR,Walmart
TXN0000019353,2024-07-22T18:24:21,ACC00000145,Payment,1279.98,-1948345.6,JPY,Target
TXN0000019354,2024-04-02T09:20:21,ACC00007026,Payment,1188.59,-1949534.19,JPY,Starbucks
TXN0000019355,2024-06-19T07:34:58,ACC00005687,ATM,531.83,-1950066.02,EUR,Amazon
TXN0000019356,2024-09-24T04:48:53,ACC00001494,Credit,1935.51,-1948130.51,USD,Amazon
TXN0000019357,2024-04-13T12:46:27,ACC00006465,Debit,249.08,-1948379.59,GBP,Walmart
TXN0000019358,2024-06-15T07:04:10,ACC00004124,Transfer,482.48,-1947897.11,EUR,Amazon
TXN0000019359,2024-10-15T12:33:15,ACC00001760,Credit,1148.8,-1946748.31,EUR,Walmart
TXN0000019360,2024-04-28T11:44:29,ACC00007696,Payment,1437.38,-1948185.69,JPY,Shell
TXN0000019361,2024-11-12T16:25:34,ACC00006144,ATM,1501.12,-1949686.81,GBP,Online Store
TXN0000019362,2024-11-08T04:31:08,ACC00005199,Credit,267.37,-1949419.44,EUR,Shell
TXN0000019363,2024-02-20T18:07:12,ACC00006882,ATM,768.64,-1950188.08,JPY,Starbucks
TXN0000019364,2024-11-19T10:03:25,ACC00001001,Payment,556.03,-1950744.11,GBP,Grocery
TXN0000019365,2024-07-07T20:23:03,ACC00002875,ATM,1250.44,-1951994.55,JPY,Starbucks
TXN0000019366,2024-05-21T06:17:57,ACC00001097,ATM,518.28,-1952512.83,EUR,Grocery
TXN0000019367,2024-07-16T23:16:02,ACC00004520,Payment,1843.29,-1954356.12,JPY,Shell
TXN0000019368,2024-11-27T04:25:05,ACC00005864,Debit,1212.15,-1955568.27,USD,Restaurant
TXN0000019369,2024-09-05T05:48:55,ACC00002193,Transfer,1146.58,-1954421.69,GBP,Restaurant
TXN0000019370,2024-07-27T16:24:30,ACC00001373,Payment,1822.64,-1956244.33,GBP,Online Store
TXN0000019371,2024-10-07T22:46:14,ACC00008264,ATM,1342.37,-1957586.7,EUR,Target
TXN0000019372,2024-08-20T02:16:15,ACC00005067,Debit,1395.45,-1958982.15,GBP,Grocery
TXN0000019373,2024-09-10T09:56:28,ACC00003994,Debit,194.01,-1959176.16,JPY,Shell
TXN0000019374,2024-10-31T22:50:26,ACC00007641,Transfer,1344.41,-1957831.75,GBP,Amazon
TXN0000019375,2024-12-01T09:23:50,ACC00008839,Payment,1856.26,-1959688.01,EUR,Amazon
TXN0000019376,2024-09-01T08:04:57,ACC00004716,Payment,1850.98,-1961538.99,GBP,Starbucks
TXN0000019377,2024-03-28T16:31:46,ACC00006123,Transfer,326.77,-1961212.22,USD,Shell
TXN0000019378,2024-12-01T18:16:04,ACC00000008,Transfer,1321.06,-1959891.16,GBP,Online Store
TXN0000019379,2024-02-10T05:42:09,ACC00003288,Debit,969.83,-1960860.99,USD,Walmart
TXN0000019380,2024-02-13T23:04:18,ACC00007432,Payment,1345.63,-1962206.62,GBP,Walmart
TXN0000019381,2024-01-19T01:38:27,ACC00000885,Payment,1287.23,-1963493.85,EUR,Online Store
TXN0000019382,2024-04-29T07:24:18,ACC00003558,Credit,1010.08,-1962483.77,EUR,Target
TXN0000019383,2024-08-30T05:56:16,ACC00001372,Debit,340.86,-1962824.63,EUR,Restaurant
TXN0000019384,2024-06-08T05:33:16,ACC00000082,Credit,552.67,-1962271.96,EUR,Online Store
TXN0000019385,2024-05-31T19:42:46,ACC00002594,Debit,1103.68,-1963375.64,GBP,Shell
TXN0000019386,2024-08-10T05:49:00,ACC00005480,Debit,989.52,-1964365.16,EUR,Shell
TXN0000019387,2024-06-29T03:51:06,ACC00008435,Credit,1722.42,-1962642.74,USD,Grocery
TXN0000019388,2024-06-14T21:07:12,ACC00003416,ATM,1693.5,-1964336.24,GBP,Amazon
TXN0000019389,2024-09-03T23:23:10,ACC00003429,Credit,1383.25,-1962952.99,USD,Target
TXN0000019390,2024-10-23T08:35:34,ACC00002725,Payment,636.46,-1963589.45,USD,Walmart
TXN0000019391,2024-12-25T14:22:25,ACC00004639,Debit,991.22,-1964580.67,EUR,Starbucks
TXN0000019392,2024-05-23T13:55:55,ACC00004353,Debit,1856.76,-1966437.43,USD,Walmart
TXN0000019393,2024-11-04T19:56:07,ACC00005353,Credit,969.25,-1965468.18,JPY,Online Store
TXN0000019394,2024-04-11T16:13:54,ACC00002945,Debit,1163.67,-1966631.85,EUR,Target
TXN0000019395,2024-08-08T16:45:34,ACC00007264,Transfer,1158.72,-1965473.13,GBP,Shell
TXN0000019396,2024-12-10T03:58:05,ACC00001571,Transfer,110.96,-1965362.17,JPY,Target
TXN0000019397,2024-08-30T17:30:05,ACC00009471,Debit,179.21,-1965541.38,USD,Online Store
TXN0000019398,2024-03-19T13:44:27,ACC00000003,Transfer,953.23,-1964588.15,GBP,Restaurant
TXN0000019399,2024-07-21T13:40:16,ACC00002842,Transfer,690.37,-1963897.78,GBP,Restaurant
TXN0000019400,2024-09-10T11:08:43,ACC00005860,Payment,1224.44,-1965122.22,GBP,Walmart
TXN0000019401,2024-08-20T12:38:01,ACC00007571,Transfer,1453.97,-1963668.25,EUR,Target
TXN0000019402,2024-12-03T23:48:22,ACC00007808,Transfer,514.11,-1963154.14,EUR,Starbucks
TXN0000019403,2024-04-08T13:37:37,ACC00000350,Debit,927.87,-1964082.01,JPY,Shell
TXN0000019404,2024-05-28T20:18:04,ACC00003268,Transfer,437.49,-1963644.52,GBP,Grocery
TXN0000019405,2024-02-01T15:24:18,ACC00006071,ATM,698.67,-1964343.19,JPY,Grocery
TXN0000019406,2024-04-27T00:31:15,ACC00004260,Transfer,1932.41,-1962410.78,EUR,Target
TXN0000019407,2024-01-05T11:50:09,ACC00005169,Debit,982.38,-1963393.16,USD,Walmart
TXN0000019408,2024-01-02T15:27:54,ACC00006604,Debit,1007.32,-1964400.48,JPY,Amazon
TXN0000019409,2024-08-19T16:05:30,ACC00000039,Credit,994.76,-1963405.72,USD,Walmart
TXN0000019410,2024-11-25T02:34:25,ACC00001965,ATM,569.45,-1963975.17,JPY,Shell
TXN0000019411,2024-09-08T10:03:56,ACC00000861,ATM,1545.69,-1965520.86,GBP,Target
TXN0000019412,2024-01-30T22:08:34,ACC00005261,ATM,540.58,-1966061.44,JPY,Grocery
TXN0000019413,2024-05-22T06:25:31,ACC00007444,ATM,1693.76,-1967755.2,EUR,Restaurant
TXN0000019414,2024-04-30T08:20:23,ACC00008681,Payment,92.21,-1967847.41,JPY,Walmart
TXN0000019415,2024-05-16T19:17:04,ACC00005811,Transfer,1602.15,-1966245.26,JPY,Grocery
TXN0000019416,2024-01-28T01:37:13,ACC00005485,Transfer,1034.53,-1965210.73,GBP,Amazon
TXN0000019417,2024-05-09T00:40:02,ACC00002273,Debit,1280.47,-1966491.2,GBP,Shell
TXN0000019418,2024-10-14T06:37:27,ACC00003509,Debit,881.21,-1967372.41,USD,Starbucks
TXN0000019419,2024-06-04T10:08:51,ACC00001996,Credit,1821.64,-1965550.77,USD,Starbucks
TXN0000019420,2024-05-24T21:26:42,ACC00009431,Transfer,360.85,-1965189.92,JPY,Online Store
TXN0000019421,2024-04-14T00:47:12,ACC00004512,Debit,1116.95,-1966306.87,GBP,Walmart
TXN0000019422,2024-05-09T09:09:22,ACC00000102,Credit,1480.23,-1964826.64,JPY,Target
TXN0000019423,2024-12-26T07:22:12,ACC00000221,Payment,1643.16,-1966469.8,USD,Starbucks
TXN0000019424,2024-03-22T00:02:24,ACC00007341,Transfer,1305.66,-1965164.14,USD,Starbucks
TXN0000019425,2024-08-11T06:34:21,ACC00004096,Transfer,74.26,-1965089.88,USD,Target
TXN0000019426,2024-08-02T09:32:02,ACC00002953,Credit,75.93,-1965013.95,JPY,Starbucks
TXN0000019427,2024-12-27T01:23:02,ACC00002316,Credit,696.87,-1964317.08,EUR,Amazon
TXN0000019428,2024-07-06T13:11:45,ACC00005733,Debit,235.35,-1964552.43,JPY,Online Store
TXN0000019429,2024-11-25T06:56:22,ACC00005937,Credit,1447.04,-1963105.39,GBP,Target
TXN0000019430,2024-01-05T06:37:07,ACC00001934,Payment,355.27,-1963460.66,JPY,Amazon
TXN0000019431,2024-09-04T04:01:44,ACC00002185,ATM,868.36,-1964329.02,EUR,Online Store
TXN0000019432,2024-07-29T12:05:47,ACC00006094,Debit,840.04,-1965169.06,JPY,Grocery
TXN0000019433,2024-03-25T18:59:01,ACC00006084,ATM,1529.09,-1966698.15,GBP,Shell
TXN0000019434,2024-03-11T12:54:31,ACC00007132,Debit,226.03,-1966924.18,GBP,Grocery
TXN0000019435,2024-02-05T08:08:57,ACC00006361,Payment,1786.14,-1968710.32,JPY,Starbucks
TXN0000019436,2024-04-10T13:16:24,ACC00002723,ATM,1504.99,-1970215.31,GBP,Target
TXN0000019437,2024-11-03T20:11:17,ACC00006211,Payment,1737.19,-1971952.5,JPY,Grocery
TXN0000019438,2024-12-03T03:50:48,ACC00002285,Transfer,593.35,-1971359.15,USD,Walmart
TXN0000019439,2024-01-13T13:38:56,ACC00004274,Payment,606.67,-1971965.82,GBP,Restaurant
TXN0000019440,2024-05-13T08:35:33,ACC00000778,Transfer,803.06,-1971162.76,EUR,Shell
TXN0000019441,2024-05-13T12:55:53,ACC00007936,Payment,903.63,-1972066.39,GBP,Restaurant
TXN0000019442,2024-06-20T05:42:39,ACC00007411,Credit,752.54,-1971313.85,GBP,Amazon
TXN0000019443,2024-04-01T15:08:43,ACC00007846,Payment,1077.23,-1972391.08,USD,Restaurant
TXN0000019444,2024-08-23T17:08:56,ACC00007597,Credit,716.45,-1971674.63,JPY,Shell
TXN0000019445,2024-10-18T13:21:09,ACC00009075,Debit,1441.51,-1973116.14,USD,Grocery
TXN0000019446,2024-03-27T01:19:23,ACC00009446,Payment,297.63,-1973413.77,EUR,Grocery
TXN0000019447,2024-08-06T17:53:14,ACC00008448,Payment,692.27,-1974106.04,JPY,Walmart
TXN0000019448,2024-04-27T12:00:55,ACC00009032,Debit,1757.22,-1975863.26,JPY,Online Store
TXN0000019449,2024-04-05T23:39:47,ACC00007677,Debit,1124.27,-1976987.53,GBP,Starbucks
TXN0000019450,2024-10-26T16:30:54,ACC00006457,ATM,1694.49,-1978682.02,GBP,Starbucks
TXN0000019451,2024-02-08T23:40:28,ACC00008574,Debit,1172.76,-1979854.78,GBP,Grocery
TXN0000019452,2024-10-24T17:08:02,ACC00003800,Debit,1029.18,-1980883.96,USD,Starbucks
TXN0000019453,2024-08-04T02:09:13,ACC00002728,Credit,1049.07,-1979834.89,EUR,Grocery
TXN0000019454,2024-03-12T02:20:11,ACC00003685,Debit,118.5,-1979953.39,JPY,Target
TXN0000019455,2024-04-23T02:18:52,ACC00009473,Transfer,1845.4,-1978107.99,USD,Target
TXN0000019456,2024-12-11T20:33:55,ACC00005506,Debit,1625.22,-1979733.21,USD,Shell
TXN0000019457,2024-12-21T05:36:22,ACC00000540,Payment,982.35,-1980715.56,JPY,Target
TXN0000019458,2024-01-02T17:14:45,ACC00006776,Payment,1117.64,-1981833.2,JPY,Starbucks
TXN0000019459,2024-04-28T01:54:37,ACC00006802,Debit,1926.61,-1983759.81,EUR,Starbucks
TXN0000019460,2024-02-19T18:37:44,ACC00009725,Transfer,943.05,-1982816.76,EUR,Amazon
TXN0000019461,2024-03-16T17:14:45,ACC00000386,Payment,1704.54,-1984521.3,JPY,Shell
TXN0000019462,2024-01-28T17:20:50,ACC00003103,Debit,1346.74,-1985868.04,GBP,Shell
TXN0000019463,2024-03-24T21:02:28,ACC00009914,Transfer,145.5,-1985722.54,JPY,Grocery
TXN0000019464,2024-10-13T19:38:58,ACC00007952,Transfer,116.42,-1985606.12,EUR,Online Store
TXN0000019465,2024-03-16T20:31:43,ACC00003128,Transfer,1096.31,-1984509.81,GBP,Online Store
TXN0000019466,2024-02-12T13:31:02,ACC00000040,Credit,1007.9,-1983501.91,USD,Amazon
TXN0000019467,2024-03-05T14:49:11,ACC00002603,Credit,31.3,-1983470.61,GBP,Grocery
TXN0000019468,2024-07-30T10:37:32,ACC00008424,Credit,970.43,-1982500.18,JPY,Walmart
TXN0000019469,2024-04-22T17:14:54,ACC00005279,ATM,378.32,-1982878.5,JPY,Restaurant
TXN0000019470,2024-04-18T16:31:32,ACC00003963,Transfer,1483.36,-1981395.14,GBP,Target
TXN0000019471,2024-05-30T17:01:32,ACC00006789,Debit,1421.32,-1982816.46,GBP,Amazon
TXN0000019472,2024-09-23T20:54:43,ACC00002420,Debit,1402.87,-1984219.33,GBP,Shell
TXN0000019473,2024-01-15T13:21:28,ACC00004175,Credit,799.08,-1983420.25,USD,Starbucks
TXN0000019474,2024-10-08T23:23:35,ACC00000943,ATM,1023.34,-1984443.59,USD,Shell
TXN0000019475,2024-08-28T13:31:08,ACC00006750,Debit,968.92,-1985412.51,USD,Walmart
TXN0000019476,2024-08-04T02:54:15,ACC00004291,Debit,1576.76,-1986989.27,GBP,Walmart
TXN0000019477,2024-08-14T23:36:54,ACC00007433,Payment,200.87,-1987190.14,EUR,Online Store
TXN0000019478,2024-04-21T13:35:17,ACC00003128,Transfer,338.46,-1986851.68,EUR,Shell
TXN0000019479,2024-06-14T04:26:22,ACC00009476,Debit,1110.34,-1987962.02,GBP,Shell
TXN0000019480,2024-10-13T01:42:30,ACC00004406,Credit,35.81,-1987926.21,GBP,Grocery
TXN0000019481,2024-02-09T08:22:59,ACC00002925,Payment,1110.08,-1989036.29,USD,Shell
TXN0000019482,2024-07-11T00:44:04,ACC00004130,ATM,36.09,-1989072.38,GBP,Grocery
TXN0000019483,2024-10-22T06:06:29,ACC00003503,ATM,1710.85,-1990783.23,GBP,Grocery
TXN0000019484,2024-09-28T00:23:41,ACC00006407,ATM,1742.86,-1992526.09,JPY,Target
TXN0000019485,2024-08-21T09:55:29,ACC00007416,Transfer,1543.05,-1990983.04,JPY,Restaurant
TXN0000019486,2024-11-24T09:04:27,ACC00002192,ATM,803.69,-1991786.73,EUR,Starbucks
TXN0000019487,2024-10-25T10:17:57,ACC00003446,ATM,580.7,-1992367.43,JPY,Shell
TXN0000019488,2024-12-07T19:18:59,ACC00003471,Transfer,1428.88,-1990938.55,JPY,Amazon
TXN0000019489,2024-04-28T16:55:36,ACC00004318,Payment,402.93,-1991341.48,GBP,Target
TXN0000019490,2024-01-08T11:34:10,ACC00005595,Credit,617.91,-1990723.57,EUR,Shell
TXN0000019491,2024-11-17T19:45:15,ACC00004697,Debit,1835.78,-1992559.35,JPY,Amazon
TXN0000019492,2024-01-13T08:58:34,ACC00005706,Debit,1456.57,-1994015.92,USD,Walmart
TXN0000019493,2024-07-04T08:40:43,ACC00007088,Payment,1777.05,-1995792.97,EUR,Amazon
TXN0000019494,2024-05-20T17:58:53,ACC00008992,ATM,923.78,-1996716.75,JPY,Target
TXN0000019495,2024-12-10T02:49:39,ACC00001140,Credit,1157.65,-1995559.1,JPY,Shell
TXN0000019496,2024-07-19T11:31:04,ACC00005497,Debit,1508.51,-1997067.61,JPY,Online Store
TXN0000019497,2024-01-06T22:13:29,ACC00003105,Transfer,1280.24,-1995787.37,EUR,Target
TXN0000019498,2024-10-30T09:59:48,ACC00000862,Debit,101.18,-1995888.55,USD,Shell
TXN0000019499,2024-09-21T02:56:20,ACC00004092,Transfer,1565.69,-1994322.86,USD,Grocery
TXN0000019500,2024-11-06T04:42:01,ACC00009300,Credit,939.35,-1993383.51,EUR,Target
TXN0000019501,2024-10-18T01:34:19,ACC00002833,Payment,1295.99,-1994679.5,JPY,Online Store
TXN0000019502,2024-06-03T03:59:37,ACC00009925,ATM,1039.71,-1995719.21,USD,Online Store
TXN0000019503,2024-03-06T08:15:12,ACC00006766,Debit,1901.14,-1997620.35,EUR,Starbucks
TXN0000019504,2024-02-06T22:07:10,ACC00005324,Payment,1748.61,-1999368.96,USD,Target
TXN0000019505,2024-03-10T13:48:39,ACC00006853,Credit,1840.23,-1997528.73,USD,Starbucks
TXN0000019506,2024-11-28T22:47:48,ACC00006663,ATM,1790.42,-1999319.15,JPY,Grocery
TXN0000019507,2024-10-20T13:02:13,ACC00001442,Debit,785.45,-2000104.6,USD,Grocery
TXN0000019508,2024-06-21T04:53:13,ACC00002359,Credit,648.81,-1999455.79,JPY,Shell
TXN0000019509,2024-03-07T07:24:25,ACC00005227,Debit,858.11,-2000313.9,EUR,Target
TXN0000019510,2024-01-08T08:18:41,ACC00002650,Transfer,108.58,-2000205.32,EUR,Online Store
TXN0000019511,2024-03-23T07:34:00,ACC00006439,Debit,1452.44,-2001657.76,EUR,Restaurant
TXN0000019512,2024-06-16T15:32:24,ACC00006813,Debit,1266.71,-2002924.47,USD,Grocery
TXN0000019513,2024-02-05T00:27:15,ACC00002535,Debit,460.35,-2003384.82,JPY,Online Store
TXN0000019514,2024-04-17T03:48:04,ACC00005008,Debit,1576.51,-2004961.33,USD,Online Store
TXN0000019515,2024-06-03T14:12:26,ACC00004386,Payment,71.75,-2005033.08,EUR,Starbucks
TXN0000019516,2024-09-05T00:36:35,ACC00008139,Debit,61.64,-2005094.72,GBP,Walmart
TXN0000019517,2024-11-29T07:13:30,ACC00002758,ATM,1977.07,-2007071.79,GBP,Amazon
TXN0000019518,2024-01-24T23:57:29,ACC00000862,Transfer,303.79,-2006768.0,USD,Online Store
TXN0000019519,2024-02-09T10:34:05,ACC00009190,Debit,920.57,-2007688.57,JPY,Online Store
TXN0000019520,2024-09-26T13:06:33,ACC00002156,ATM,1747.9,-2009436.47,JPY,Starbucks
TXN0000019521,2024-10-08T14:34:11,ACC00006407,Credit,561.1,-2008875.37,JPY,Online Store
TXN0000019522,2024-04-17T18:16:58,ACC00001372,Debit,48.51,-2008923.88,JPY,Walmart
TXN0000019523,2024-06-16T18:55:54,ACC00004003,Credit,1952.42,-2006971.46,EUR,Grocery
TXN0000019524,2024-11-17T05:53:12,ACC00001745,ATM,491.26,-2007462.72,USD,Grocery
TXN0000019525,2024-05-27T21:17:22,ACC00002848,Debit,1154.31,-2008617.03,EUR,Grocery
TXN0000019526,2024-02-06T10:33:48,ACC00009942,Credit,1332.89,-2007284.14,USD,Grocery
TXN0000019527,2024-09-10T04:06:19,ACC00000303,Credit,1775.08,-2005509.06,GBP,Online Store
TXN0000019528,2024-10-15T23:41:12,ACC00005408,Credit,419.15,-2005089.91,GBP,Amazon
TXN0000019529,2024-11-19T03:29:32,ACC00008471,Debit,1777.62,-2006867.53,EUR,Grocery
TXN0000019530,2024-12-06T21:37:01,ACC00000890,Payment,1304.6,-2008172.13,GBP,Grocery
TXN0000019531,2024-07-24T19:49:43,ACC00004221,Credit,602.76,-2007569.37,EUR,Shell
TXN0000019532,2024-01-04T06:42:17,ACC00008147,Credit,524.3,-2007045.07,EUR,Grocery
TXN0000019533,2024-08-14T09:52:29,ACC00007864,Transfer,1994.36,-2005050.71,GBP,Target
TXN0000019534,2024-05-26T00:59:12,ACC00009583,ATM,1697.19,-2006747.9,GBP,Shell
TXN0000019535,2024-10-23T02:05:39,ACC00009316,Transfer,1062.58,-2005685.32,JPY,Walmart
TXN0000019536,2024-06-13T19:43:40,ACC00005266,Credit,1467.87,-2004217.45,GBP,Shell
TXN0000019537,2024-03-25T20:39:08,ACC00006158,Debit,1275.28,-2005492.73,EUR,Shell
TXN0000019538,2024-12-22T19:34:44,ACC00005212,Payment,1303.01,-2006795.74,JPY,Target
TXN0000019539,2024-09-18T11:05:18,ACC00003103,Transfer,1613.5,-2005182.24,USD,Target
TXN0000019540,2024-03-28T15:38:50,ACC00002275,Transfer,1794.81,-2003387.43,JPY,Grocery
TXN0000019541,2024-04-20T18:59:46,ACC00002991,Transfer,1844.37,-2001543.06,JPY,Amazon
TXN0000019542,2024-03-09T06:28:48,ACC00009366,Payment,1077.59,-2002620.65,USD,Target
TXN0000019543,2024-01-21T16:18:59,ACC00006542,Transfer,1700.6,-2000920.05,USD,Target
TXN0000019544,2024-10-17T09:51:47,ACC00007268,ATM,1327.47,-2002247.52,GBP,Grocery
TXN0000019545,2024-05-10T20:38:29,ACC00008412,Debit,1567.56,-2003815.08,JPY,Walmart
TXN0000019546,2024-11-09T18:46:10,ACC00004351,Payment,1822.47,-2005637.55,EUR,Target
TXN0000019547,2024-10-29T04:45:43,ACC00006201,Credit,227.85,-2005409.7,GBP,Amazon
TXN0000019548,2024-11-07T08:35:55,ACC00006758,Debit,512.65,-2005922.35,JPY,Online Store
TXN0000019549,2024-12-09T16:52:57,ACC00002305,Credit,992.55,-2004929.8,JPY,Target
TXN0000019550,2024-12-20T22:06:51,ACC00008911,Credit,1936.12,-2002993.68,EUR,Amazon
TXN0000019551,2024-07-13T16:34:32,ACC00002895,ATM,1584.25,-2004577.93,USD,Starbucks
TXN0000019552,2024-01-17T13:39:11,ACC00006300,Payment,1111.24,-2005689.17,USD,Restaurant
TXN0000019553,2024-11-28T03:46:58,ACC00001472,ATM,925.78,-2006614.95,EUR,Online Store
TXN0000019554,2024-11-30T16:49:47,ACC00005437,Credit,1823.19,-2004791.76,GBP,Amazon
TXN0000019555,2024-07-08T20:50:03,ACC00007786,Payment,1032.79,-2005824.55,JPY,Grocery
TXN0000019556,2024-07-16T21:30:17,ACC00003916,ATM,1112.33,-2006936.88,JPY,Online Store
TXN0000019557,2024-10-23T23:16:22,ACC00002720,Transfer,1406.36,-2005530.52,GBP,Restaurant
TXN0000019558,2024-10-23T13:00:28,ACC00003254,ATM,34.95,-2005565.47,JPY,Target
TXN0000019559,2024-04-23T20:07:38,ACC00005807,Debit,1250.42,-2006815.89,USD,Starbucks
TXN0000019560,2024-11-30T18:33:55,ACC00004581,Payment,1007.07,-2007822.96,USD,Online Store
TXN0000019561,2024-09-26T03:14:04,ACC00006977,ATM,623.62,-2008446.58,USD,Walmart
TXN0000019562,2024-08-31T13:12:44,ACC00008734,Debit,955.48,-2009402.06,JPY,Shell
TXN0000019563,2024-08-15T13:04:17,ACC00007234,Transfer,773.44,-2008628.62,EUR,Grocery
TXN0000019564,2024-02-11T20:36:05,ACC00006915,Transfer,450.16,-2008178.46,USD,Online Store
TXN0000019565,2024-07-12T10:44:33,ACC00002877,Credit,1536.84,-2006641.62,JPY,Restaurant
TXN0000019566,2024-02-20T01:00:16,ACC00007993,ATM,1542.92,-2008184.54,GBP,Target
TXN0000019567,2024-04-14T00:28:53,ACC00009620,Debit,1564.95,-2009749.49,JPY,Walmart
TXN0000019568,2024-08-15T23:56:59,ACC00001746,Credit,951.73,-2008797.76,USD,Starbucks
TXN0000019569,2024-12-15T04:12:59,ACC00007762,ATM,812.36,-2009610.12,GBP,Amazon
TXN0000019570,2024-08-13T14:28:12,ACC00007060,ATM,1327.5,-2010937.62,EUR,Online Store
TXN0000019571,2024-06-04T13:02:07,ACC00003483,Credit,1373.64,-2009563.98,GBP,Grocery
TXN0000019572,2024-03-31T21:24:25,ACC00001256,ATM,1993.34,-2011557.32,JPY,Online Store
TXN0000019573,2024-02-06T02:43:05,ACC00000323,Debit,1081.92,-2012639.24,USD,Target
TXN0000019574,2024-03-22T14:44:14,ACC00000512,Payment,1094.79,-2013734.03,JPY,Restaurant
TXN0000019575,2024-08-05T19:23:52,ACC00003617,Transfer,1238.82,-2012495.21,EUR,Amazon
TXN0000019576,2024-12-08T11:43:28,ACC00006549,Credit,10.47,-2012484.74,JPY,Amazon
TXN0000019577,2024-08-07T18:06:14,ACC00007900,Transfer,1139.86,-2011344.88,GBP,Starbucks
TXN0000019578,2024-04-02T01:23:45,ACC00006757,Debit,1396.64,-2012741.52,USD,Online Store
TXN0000019579,2024-09-24T07:58:51,ACC00006150,ATM,136.0,-2012877.52,EUR,Restaurant
TXN0000019580,2024-12-10T07:46:45,ACC00003098,Payment,1960.32,-2014837.84,USD,Online Store
TXN0000019581,2024-03-16T07:47:09,ACC00007838,Transfer,242.75,-2014595.09,GBP,Restaurant
TXN0000019582,2024-09-21T10:15:54,ACC00003657,Transfer,1301.52,-2013293.57,USD,Amazon
TXN0000019583,2024-12-23T09:14:05,ACC00009880,Transfer,971.26,-2012322.31,JPY,Shell
TXN0000019584,2024-04-08T06:06:48,ACC00007898,Credit,163.2,-2012159.11,EUR,Walmart
TXN0000019585,2024-10-07T13:57:28,ACC00003309,ATM,577.52,-2012736.63,GBP,Restaurant
TXN0000019586,2024-05-15T14:08:44,ACC00004309,Debit,193.35,-2012929.98,JPY,Target
TXN0000019587,2024-12-20T16:35:28,ACC00004197,ATM,478.69,-2013408.67,GBP,Amazon
TXN0000019588,2024-07-30T19:45:15,ACC00003161,ATM,1936.96,-2015345.63,JPY,Target
TXN0000019589,2024-07-12T03:26:14,ACC00007090,Credit,1760.36,-2013585.27,EUR,Shell
TXN0000019590,2024-05-02T12:18:00,ACC00006273,Credit,1956.44,-2011628.83,JPY,Target
TXN0000019591,2024-01-17T09:14:54,ACC00005134,Payment,153.5,-2011782.33,USD,Online Store
TXN0000019592,2024-03-10T02:00:35,ACC00002953,ATM,1605.29,-2013387.62,USD,Starbucks
TXN0000019593,2024-07-13T19:29:10,ACC00005561,Debit,74.58,-2013462.2,GBP,Amazon
TXN0000019594,2024-04-29T20:13:54,ACC00000905,Payment,655.97,-2014118.17,USD,Grocery
TXN0000019595,2024-10-14T08:19:08,ACC00000982,ATM,605.45,-2014723.62,USD,Online Store
TXN0000019596,2024-02-20T05:04:34,ACC00003620,Debit,922.03,-2015645.65,GBP,Target
TXN0000019597,2024-06-01T12:54:52,ACC00004451,Payment,997.98,-2016643.63,EUR,Online Store
TXN0000019598,2024-03-21T03:33:20,ACC00005405,Debit,1346.06,-2017989.69,EUR,Shell
TXN0000019599,2024-10-09T14:26:48,ACC00003525,Payment,1321.7,-2019311.39,GBP,Target
TXN0000019600,2024-09-04T02:05:30,ACC00009393,ATM,1050.44,-2020361.83,GBP,Walmart
TXN0000019601,2024-08-14T13:32:44,ACC00002667,Debit,1000.72,-2021362.55,USD,Walmart
TXN0000019602,2024-07-15T00:44:08,ACC00009402,Transfer,1923.64,-2019438.91,USD,Shell
TXN0000019603,2024-12-13T15:05:27,ACC00005025,Payment,1448.52,-2020887.43,GBP,Amazon
TXN0000019604,2024-10-01T02:44:37,ACC00000021,Transfer,876.74,-2020010.69,GBP,Restaurant
TXN0000019605,2024-09-23T14:04:20,ACC00003067,Credit,204.7,-2019805.99,JPY,Restaurant
TXN0000019606,2024-08-09T19:57:21,ACC00003129,Transfer,940.91,-2018865.08,GBP,Starbucks
TXN0000019607,2024-10-03T14:50:58,ACC00008596,ATM,1686.22,-2020551.3,EUR,Grocery
TXN0000019608,2024-12-19T07:01:39,ACC00005384,Debit,1286.29,-2021837.59,EUR,Shell
TXN0000019609,2024-12-17T05:39:57,ACC00004922,ATM,837.38,-2022674.97,EUR,Grocery
TXN0000019610,2024-11-18T18:34:45,ACC00005426,Debit,1766.48,-2024441.45,JPY,Starbucks
TXN0000019611,2024-12-28T07:58:33,ACC00003719,Transfer,1702.44,-2022739.01,EUR,Target
TXN0000019612,2024-07-15T13:58:43,ACC00004970,Payment,124.78,-2022863.79,JPY,Restaurant
TXN0000019613,2024-08-06T08:44:07,ACC00006348,Debit,890.66,-2023754.45,JPY,Walmart
TXN0000019614,2024-11-22T20:48:05,ACC00002238,Payment,1285.16,-2025039.61,JPY,Restaurant
TXN0000019615,2024-09-26T07:44:12,ACC00006916,Payment,195.68,-2025235.29,GBP,Target
TXN0000019616,2024-11-02T23:21:18,ACC00006382,Transfer,1302.42,-2023932.87,EUR,Restaurant
TXN0000019617,2024-09-27T10:09:55,ACC00006520,Debit,170.18,-2024103.05,EUR,Online Store
TXN0000019618,2024-06-28T02:28:44,ACC00002904,Payment,803.95,-2024907.0,USD,Starbucks
TXN0000019619,2024-05-06T06:50:51,ACC00000623,Transfer,942.44,-2023964.56,GBP,Online Store
TXN0000019620,2024-10-27T03:58:28,ACC00005116,Credit,1676.93,-2022287.63,USD,Walmart
TXN0000019621,2024-06-26T05:31:14,ACC00007837,Debit,474.21,-2022761.84,GBP,Shell
TXN0000019622,2024-06-28T15:56:22,ACC00001281,ATM,1471.05,-2024232.89,JPY,Online Store
TXN0000019623,2024-12-26T11:34:42,ACC00000195,Credit,1470.6,-2022762.29,USD,Shell
TXN0000019624,2024-07-28T06:42:36,ACC00004083,Credit,770.26,-2021992.03,JPY,Target
TXN0000019625,2024-02-25T19:51:00,ACC00002497,Payment,1265.24,-2023257.27,GBP,Online Store
TXN0000019626,2024-08-20T04:42:31,ACC00001818,ATM,673.95,-2023931.22,USD,Shell
TXN0000019627,2024-07-13T06:37:34,ACC00004804,Credit,347.79,-2023583.43,GBP,Amazon
TXN0000019628,2024-05-19T06:48:42,ACC00008790,Payment,615.58,-2024199.01,USD,Amazon
TXN0000019629,2024-09-29T06:56:33,ACC00008651,Debit,1430.18,-2025629.19,GBP,Walmart
TXN0000019630,2024-02-24T13:07:31,ACC00007182,Payment,1018.02,-2026647.21,JPY,Shell
TXN0000019631,2024-05-19T20:46:29,ACC00000350,Transfer,1881.5,-2024765.71,USD,Restaurant
TXN0000019632,2024-02-10T05:10:39,ACC00004879,ATM,846.79,-2025612.5,GBP,Walmart
TXN0000019633,2024-08-10T12:40:56,ACC00002300,Debit,805.42,-2026417.92,GBP,Amazon
TXN0000019634,2024-02-01T00:26:07,ACC00008137,Transfer,404.42,-2026013.5,USD,Online Store
TXN0000019635,2024-08-15T22:25:13,ACC00001344,Debit,1578.43,-2027591.93,JPY,Shell
TXN0000019636,2024-02-07T06:38:24,ACC00000901,Debit,1930.49,-2029522.42,EUR,Walmart
TXN0000019637,2024-06-17T16:58:06,ACC00007753,Credit,606.81,-2028915.61,GBP,Target
TXN0000019638,2024-02-11T13:33:40,ACC00009963,ATM,1410.58,-2030326.19,USD,Shell
TXN0000019639,2024-05-31T15:33:10,ACC00008169,Transfer,899.78,-2029426.41,JPY,Shell
TXN0000019640,2024-08-16T19:14:56,ACC00007847,Transfer,813.9,-2028612.51,EUR,Restaurant
TXN0000019641,2024-07-19T10:04:11,ACC00008406,Transfer,1203.67,-2027408.84,JPY,Starbucks
TXN0000019642,2024-03-21T13:15:08,ACC00000951,Debit,1638.8,-2029047.64,GBP,Online Store
TXN0000019643,2024-01-05T23:54:40,ACC00009857,ATM,842.9,-2029890.54,GBP,Restaurant
TXN0000019644,2024-06-04T06:33:38,ACC00004070,Debit,165.66,-2030056.2,GBP,Target
TXN0000019645,2024-08-07T19:09:02,ACC00005265,Payment,257.4,-2030313.6,USD,Online Store
TXN0000019646,2024-11-15T22:32:59,ACC00009603,Credit,1580.2,-2028733.4,USD,Target
TXN0000019647,2024-12-01T16:08:08,ACC00000529,Debit,1083.22,-2029816.62,GBP,Amazon
TXN0000019648,2024-12-14T08:23:42,ACC00008138,Transfer,217.13,-2029599.49,GBP,Restaurant
TXN0000019649,2024-06-15T21:55:34,ACC00007128,Payment,1829.2,-2031428.69,USD,Shell
TXN0000019650,2024-04-23T18:03:22,ACC00006242,Debit,409.76,-2031838.45,USD,Restaurant
TXN0000019651,2024-09-28T04:49:52,ACC00000819,Debit,583.92,-2032422.37,JPY,Grocery
TXN0000019652,2024-11-21T10:30:54,ACC00002169,Transfer,1280.93,-2031141.44,USD,Grocery
TXN0000019653,2024-01-07T19:54:53,ACC00009768,ATM,347.57,-2031489.01,JPY,Target
TXN0000019654,2024-02-24T14:33:58,ACC00001181,Debit,1535.96,-2033024.97,JPY,Shell
TXN0000019655,2024-07-20T03:57:50,ACC00001099,Credit,20.44,-2033004.53,GBP,Amazon
TXN0000019656,2024-11-11T22:32:29,ACC00002202,ATM,1501.89,-2034506.42,JPY,Amazon
TXN0000019657,2024-03-10T08:21:25,ACC00004808,Debit,589.93,-2035096.35,USD,Online Store
TXN0000019658,2024-02-25T17:05:28,ACC00001185,Credit,1338.14,-2033758.21,JPY,Shell
TXN0000019659,2024-11-22T19:02:15,ACC00008946,Payment,1510.23,-2035268.44,EUR,Restaurant
TXN0000019660,2024-06-21T03:45:07,ACC00006551,Credit,591.35,-2034677.09,GBP,Amazon
TXN0000019661,2024-03-19T03:12:00,ACC00008295,Credit,1493.53,-2033183.56,USD,Shell
TXN0000019662,2024-04-25T03:04:43,ACC00005621,Debit,875.07,-2034058.63,GBP,Amazon
TXN0000019663,2024-02-27T08:16:01,ACC00006576,Payment,376.56,-2034435.19,GBP,Shell
TXN0000019664,2024-07-13T06:14:13,ACC00004459,ATM,615.97,-2035051.16,USD,Online Store
TXN0000019665,2024-01-28T08:22:54,ACC00001865,Transfer,1205.24,-2033845.92,JPY,Amazon
TXN0000019666,2024-09-09T08:01:31,ACC00002278,ATM,1970.02,-2035815.94,USD,Target
TXN0000019667,2024-10-16T10:03:49,ACC00004226,Debit,851.38,-2036667.32,EUR,Online Store
TXN0000019668,2024-06-28T16:55:18,ACC00005735,Credit,340.46,-2036326.86,JPY,Online Store
TXN0000019669,2024-03-17T18:45:46,ACC00004912,ATM,1078.39,-2037405.25,GBP,Starbucks
TXN0000019670,2024-12-04T23:09:36,ACC00005842,ATM,659.19,-2038064.44,USD,Starbucks
TXN0000019671,2024-12-17T18:30:41,ACC00008423,Debit,230.03,-2038294.47,GBP,Online Store
TXN0000019672,2024-03-25T05:13:04,ACC00006573,Payment,940.4,-2039234.87,GBP,Amazon
TXN0000019673,2024-05-17T11:04:28,ACC00003962,Payment,1953.16,-2041188.03,GBP,Online Store
TXN0000019674,2024-03-31T20:13:58,ACC00002822,Payment,662.19,-2041850.22,EUR,Starbucks
TXN0000019675,2024-11-17T09:16:21,ACC00001572,Transfer,37.98,-2041812.24,GBP,Grocery
TXN0000019676,2024-01-17T07:51:07,ACC00005499,Debit,113.65,-2041925.89,EUR,Grocery
TXN0000019677,2024-05-11T19:14:52,ACC00002625,ATM,110.94,-2042036.83,EUR,Walmart
TXN0000019678,2024-02-10T08:51:32,ACC00005962,Credit,1319.4,-2040717.43,USD,Online Store
TXN0000019679,2024-09-16T08:35:21,ACC00007850,Payment,235.4,-2040952.83,JPY,Grocery
TXN0000019680,2024-12-12T14:07:31,ACC00004100,Debit,1774.21,-2042727.04,EUR,Restaurant
TXN0000019681,2024-01-13T20:26:45,ACC00009875,Transfer,1537.77,-2041189.27,GBP,Walmart
TXN0000019682,2024-11-14T10:37:28,ACC00005921,Debit,281.62,-2041470.89,EUR,Amazon
TXN0000019683,2024-04-14T16:29:32,ACC00003717,Transfer,1486.74,-2039984.15,JPY,Shell
TXN0000019684,2024-11-28T11:16:00,ACC00004106,Payment,263.12,-2040247.27,EUR,Walmart
TXN0000019685,2024-04-23T22:22:03,ACC00008932,Payment,1980.58,-2042227.85,EUR,Target
TXN0000019686,2024-02-21T01:50:05,ACC00002822,ATM,1098.33,-2043326.18,GBP,Starbucks
TXN0000019687,2024-08-18T11:55:54,ACC00009456,Debit,1923.73,-2045249.91,EUR,Starbucks
TXN0000019688,2024-03-04T19:54:33,ACC00001233,ATM,945.35,-2046195.26,GBP,Target
TXN0000019689,2024-03-31T09:11:15,ACC00003360,Transfer,956.54,-2045238.72,USD,Target
TXN0000019690,2024-04-11T05:04:14,ACC00004243,Credit,143.99,-2045094.73,JPY,Restaurant
TXN0000019691,2024-05-02T02:21:18,ACC00009257,ATM,1803.68,-2046898.41,GBP,Amazon
TXN0000019692,2024-09-22T05:33:58,ACC00001000,Debit,724.36,-2047622.77,GBP,Grocery
TXN0000019693,2024-08-11T15:23:54,ACC00006841,Payment,1472.96,-2049095.73,USD,Shell
TXN0000019694,2024-11-08T23:18:34,ACC00002177,Credit,858.77,-2048236.96,JPY,Walmart
TXN0000019695,2024-03-07T10:15:30,ACC00000455,Debit,522.06,-2048759.02,USD,Online Store
TXN0000019696,2024-07-03T00:26:06,ACC00003202,Debit,482.41,-2049241.43,GBP,Grocery
TXN0000019697,2024-06-01T20:39:20,ACC00003710,Debit,719.67,-2049961.1,JPY,Amazon
TXN0000019698,2024-09-12T14:41:54,ACC00002369,Debit,178.4,-2050139.5,USD,Amazon
TXN0000019699,2024-09-29T11:06:51,ACC00005083,Debit,1121.54,-2051261.04,GBP,Online Store
TXN0000019700,2024-11-18T04:37:09,ACC00001076,Transfer,1879.52,-2049381.52,EUR,Restaurant
TXN0000019701,2024-02-22T18:32:56,ACC00000809,Transfer,1863.75,-2047517.77,JPY,Target
TXN0000019702,2024-05-29T00:22:25,ACC00009248,Transfer,425.68,-2047092.09,GBP,Restaurant
TXN0000019703,2024-01-05T12:23:44,ACC00007547,Transfer,1583.93,-2045508.16,JPY,Restaurant
TXN0000019704,2024-10-28T06:57:33,ACC00004136,ATM,831.87,-2046340.03,JPY,Walmart
TXN0000019705,2024-10-25T14:47:15,ACC00007571,Credit,1792.34,-2044547.69,EUR,Starbucks
TXN0000019706,2024-09-20T02:51:11,ACC00008966,Credit,37.44,-2044510.25,GBP,Online Store
TXN0000019707,2024-05-16T18:22:19,ACC00001382,Payment,141.23,-2044651.48,JPY,Walmart
TXN0000019708,2024-07-27T02:22:12,ACC00000406,Debit,131.38,-2044782.86,EUR,Starbucks
TXN0000019709,2024-10-17T19:55:35,ACC00006621,Debit,1361.78,-2046144.64,JPY,Restaurant
TXN0000019710,2024-07-27T11:04:33,ACC00000697,Transfer,891.3,-2045253.34,GBP,Amazon
TXN0000019711,2024-04-30T19:02:52,ACC00003860,Credit,1107.38,-2044145.96,JPY,Grocery
TXN0000019712,2024-09-24T00:44:11,ACC00008318,Credit,148.13,-2043997.83,JPY,Amazon
TXN0000019713,2024-04-05T03:09:20,ACC00009314,Payment,1075.55,-2045073.38,USD,Walmart
TXN0000019714,2024-04-03T07:46:16,ACC00006210,Credit,512.51,-2044560.87,EUR,Starbucks
TXN0000019715,2024-04-15T04:37:04,ACC00005243,Debit,1541.55,-2046102.42,USD,Target
TXN0000019716,2024-09-24T16:26:15,ACC00002663,Debit,325.2,-2046427.62,USD,Online Store
TXN0000019717,2024-03-31T22:09:13,ACC00000594,Transfer,653.6,-2045774.02,GBP,Grocery
TXN0000019718,2024-07-17T06:29:30,ACC00006279,Credit,1633.58,-2044140.44,GBP,Amazon
TXN0000019719,2024-12-30T16:05:26,ACC00009492,Transfer,1020.31,-2043120.13,EUR,Starbucks
TXN0000019720,2024-09-29T00:02:09,ACC00008863,ATM,1101.9,-2044222.03,EUR,Walmart
TXN0000019721,2024-02-16T22:45:59,ACC00004847,Debit,35.25,-2044257.28,USD,Walmart
TXN0000019722,2024-03-12T09:58:48,ACC00004490,Payment,720.98,-2044978.26,JPY,Shell
TXN0000019723,2024-04-09T07:58:17,ACC00002777,Transfer,887.33,-2044090.93,USD,Target
TXN0000019724,2024-09-17T19:29:02,ACC00006039,Credit,14.82,-2044076.11,JPY,Restaurant
TXN0000019725,2024-02-19T12:25:50,ACC00005985,Transfer,505.56,-2043570.55,USD,Target
TXN0000019726,2024-02-09T14:20:49,ACC00001966,Payment,1905.07,-2045475.62,USD,Shell
TXN0000019727,2024-05-04T01:20:52,ACC00000148,Payment,1032.86,-2046508.48,GBP,Shell
TXN0000019728,2024-07-13T11:18:36,ACC00000952,Credit,1091.63,-2045416.85,GBP,Shell
TXN0000019729,2024-01-20T14:11:47,ACC00006853,Transfer,952.64,-2044464.21,USD,Shell
TXN0000019730,2024-12-04T21:10:28,ACC00005388,ATM,967.71,-2045431.92,GBP,Walmart
TXN0000019731,2024-11-13T15:26:21,ACC00006509,Payment,651.55,-2046083.47,USD,Target
TXN0000019732,2024-12-05T03:30:29,ACC00007955,Transfer,1028.06,-2045055.41,EUR,Shell
TXN0000019733,2024-10-08T05:01:23,ACC00000733,Payment,732.92,-2045788.33,GBP,Amazon
TXN0000019734,2024-11-26T03:13:49,ACC00001176,Transfer,73.61,-2045714.72,GBP,Grocery
TXN0000019735,2024-06-01T13:52:46,ACC00004959,Transfer,1350.47,-2044364.25,EUR,Starbucks
TXN0000019736,2024-12-19T05:16:20,ACC00009512,ATM,967.64,-2045331.89,EUR,Walmart
TXN0000019737,2024-02-19T14:05:36,ACC00003018,ATM,636.82,-2045968.71,GBP,Grocery
TXN0000019738,2024-04-05T22:53:43,ACC00001478,Transfer,1705.83,-2044262.88,JPY,Grocery
TXN0000019739,2024-08-22T13:55:50,ACC00006984,Credit,12.19,-2044250.69,JPY,Target
TXN0000019740,2024-02-04T18:42:29,ACC00003838,Payment,727.86,-2044978.55,GBP,Restaurant
TXN0000019741,2024-03-18T21:44:57,ACC00000752,Payment,373.55,-2045352.1,EUR,Starbucks
TXN0000019742,2024-11-12T01:57:09,ACC00002514,Credit,1536.05,-2043816.05,JPY,Starbucks
TXN0000019743,2024-06-09T00:16:41,ACC00003139,Payment,1270.32,-2045086.37,EUR,Grocery
TXN0000019744,2024-04-09T13:03:33,ACC00005421,Payment,1556.33,-2046642.7,JPY,Amazon
TXN0000019745,2024-02-19T02:45:33,ACC00005239,Debit,789.58,-2047432.28,USD,Amazon
TXN0000019746,2024-12-17T02:40:03,ACC00009485,Payment,568.93,-2048001.21,EUR,Starbucks
TXN0000019747,2024-09-12T00:28:33,ACC00007011,Credit,952.58,-2047048.63,JPY,Online Store
TXN0000019748,2024-10-23T02:32:07,ACC00009578,Credit,796.33,-2046252.3,USD,Shell
TXN0000019749,2024-12-13T20:34:27,ACC00009261,Credit,1703.56,-2044548.74,USD,Shell
TXN0000019750,2024-09-01T21:58:47,ACC00009471,Payment,1593.94,-2046142.68,JPY,Restaurant
TXN0000019751,2024-08-26T22:42:33,ACC00006155,Credit,446.53,-2045696.15,EUR,Grocery
TXN0000019752,2024-12-19T13:33:57,ACC00009534,Transfer,1554.53,-2044141.62,GBP,Starbucks
TXN0000019753,2024-11-24T00:21:48,ACC00004299,Credit,64.3,-2044077.32,JPY,Online Store
TXN0000019754,2024-12-12T12:23:05,ACC00006055,Credit,1052.45,-2043024.87,USD,Target
TXN0000019755,2024-09-11T08:17:34,ACC00007639,ATM,1206.36,-2044231.23,GBP,Amazon
TXN0000019756,2024-02-23T00:16:25,ACC00001220,Debit,1749.37,-2045980.6,USD,Starbucks
TXN0000019757,2024-09-15T21:49:49,ACC00001310,Debit,877.38,-2046857.98,JPY,Shell
TXN0000019758,2024-02-03T20:57:30,ACC00009598,Debit,164.41,-2047022.39,GBP,Target
TXN0000019759,2024-09-08T15:15:45,ACC00000136,Debit,1665.81,-2048688.2,GBP,Walmart
TXN0000019760,2024-10-19T04:01:11,ACC00000803,Credit,868.54,-2047819.66,USD,Target
TXN0000019761,2024-07-27T16:26:34,ACC00006848,Credit,1235.96,-2046583.7,USD,Target
TXN0000019762,2024-12-19T06:34:59,ACC00008839,Debit,1363.62,-2047947.32,USD,Walmart
TXN0000019763,2024-12-06T13:49:13,ACC00000757,Credit,1330.61,-2046616.71,GBP,Target
TXN0000019764,2024-05-01T07:43:04,ACC00004684,Debit,421.55,-2047038.26,USD,Amazon
TXN0000019765,2024-08-24T06:46:10,ACC00008265,Transfer,1730.12,-2045308.14,JPY,Online Store
TXN0000019766,2024-02-22T15:31:31,ACC00006034,Credit,1663.77,-2043644.37,GBP,Amazon
TXN0000019767,2024-02-19T07:52:51,ACC00003733,Transfer,1198.33,-2042446.04,GBP,Starbucks
TXN0000019768,2024-03-02T04:05:05,ACC00008523,ATM,417.65,-2042863.69,GBP,Shell
TXN0000019769,2024-10-14T00:46:01,ACC00008977,ATM,284.19,-2043147.88,GBP,Shell
TXN0000019770,2024-02-12T14:32:48,ACC00009785,ATM,1070.52,-2044218.4,JPY,Restaurant
TXN0000019771,2024-09-17T07:46:39,ACC00003340,Credit,401.67,-2043816.73,USD,Amazon
TXN0000019772,2024-07-26T15:00:55,ACC00005393,Debit,1605.35,-2045422.08,JPY,Amazon
TXN0000019773,2024-07-20T21:16:04,ACC00005639,Credit,760.71,-2044661.37,JPY,Walmart
TXN0000019774,2024-04-15T01:46:55,ACC00000959,ATM,1009.1,-2045670.47,GBP,Shell
TXN0000019775,2024-07-20T10:28:39,ACC00003323,Credit,1030.71,-2044639.76,JPY,Online Store
TXN0000019776,2024-01-02T17:14:10,ACC00003949,Credit,1956.81,-2042682.95,JPY,Shell
TXN0000019777,2024-12-04T06:32:44,ACC00007340,Payment,1805.34,-2044488.29,JPY,Online Store
TXN0000019778,2024-10-26T02:30:15,ACC00002223,ATM,165.81,-2044654.1,JPY,Restaurant
TXN0000019779,2024-04-21T08:27:12,ACC00009817,Debit,727.38,-2045381.48,JPY,Walmart
TXN0000019780,2024-05-29T09:46:08,ACC00007759,ATM,1979.54,-2047361.02,GBP,Target
TXN0000019781,2024-10-04T02:21:31,ACC00003947,ATM,115.21,-2047476.23,JPY,Target
TXN0000019782,2024-06-20T07:12:26,ACC00005392,Credit,390.27,-2047085.96,GBP,Starbucks
TXN0000019783,2024-05-25T01:40:56,ACC00000540,Credit,369.53,-2046716.43,JPY,Grocery
TXN0000019784,2024-03-18T00:24:24,ACC00000049,Payment,867.71,-2047584.14,GBP,Walmart
TXN0000019785,2024-04-28T14:31:22,ACC00006636,Transfer,830.94,-2046753.2,GBP,Restaurant
TXN0000019786,2024-12-07T03:52:25,ACC00008655,Transfer,1058.03,-2045695.17,EUR,Walmart
TXN0000019787,2024-08-13T15:23:23,ACC00005713,ATM,1186.9,-2046882.07,JPY,Shell
TXN0000019788,2024-12-21T17:07:07,ACC00005920,ATM,729.5,-2047611.57,EUR,Restaurant
TXN0000019789,2024-12-02T03:46:04,ACC00002645,ATM,123.06,-2047734.63,USD,Online Store
TXN0000019790,2024-06-19T04:58:48,ACC00006474,Payment,1848.23,-2049582.86,USD,Shell
TXN0000019791,2024-09-12T14:20:15,ACC00006767,Transfer,1988.85,-2047594.01,JPY,Target
TXN0000019792,2024-01-26T18:55:18,ACC00000675,Transfer,1718.59,-2045875.42,JPY,Target
TXN0000019793,2024-07-01T19:35:45,ACC00007812,Payment,916.63,-2046792.05,EUR,Shell
TXN0000019794,2024-03-26T12:21:37,ACC00002336,ATM,1247.5,-2048039.55,JPY,Shell
TXN0000019795,2024-05-23T21:48:05,ACC00005500,Debit,1767.32,-2049806.87,USD,Amazon
TXN0000019796,2024-09-08T08:40:56,ACC00008912,ATM,724.39,-2050531.26,GBP,Starbucks
TXN0000019797,2024-07-16T03:49:33,ACC00006357,ATM,1223.26,-2051754.52,EUR,Starbucks
TXN0000019798,2024-05-09T09:54:30,ACC00008146,ATM,724.65,-2052479.17,JPY,Starbucks
TXN0000019799,2024-01-08T21:48:24,ACC00001797,ATM,1276.61,-2053755.78,GBP,Starbucks
TXN0000019800,2024-10-05T20:28:23,ACC00008014,ATM,1112.58,-2054868.36,GBP,Walmart
TXN0000019801,2024-05-07T21:50:03,ACC00004860,ATM,562.08,-2055430.44,USD,Grocery
TXN0000019802,2024-01-21T17:21:58,ACC00003637,Debit,18.55,-2055448.99,JPY,Walmart
TXN0000019803,2024-01-07T07:30:51,ACC00000446,Credit,566.37,-2054882.62,JPY,Amazon
TXN0000019804,2024-09-01T17:42:17,ACC00008252,Credit,101.98,-2054780.64,USD,Shell
TXN0000019805,2024-04-30T19:17:58,ACC00008890,ATM,1221.7,-2056002.34,USD,Target
TXN0000019806,2024-04-18T11:35:04,ACC00003722,ATM,1849.77,-2057852.11,JPY,Starbucks
TXN0000019807,2024-02-17T04:15:38,ACC00004145,Credit,1701.37,-2056150.74,EUR,Walmart
TXN0000019808,2024-04-22T16:37:02,ACC00002131,Debit,850.93,-2057001.67,JPY,Grocery
TXN0000019809,2024-02-24T21:43:52,ACC00006808,Payment,1850.08,-2058851.75,USD,Grocery
TXN0000019810,2024-08-21T10:24:13,ACC00001252,ATM,1374.46,-2060226.21,USD,Amazon
TXN0000019811,2024-03-21T00:40:54,ACC00007982,ATM,84.69,-2060310.9,EUR,Walmart
TXN0000019812,2024-06-22T13:05:57,ACC00004595,Payment,175.51,-2060486.41,GBP,Target
TXN0000019813,2024-09-07T22:56:29,ACC00005590,Transfer,1528.82,-2058957.59,USD,Walmart
TXN0000019814,2024-05-22T13:39:42,ACC00008447,Credit,698.29,-2058259.3,GBP,Target
TXN0000019815,2024-09-08T16:04:39,ACC00004912,ATM,249.12,-2058508.42,EUR,Shell
TXN0000019816,2024-07-26T14:49:38,ACC00006409,Transfer,1352.65,-2057155.77,GBP,Shell
TXN0000019817,2024-10-14T15:01:22,ACC00003972,Transfer,229.0,-2056926.77,GBP,Grocery
TXN0000019818,2024-01-19T14:14:31,ACC00002733,Payment,733.4,-2057660.17,JPY,Starbucks
TXN0000019819,2024-01-20T15:40:16,ACC00000823,Payment,177.09,-2057837.26,EUR,Shell
TXN0000019820,2024-03-19T19:34:25,ACC00005944,Credit,655.44,-2057181.82,JPY,Shell
TXN0000019821,2024-08-06T23:43:38,ACC00007116,Payment,1212.16,-2058393.98,USD,Starbucks
TXN0000019822,2024-12-04T20:11:03,ACC00007118,Transfer,1978.38,-2056415.6,USD,Amazon
TXN0000019823,2024-11-22T21:39:53,ACC00001002,Transfer,198.14,-2056217.46,JPY,Starbucks
TXN0000019824,2024-03-27T03:23:26,ACC00003782,Credit,587.23,-2055630.23,GBP,Target
TXN0000019825,2024-07-09T05:25:05,ACC00001547,ATM,164.3,-2055794.53,GBP,Online Store
TXN0000019826,2024-08-17T02:09:41,ACC00008998,Payment,1266.44,-2057060.97,USD,Amazon
TXN0000019827,2024-04-18T15:17:02,ACC00008930,Credit,883.21,-2056177.76,USD,Target
TXN0000019828,2024-10-31T05:43:46,ACC00000303,ATM,1231.63,-2057409.39,JPY,Grocery
TXN0000019829,2024-08-27T13:13:13,ACC00002212,Transfer,291.98,-2057117.41,USD,Amazon
TXN0000019830,2024-07-06T11:51:13,ACC00006937,Transfer,1389.87,-2055727.54,EUR,Walmart
TXN0000019831,2024-08-06T20:07:56,ACC00002936,ATM,1835.42,-2057562.96,GBP,Grocery
TXN0000019832,2024-01-28T12:46:18,ACC00005987,Debit,1979.61,-2059542.57,GBP,Amazon
TXN0000019833,2024-03-29T20:40:12,ACC00003454,Transfer,1432.02,-2058110.55,USD,Restaurant
TXN0000019834,2024-05-03T17:55:26,ACC00009117,Credit,1287.68,-2056822.87,EUR,Restaurant
TXN0000019835,2024-09-30T02:54:15,ACC00002508,Debit,1402.88,-2058225.75,JPY,Grocery
TXN0000019836,2024-07-03T05:37:01,ACC00003202,Debit,1441.65,-2059667.4,JPY,Walmart
TXN0000019837,2024-12-13T18:47:40,ACC00002221,Payment,150.98,-2059818.38,JPY,Walmart
TXN0000019838,2024-03-16T06:43:00,ACC00002734,Credit,442.26,-2059376.12,JPY,Walmart
TXN0000019839,2024-11-25T08:40:30,ACC00000024,ATM,1863.89,-2061240.01,JPY,Restaurant
TXN0000019840,2024-10-17T10:09:14,ACC00006612,Debit,515.78,-2061755.79,EUR,Starbucks
TXN0000019841,2024-04-09T21:47:23,ACC00008998,Credit,51.86,-2061703.93,USD,Grocery
TXN0000019842,2024-08-16T05:32:37,ACC00005877,Transfer,1326.63,-2060377.3,USD,Amazon
TXN0000019843,2024-10-17T13:07:34,ACC00002860,Payment,1903.26,-2062280.56,JPY,Walmart
TXN0000019844,2024-06-04T11:10:45,ACC00007148,ATM,879.04,-2063159.6,GBP,Amazon
TXN0000019845,2024-06-13T09:18:24,ACC00003446,Payment,1231.94,-2064391.54,JPY,Amazon
TXN0000019846,2024-11-06T23:40:53,ACC00003821,Debit,30.94,-2064422.48,USD,Shell
TXN0000019847,2024-06-13T07:03:19,ACC00007130,ATM,709.7,-2065132.18,EUR,Walmart
TXN0000019848,2024-09-20T15:08:02,ACC00009428,Payment,1935.92,-2067068.1,EUR,Shell
TXN0000019849,2024-03-02T17:56:52,ACC00006578,Credit,1778.67,-2065289.43,JPY,Grocery
TXN0000019850,2024-11-14T05:01:46,ACC00003914,ATM,1354.77,-2066644.2,GBP,Online Store
TXN0000019851,2024-09-21T06:18:53,ACC00005664,Credit,767.8,-2065876.4,GBP,Restaurant
TXN0000019852,2024-04-30T02:43:32,ACC00000518,ATM,949.3,-2066825.7,JPY,Starbucks
TXN0000019853,2024-04-14T21:33:06,ACC00004732,Payment,273.96,-2067099.66,USD,Amazon
TXN0000019854,2024-05-22T22:57:05,ACC00001886,Transfer,1263.27,-2065836.39,GBP,Target
TXN0000019855,2024-02-05T07:12:22,ACC00002351,Transfer,1602.73,-2064233.66,JPY,Amazon
TXN0000019856,2024-12-28T21:13:29,ACC00001285,ATM,88.89,-2064322.55,GBP,Target
TXN0000019857,2024-09-29T21:58:19,ACC00001763,Credit,1073.45,-2063249.1,JPY,Target
TXN0000019858,2024-09-13T10:39:19,ACC00005755,Payment,1319.47,-2064568.57,GBP,Walmart
TXN0000019859,2024-07-18T12:27:35,ACC00004486,Credit,973.47,-2063595.1,EUR,Grocery
TXN0000019860,2024-04-23T11:18:15,ACC00005777,ATM,332.25,-2063927.35,JPY,Shell
TXN0000019861,2024-03-27T11:05:50,ACC00004179,Debit,1707.04,-2065634.39,GBP,Starbucks
TXN0000019862,2024-04-22T13:45:00,ACC00005590,Transfer,1281.82,-2064352.57,GBP,Walmart
TXN0000019863,2024-09-23T13:17:35,ACC00006471,Payment,1268.68,-2065621.25,EUR,Restaurant
TXN0000019864,2024-12-03T18:55:28,ACC00000408,Debit,1828.66,-2067449.91,JPY,Starbucks
TXN0000019865,2024-03-06T13:53:42,ACC00008725,ATM,1865.18,-2069315.09,JPY,Walmart
TXN0000019866,2024-05-06T16:32:54,ACC00001257,ATM,275.12,-2069590.21,JPY,Target
TXN0000019867,2024-12-09T19:37:55,ACC00002157,Credit,152.15,-2069438.06,GBP,Walmart
TXN0000019868,2024-05-06T13:03:06,ACC00006410,ATM,871.49,-2070309.55,USD,Starbucks
TXN0000019869,2024-01-14T21:10:01,ACC00000230,ATM,1687.14,-2071996.69,EUR,Online Store
TXN0000019870,2024-08-20T20:23:43,ACC00003642,Transfer,1422.18,-2070574.51,USD,Walmart
TXN0000019871,2024-03-09T00:56:17,ACC00006710,Credit,1189.1,-2069385.41,USD,Amazon
TXN0000019872,2024-03-14T01:00:50,ACC00000518,Transfer,39.14,-2069346.27,EUR,Online Store
TXN0000019873,2024-09-17T03:29:28,ACC00003526,Transfer,824.25,-2068522.02,EUR,Grocery
TXN0000019874,2024-07-06T00:07:02,ACC00006109,Payment,664.69,-2069186.71,USD,Online Store
TXN0000019875,2024-06-30T04:08:30,ACC00007552,Debit,55.11,-2069241.82,EUR,Amazon
TXN0000019876,2024-12-26T22:57:07,ACC00003912,Debit,1354.02,-2070595.84,USD,Starbucks
TXN0000019877,2024-01-29T00:03:21,ACC00007305,Credit,830.77,-2069765.07,USD,Walmart
TXN0000019878,2024-02-29T07:47:35,ACC00007356,Debit,1934.82,-2071699.89,JPY,Target
TXN0000019879,2024-07-10T15:05:07,ACC00001504,Debit,1783.55,-2073483.44,GBP,Amazon
TXN0000019880,2024-06-28T05:07:05,ACC00004390,Payment,1625.77,-2075109.21,EUR,Amazon
TXN0000019881,2024-07-28T15:48:04,ACC00008287,ATM,596.48,-2075705.69,JPY,Amazon
TXN0000019882,2024-11-30T00:19:28,ACC00006182,Transfer,1481.71,-2074223.98,EUR,Starbucks
TXN0000019883,2024-07-21T13:25:31,ACC00009184,Debit,1156.69,-2075380.67,EUR,Shell
TXN0000019884,2024-11-16T10:24:13,ACC00004400,ATM,1101.29,-2076481.96,USD,Target
TXN0000019885,2024-09-29T05:44:43,ACC00003454,ATM,1130.91,-2077612.87,JPY,Target
TXN0000019886,2024-03-15T10:28:03,ACC00009802,Credit,368.61,-2077244.26,USD,Walmart
TXN0000019887,2024-10-02T07:03:12,ACC00008861,ATM,258.95,-2077503.21,USD,Online Store
TXN0000019888,2024-01-21T08:41:30,ACC00003889,Credit,807.7,-2076695.51,USD,Walmart
TXN0000019889,2024-06-22T00:33:43,ACC00004864,Credit,35.46,-2076660.05,EUR,Target
TXN0000019890,2024-05-29T13:39:32,ACC00005712,ATM,1347.16,-2078007.21,EUR,Starbucks
TXN0000019891,2024-02-07T19:03:39,ACC00009602,Debit,329.08,-2078336.29,USD,Online Store
TXN0000019892,2024-08-20T00:40:44,ACC00001329,Transfer,1636.38,-2076699.91,JPY,Starbucks
TXN0000019893,2024-05-05T02:40:28,ACC00002844,Payment,1026.21,-2077726.12,USD,Shell
TXN0000019894,2024-10-12T05:36:28,ACC00001874,Debit,59.14,-2077785.26,USD,Shell
TXN0000019895,2024-09-20T15:21:50,ACC00007483,Credit,1432.31,-2076352.95,USD,Shell
TXN0000019896,2024-06-18T18:29:20,ACC00000498,Debit,651.1,-2077004.05,EUR,Shell
TXN0000019897,2024-07-02T19:06:52,ACC00009704,Credit,938.12,-2076065.93,USD,Online Store
TXN0000019898,2024-08-04T02:20:25,ACC00005073,Debit,1694.56,-2077760.49,USD,Starbucks
TXN0000019899,2024-04-16T20:33:23,ACC00005636,ATM,1648.66,-2079409.15,EUR,Online Store
TXN0000019900,2024-12-09T08:11:39,ACC00004409,Payment,396.47,-2079805.62,USD,Amazon
TXN0000019901,2024-02-15T12:21:06,ACC00008523,Debit,1692.76,-2081498.38,EUR,Starbucks
TXN0000019902,2024-08-01T18:11:47,ACC00007413,Payment,505.13,-2082003.51,GBP,Target
TXN0000019903,2024-04-19T18:06:00,ACC00004190,Credit,864.96,-2081138.55,USD,Target
TXN0000019904,2024-08-16T18:22:18,ACC00000648,Credit,1845.83,-2079292.72,USD,Walmart
TXN0000019905,2024-05-04T17:08:56,ACC00004165,Payment,1322.86,-2080615.58,JPY,Shell
TXN0000019906,2024-06-25T03:53:20,ACC00001378,Payment,288.55,-2080904.13,USD,Shell
TXN0000019907,2024-07-19T03:24:13,ACC00005290,Transfer,174.44,-2080729.69,JPY,Shell
TXN0000019908,2024-12-01T11:04:19,ACC00009021,ATM,836.29,-2081565.98,EUR,Walmart
TXN0000019909,2024-07-01T21:11:35,ACC00004670,Payment,253.38,-2081819.36,GBP,Online Store
TXN0000019910,2024-09-25T22:07:10,ACC00004870,Transfer,1347.27,-2080472.09,GBP,Amazon
TXN0000019911,2024-11-08T12:02:04,ACC00001821,Debit,1405.88,-2081877.97,GBP,Shell
TXN0000019912,2024-10-31T12:57:05,ACC00005715,Credit,217.07,-2081660.9,USD,Shell
TXN0000019913,2024-07-05T10:14:11,ACC00006267,ATM,1652.27,-2083313.17,GBP,Grocery
TXN0000019914,2024-02-01T10:22:10,ACC00001545,Debit,1422.09,-2084735.26,USD,Starbucks
TXN0000019915,2024-12-04T10:12:23,ACC00002579,Payment,264.98,-2085000.24,EUR,Restaurant
TXN0000019916,2024-04-23T07:57:14,ACC00002271,ATM,107.27,-2085107.51,EUR,Shell
TXN0000019917,2024-05-20T07:25:32,ACC00009756,Transfer,1219.82,-2083887.69,EUR,Target
TXN0000019918,2024-01-22T05:26:44,ACC00000810,ATM,1407.71,-2085295.4,USD,Restaurant
TXN0000019919,2024-07-16T16:07:46,ACC00000606,Debit,1763.76,-2087059.16,EUR,Grocery
TXN0000019920,2024-04-08T13:07:06,ACC00004508,ATM,248.05,-2087307.21,JPY,Grocery
TXN0000019921,2024-01-15T17:47:31,ACC00002330,Transfer,1232.85,-2086074.36,USD,Grocery
TXN0000019922,2024-05-14T21:28:49,ACC00009074,Payment,359.86,-2086434.22,GBP,Target
TXN0000019923,2024-01-03T18:34:07,ACC00002315,Payment,785.14,-2087219.36,GBP,Target
TXN0000019924,2024-10-27T18:41:30,ACC00008385,Debit,1739.14,-2088958.5,GBP,Shell
TXN0000019925,2024-07-26T07:29:32,ACC00005692,ATM,1280.38,-2090238.88,GBP,Restaurant
TXN0000019926,2024-12-21T15:55:47,ACC00008122,Transfer,1759.34,-2088479.54,EUR,Target
TXN0000019927,2024-03-22T11:25:22,ACC00000714,Payment,17.22,-2088496.76,JPY,Grocery
TXN0000019928,2024-12-23T01:34:18,ACC00000767,Debit,726.67,-2089223.43,JPY,Online Store
TXN0000019929,2024-08-03T19:54:17,ACC00009693,Debit,662.51,-2089885.94,GBP,Target
TXN0000019930,2024-11-29T16:16:35,ACC00000253,ATM,1793.84,-2091679.78,USD,Grocery
TXN0000019931,2024-01-12T07:17:15,ACC00006420,Transfer,1114.53,-2090565.25,GBP,Amazon
TXN0000019932,2024-03-12T03:15:50,ACC00009062,Transfer,382.0,-2090183.25,USD,Online Store
TXN0000019933,2024-05-25T03:56:12,ACC00005393,Debit,1390.06,-2091573.31,JPY,Grocery
TXN0000019934,2024-09-20T12:42:13,ACC00002267,Credit,1490.51,-2090082.8,EUR,Shell
TXN0000019935,2024-06-04T12:58:37,ACC00002840,ATM,19.72,-2090102.52,USD,Restaurant
TXN0000019936,2024-06-05T06:44:50,ACC00001939,Debit,1287.32,-2091389.84,EUR,Amazon
TXN0000019937,2024-10-20T19:36:48,ACC00001307,Transfer,422.13,-2090967.71,USD,Online Store
TXN0000019938,2024-12-25T00:05:33,ACC00007233,Transfer,1187.57,-2089780.14,USD,Restaurant
TXN0000019939,2024-10-19T13:10:33,ACC00003301,Credit,402.48,-2089377.66,EUR,Walmart
TXN0000019940,2024-01-01T05:32:14,ACC00001834,Credit,1348.68,-2088028.98,JPY,Amazon
TXN0000019941,2024-10-01T18:38:06,ACC00006865,Debit,449.99,-2088478.97,USD,Restaurant
TXN0000019942,2024-10-26T21:06:48,ACC00004328,Transfer,957.41,-2087521.56,USD,Online Store
TXN0000019943,2024-01-06T19:42:43,ACC00009718,ATM,821.59,-2088343.15,JPY,Target
TXN0000019944,2024-04-02T11:56:12,ACC00008208,Payment,1146.27,-2089489.42,JPY,Walmart
TXN0000019945,2024-04-15T15:50:11,ACC00006968,Debit,1001.03,-2090490.45,EUR,Starbucks
TXN0000019946,2024-09-18T13:01:12,ACC00002925,Credit,529.93,-2089960.52,JPY,Starbucks
TXN0000019947,2024-04-26T05:19:18,ACC00001119,Transfer,352.73,-2089607.79,USD,Online Store
TXN0000019948,2024-01-14T00:56:46,ACC00009229,Debit,682.0,-2090289.79,USD,Amazon
TXN0000019949,2024-07-04T18:53:49,ACC00007714,Debit,1861.16,-2092150.95,GBP,Amazon
TXN0000019950,2024-11-03T06:45:24,ACC00002922,Debit,1539.54,-2093690.49,USD,Shell
TXN0000019951,2024-01-09T13:16:17,ACC00008148,Payment,1759.63,-2095450.12,EUR,Shell
TXN0000019952,2024-08-05T14:39:55,ACC00007527,Debit,1043.3,-2096493.42,USD,Grocery
TXN0000019953,2024-12-09T23:25:16,ACC00002430,ATM,753.61,-2097247.03,GBP,Starbucks
TXN0000019954,2024-01-28T04:44:55,ACC00003180,Transfer,1133.71,-2096113.32,EUR,Amazon
TXN0000019955,2024-07-10T23:47:26,ACC00006304,Credit,753.23,-2095360.09,GBP,Starbucks
TXN0000019956,2024-04-18T08:22:58,ACC00003044,Debit,1112.27,-2096472.36,GBP,Target
TXN0000019957,2024-02-11T11:43:17,ACC00003625,Payment,164.98,-2096637.34,USD,Amazon
TXN0000019958,2024-01-16T02:36:26,ACC00003756,Payment,1037.86,-2097675.2,USD,Starbucks
TXN0000019959,2024-09-03T18:35:05,ACC00004292,Payment,467.61,-2098142.81,JPY,Amazon
TXN0000019960,2024-10-08T13:07:12,ACC00005554,Transfer,1208.07,-2096934.74,USD,Grocery
TXN0000019961,2024-06-27T02:01:15,ACC00007718,ATM,321.84,-2097256.58,EUR,Online Store
TXN0000019962,2024-01-13T16:12:06,ACC00004141,Debit,324.8,-2097581.38,EUR,Grocery
TXN0000019963,2024-11-14T17:13:51,ACC00004795,Transfer,326.8,-2097254.58,EUR,Shell
TXN0000019964,2024-01-28T18:34:16,ACC00009813,ATM,528.69,-2097783.27,EUR,Grocery
TXN0000019965,2024-07-07T15:55:32,ACC00001262,ATM,1201.98,-2098985.25,GBP,Online Store
TXN0000019966,2024-12-03T18:26:25,ACC00000980,Transfer,1465.83,-2097519.42,JPY,Online Store
TXN0000019967,2024-03-27T21:57:13,ACC00008869,Transfer,1075.16,-2096444.26,JPY,Shell
TXN0000019968,2024-03-07T15:16:05,ACC00007146,Payment,1177.48,-2097621.74,USD,Shell
TXN0000019969,2024-07-19T08:49:50,ACC00002167,Debit,643.23,-2098264.97,GBP,Online Store
TXN0000019970,2024-06-01T16:36:17,ACC00009608,Payment,508.6,-2098773.57,EUR,Restaurant
TXN0000019971,2024-02-24T16:17:37,ACC00008490,Payment,1638.96,-2100412.53,EUR,Grocery
TXN0000019972,2024-05-08T06:29:47,ACC00001127,ATM,1294.17,-2101706.7,JPY,Starbucks
TXN0000019973,2024-05-01T10:23:58,ACC00002454,Credit,591.28,-2101115.42,JPY,Online Store
TXN0000019974,2024-12-04T01:10:40,ACC00008991,ATM,201.84,-2101317.26,GBP,Restaurant
TXN0000019975,2024-02-27T18:36:32,ACC00009698,Transfer,1110.7,-2100206.56,GBP,Grocery
TXN0000019976,2024-05-06T08:47:33,ACC00006557,Payment,120.86,-2100327.42,USD,Target
TXN0000019977,2024-01-28T03:37:59,ACC00004689,Payment,1155.83,-2101483.25,USD,Target
TXN0000019978,2024-06-27T12:23:55,ACC00004523,ATM,1054.29,-2102537.54,EUR,Online Store
TXN0000019979,2024-01-22T13:17:20,ACC00009619,Credit,126.37,-2102411.17,JPY,Walmart
TXN0000019980,2024-08-12T16:32:21,ACC00001147,Transfer,1662.46,-2100748.71,GBP,Target
TXN0000019981,2024-02-28T02:08:40,ACC00004295,Transfer,1505.55,-2099243.16,JPY,Shell
TXN0000019982,2024-06-10T07:04:17,ACC00003714,Debit,903.43,-2100146.59,JPY,Grocery
TXN0000019983,2024-07-22T12:50:46,ACC00003144,Debit,1112.36,-2101258.95,GBP,Restaurant
TXN0000019984,2024-09-18T10:22:58,ACC00001285,Transfer,1093.31,-2100165.64,JPY,Grocery
TXN0000019985,2024-10-27T20:53:18,ACC00008844,ATM,1983.16,-2102148.8,EUR,Shell
TXN0000019986,2024-09-11T20:53:14,ACC00007164,ATM,1261.35,-2103410.15,EUR,Restaurant
TXN0000019987,2024-10-23T02:07:53,ACC00007412,ATM,1471.37,-2104881.52,USD,Amazon
TXN0000019988,2024-08-03T07:31:16,ACC00004342,Transfer,930.15,-2103951.37,JPY,Starbucks
TXN0000019989,2024-09-05T20:43:34,ACC00006540,Debit,1275.82,-2105227.19,JPY,Walmart
TXN0000019990,2024-12-14T15:04:14,ACC00008580,Credit,834.02,-2104393.17,EUR,Amazon
TXN0000019991,2024-05-22T21:32:31,ACC00009496,Transfer,1353.74,-2103039.43,JPY,Starbucks
TXN0000019992,2024-11-24T23:00:55,ACC00001071,Debit,1012.47,-2104051.9,GBP,Grocery
TXN0000019993,2024-12-01T05:47:13,ACC00003285,ATM,463.74,-2104515.64,GBP,Target
TXN0000019994,2024-09-13T00:26:19,ACC00002679,Credit,274.39,-2104241.25,GBP,Target
TXN0000019995,2024-05-17T15:34:35,ACC00008997,Debit,384.4,-2104625.65,JPY,Grocery
TXN0000019996,2024-11-17T21:56:20,ACC00005694,Credit,1195.2,-2103430.45,GBP,Restaurant
TXN0000019997,2024-10-01T20:06:40,ACC00005283,Transfer,713.43,-2102717.02,JPY,Target
TXN0000019998,2024-06-27T04:42:46,ACC00000176,ATM,1481.63,-2104198.65,GBP,Restaurant
TXN0000019999,2024-01-30T22:17:08,ACC00002540,Payment,1840.88,-2106039.53,EUR,Shell
TXN0000020000,2024-04-03T19:10:28,ACC00003842,Payment,357.45,-2106396.98,USD,Restaurant
TXN0000020001,2024-05-07T10:56:39,ACC00001945,Payment,1837.77,10247.78,GBP,Walmart
TXN0000020002,2024-02-29T22:42:48,ACC00001096,ATM,370.63,9877.15,JPY,Online Store
TXN0000020003,2024-04-01T06:15:08,ACC00006327,Credit,956.53,10833.68,USD,Restaurant
TXN0000020004,2024-02-09T01:59:32,ACC00009650,Transfer,374.99,11208.67,GBP,Walmart
TXN0000020005,2024-08-20T14:16:32,ACC00000251,Transfer,1060.23,12268.9,GBP,Starbucks
TXN0000020006,2024-11-15T06:44:36,ACC00009885,ATM,162.69,12106.21,GBP,Shell
TXN0000020007,2024-12-24T10:22:56,ACC00005988,ATM,1116.78,10989.43,EUR,Restaurant
TXN0000020008,2024-02-14T07:29:50,ACC00005559,Debit,329.54,10659.89,GBP,Online Store
TXN0000020009,2024-05-31T09:43:30,ACC00004109,Credit,1886.03,12545.92,JPY,Grocery
TXN0000020010,2024-04-06T13:04:13,ACC00006463,Credit,313.28,12859.2,JPY,Walmart
TXN0000020011,2024-06-01T19:49:09,ACC00006543,Credit,18.31,12877.51,GBP,Restaurant
TXN0000020012,2024-01-30T11:36:38,ACC00003111,Debit,1166.61,11710.9,USD,Shell
TXN0000020013,2024-06-26T21:47:44,ACC00004554,Debit,619.16,11091.74,JPY,Starbucks
TXN0000020014,2024-11-01T20:33:37,ACC00004400,Credit,1216.04,12307.78,JPY,Online Store
TXN0000020015,2024-12-11T17:56:01,ACC00009956,Credit,1187.12,13494.9,EUR,Grocery
TXN0000020016,2024-06-21T19:33:18,ACC00003366,Payment,934.04,12560.86,JPY,Starbucks
TXN0000020017,2024-11-08T08:10:25,ACC00009771,Transfer,1833.52,14394.38,GBP,Restaurant
TXN0000020018,2024-09-17T15:09:21,ACC00006996,Debit,1789.62,12604.76,GBP,Shell
TXN0000020019,2024-05-11T06:18:56,ACC00007204,ATM,1720.52,10884.24,USD,Shell
TXN0000020020,2024-08-08T15:53:42,ACC00006307,ATM,117.96,10766.28,JPY,Target
TXN0000020021,2024-08-24T11:32:28,ACC00009028,Debit,1910.89,8855.39,JPY,Online Store
TXN0000020022,2024-05-08T17:04:51,ACC00006597,Payment,847.81,8007.58,EUR,Walmart
TXN0000020023,2024-04-28T17:17:31,ACC00003396,Transfer,657.62,8665.2,GBP,Walmart
TXN0000020024,2024-11-18T18:57:28,ACC00009079,ATM,1514.69,7150.51,GBP,Restaurant
TXN0000020025,2024-01-03T00:00:48,ACC00009694,ATM,33.3,7117.21,GBP,Starbucks
TXN0000020026,2024-03-29T13:22:41,ACC00004055,Transfer,1951.46,9068.67,GBP,Starbucks
TXN0000020027,2024-10-10T04:00:08,ACC00006768,Credit,940.95,10009.62,EUR,Starbucks
TXN0000020028,2024-03-14T08:16:43,ACC00003947,ATM,137.88,9871.74,EUR,Amazon
TXN0000020029,2024-10-25T13:37:29,ACC00004851,Debit,1158.4,8713.34,EUR,Amazon
TXN0000020030,2024-11-15T08:49:48,ACC00004126,Payment,72.64,8640.7,USD,Restaurant
TXN0000020031,2024-06-21T03:32:20,ACC00005731,Credit,104.68,8745.38,EUR,Restaurant
TXN0000020032,2024-02-03T00:20:35,ACC00000747,Transfer,1910.38,10655.76,EUR,Target
TXN0000020033,2024-03-27T11:02:34,ACC00003649,Transfer,581.7,11237.46,JPY,Amazon
TXN0000020034,2024-06-01T17:35:47,ACC00005891,Debit,300.55,10936.91,GBP,Grocery
TXN0000020035,2024-05-08T21:46:50,ACC00005633,Payment,1365.06,9571.85,GBP,Target
TXN0000020036,2024-03-29T10:47:40,ACC00007464,ATM,1980.22,7591.63,JPY,Restaurant
TXN0000020037,2024-11-14T08:26:02,ACC00005570,Debit,1749.25,5842.38,USD,Starbucks
TXN0000020038,2024-06-18T21:19:10,ACC00008268,Credit,1827.5,7669.88,GBP,Online Store
TXN0000020039,2024-06-16T06:59:39,ACC00002485,Transfer,1922.71,9592.59,EUR,Online Store
TXN0000020040,2024-10-03T07:52:18,ACC00008394,Payment,1624.78,7967.81,GBP,Amazon
TXN0000020041,2024-08-01T01:57:41,ACC00007926,Transfer,1816.96,9784.77,JPY,Starbucks
TXN0000020042,2024-11-30T14:37:27,ACC00002176,Credit,597.42,10382.19,USD,Amazon
TXN0000020043,2024-06-02T08:01:34,ACC00005238,Credit,911.95,11294.14,USD,Target
TXN0000020044,2024-10-30T21:45:29,ACC00008190,ATM,967.99,10326.15,JPY,Restaurant
TXN0000020045,2024-03-10T10:21:45,ACC00002016,Transfer,58.14,10384.29,USD,Target
TXN0000020046,2024-04-25T12:26:11,ACC00009200,Debit,1513.2,8871.09,USD,Restaurant
TXN0000020047,2024-03-06T11:54:29,ACC00001256,Credit,1072.35,9943.44,GBP,Starbucks
TXN0000020048,2024-10-17T19:57:02,ACC00004525,Transfer,1243.56,11187.0,USD,Target
TXN0000020049,2024-09-05T06:10:36,ACC00004135,Transfer,452.31,11639.31,USD,Shell
TXN0000020050,2024-09-04T18:41:34,ACC00009234,Payment,1054.99,10584.32,JPY,Shell
TXN0000020051,2024-02-05T19:52:18,ACC00007870,Transfer,1791.86,12376.18,EUR,Restaurant
TXN0000020052,2024-04-06T22:13:01,ACC00006270,Payment,595.58,11780.6,EUR,Restaurant
TXN0000020053,2024-11-09T09:47:45,ACC00001308,Payment,1714.48,10066.12,EUR,Shell
TXN0000020054,2024-02-12T06:13:16,ACC00000646,Debit,848.69,9217.43,JPY,Target
TXN0000020055,2024-02-09T11:47:13,ACC00003621,Credit,1946.33,11163.76,GBP,Target
TXN0000020056,2024-07-30T07:39:18,ACC00008786,Debit,594.21,10569.55,EUR,Grocery
TXN0000020057,2024-12-24T18:35:44,ACC00009273,Payment,934.61,9634.94,EUR,Target
TXN0000020058,2024-04-08T21:33:57,ACC00006163,Debit,36.43,9598.51,JPY,Restaurant
TXN0000020059,2024-02-14T16:31:43,ACC00006653,Credit,818.87,10417.38,USD,Target
TXN0000020060,2024-02-20T05:30:38,ACC00009670,Debit,1261.67,9155.71,JPY,Amazon
TXN0000020061,2024-10-04T08:22:05,ACC00003164,Transfer,1507.45,10663.16,JPY,Restaurant
TXN0000020062,2024-12-03T06:28:35,ACC00001112,Transfer,49.48,10712.64,EUR,Amazon
TXN0000020063,2024-01-04T20:40:46,ACC00003221,Debit,1975.26,8737.38,USD,Shell
TXN0000020064,2024-02-05T20:45:06,ACC00002212,ATM,502.14,8235.24,USD,Starbucks
TXN0000020065,2024-11-04T01:40:56,ACC00007070,Payment,1026.23,7209.01,USD,Amazon
TXN0000020066,2024-07-08T19:33:39,ACC00001651,Credit,1745.7,8954.71,USD,Walmart
TXN0000020067,2024-02-11T20:31:59,ACC00007397,Transfer,589.72,9544.43,GBP,Grocery
TXN0000020068,2024-10-13T21:05:48,ACC00009666,Credit,1572.46,11116.89,EUR,Walmart
TXN0000020069,2024-09-06T19:24:34,ACC00006788,Transfer,976.68,12093.57,JPY,Walmart
TXN0000020070,2024-06-08T01:20:21,ACC00002949,Debit,1101.76,10991.81,JPY,Online Store
TXN0000020071,2024-09-15T21:56:49,ACC00002657,Transfer,1769.9,12761.71,GBP,Restaurant
TXN0000020072,2024-05-11T05:01:52,ACC00000995,Payment,1840.07,10921.64,JPY,Target
TXN0000020073,2024-06-21T18:13:38,ACC00009704,Credit,1037.12,11958.76,GBP,Starbucks
TXN0000020074,2024-09-14T12:20:25,ACC00003138,Debit,1560.51,10398.25,JPY,Online Store
TXN0000020075,2024-12-17T20:34:24,ACC00009378,Debit,1186.33,9211.92,JPY,Restaurant
TXN0000020076,2024-05-28T17:43:21,ACC00002077,Debit,1002.88,8209.04,JPY,Shell
TXN0000020077,2024-03-07T21:21:31,ACC00000098,Credit,1544.42,9753.46,USD,Target
TXN0000020078,2024-02-02T11:08:54,ACC00007470,Transfer,209.2,9962.66,USD,Amazon
TXN0000020079,2024-09-12T09:42:53,ACC00000738,Payment,1125.14,8837.52,EUR,Grocery
TXN0000020080,2024-02-15T06:56:57,ACC00005738,Debit,289.06,8548.46,EUR,Grocery
TXN0000020081,2024-09-24T17:13:34,ACC00003301,ATM,993.87,7554.59,GBP,Walmart
TXN0000020082,2024-12-09T15:06:23,ACC00000568,Debit,1208.92,6345.67,USD,Target
TXN0000020083,2024-06-05T17:35:37,ACC00006904,Debit,1986.03,4359.64,GBP,Grocery
TXN0000020084,2024-10-16T20:32:58,ACC00006813,Debit,232.17,4127.47,JPY,Amazon
TXN0000020085,2024-04-08T07:08:24,ACC00009768,ATM,1140.05,2987.42,GBP,Target
TXN0000020086,2024-08-13T23:30:08,ACC00009911,Credit,653.67,3641.09,USD,Restaurant
TXN0000020087,2024-05-20T00:03:54,ACC00005386,Transfer,1080.83,4721.92,JPY,Amazon
TXN0000020088,2024-08-14T21:02:01,ACC00003794,Debit,1686.53,3035.39,GBP,Restaurant
TXN0000020089,2024-05-15T15:08:38,ACC00004531,ATM,751.32,2284.07,USD,Online Store
TXN0000020090,2024-04-03T11:35:38,ACC00009089,Debit,740.32,1543.75,GBP,Online Store
TXN0000020091,2024-09-13T09:07:37,ACC00007436,Credit,731.86,2275.61,USD,Grocery
TXN0000020092,2024-10-18T19:25:04,ACC00003833,Credit,870.46,3146.07,JPY,Restaurant
TXN0000020093,2024-05-20T00:11:24,ACC00009460,Transfer,1305.87,4451.94,JPY,Restaurant
TXN0000020094,2024-08-18T16:48:46,ACC00000192,Credit,1585.14,6037.08,USD,Target
TXN0000020095,2024-10-13T09:23:07,ACC00006415,Debit,544.65,5492.43,EUR,Target
TXN0000020096,2024-05-30T21:29:08,ACC00003300,Transfer,263.09,5755.52,EUR,Target
TXN0000020097,2024-12-16T09:02:26,ACC00007296,Credit,1755.72,7511.24,USD,Walmart
TXN0000020098,2024-12-25T13:30:55,ACC00001163,Credit,1210.15,8721.39,GBP,Online Store
TXN0000020099,2024-10-23T22:29:14,ACC00002355,Credit,1714.96,10436.35,EUR,Starbucks
TXN0000020100,2024-12-28T01:26:58,ACC00006462,ATM,1938.57,8497.78,GBP,Grocery
TXN0000020101,2024-08-05T16:50:35,ACC00009724,Credit,1688.47,10186.25,GBP,Amazon
TXN0000020102,2024-03-04T17:27:19,ACC00007817,Payment,155.85,10030.4,USD,Walmart
TXN0000020103,2024-01-13T10:02:27,ACC00001502,ATM,12.12,10018.28,USD,Starbucks
TXN0000020104,2024-10-18T21:16:29,ACC00008703,Credit,518.23,10536.51,EUR,Restaurant
TXN0000020105,2024-03-23T06:16:41,ACC00009758,Debit,623.02,9913.49,JPY,Online Store
TXN0000020106,2024-12-23T14:31:02,ACC00002855,ATM,1279.83,8633.66,USD,Online Store
TXN0000020107,2024-03-25T20:30:05,ACC00009444,ATM,1788.88,6844.78,EUR,Walmart
TXN0000020108,2024-08-02T00:26:38,ACC00008934,Debit,1655.49,5189.29,USD,Shell
TXN0000020109,2024-08-12T06:51:53,ACC00004149,Credit,537.7,5726.99,EUR,Target
TXN0000020110,2024-08-31T19:08:22,ACC00003944,ATM,1455.18,4271.81,USD,Grocery
TXN0000020111,2024-03-09T04:13:36,ACC00006032,Credit,1788.44,6060.25,GBP,Walmart
TXN0000020112,2024-03-27T02:33:49,ACC00004987,Transfer,685.95,6746.2,JPY,Restaurant
TXN0000020113,2024-10-18T12:56:32,ACC00002239,Transfer,1756.89,8503.09,USD,Amazon
TXN0000020114,2024-08-21T02:00:08,ACC00009107,Transfer,802.87,9305.96,GBP,Amazon
TXN0000020115,2024-03-14T02:52:05,ACC00005998,ATM,1674.46,7631.5,EUR,Target
TXN0000020116,2024-04-04T09:19:39,ACC00005766,Credit,1974.93,9606.43,USD,Shell
TXN0000020117,2024-04-26T19:12:09,ACC00001243,Debit,119.64,9486.79,GBP,Online Store
TXN0000020118,2024-04-26T16:31:00,ACC00003524,Transfer,1168.43,10655.22,GBP,Restaurant
TXN0000020119,2024-03-18T09:09:26,ACC00006740,Transfer,1295.39,11950.61,EUR,Grocery
TXN0000020120,2024-09-08T02:02:22,ACC00008970,ATM,793.24,11157.37,GBP,Shell
TXN0000020121,2024-01-04T13:09:18,ACC00004449,Payment,192.29,10965.08,GBP,Walmart
TXN0000020122,2024-01-13T07:24:28,ACC00001085,Payment,414.18,10550.9,USD,Target
TXN0000020123,2024-11-18T04:12:45,ACC00009013,Debit,653.88,9897.02,GBP,Amazon
TXN0000020124,2024-02-27T14:05:53,ACC00003237,Credit,870.52,10767.54,EUR,Starbucks
TXN0000020125,2024-11-18T16:18:29,ACC00001855,Debit,537.53,10230.01,GBP,Starbucks
TXN0000020126,2024-01-10T10:33:27,ACC00007844,Credit,708.39,10938.4,USD,Starbucks
TXN0000020127,2024-11-01T23:49:25,ACC00000264,Credit,640.84,11579.24,JPY,Grocery
TXN0000020128,2024-01-14T08:59:42,ACC00006093,ATM,303.97,11275.27,JPY,Starbucks
TXN0000020129,2024-12-20T01:40:32,ACC00002141,ATM,1894.03,9381.24,JPY,Grocery
TXN0000020130,2024-06-19T14:11:39,ACC00007105,Credit,1091.89,10473.13,USD,Shell
TXN0000020131,2024-07-14T15:36:24,ACC00000913,Transfer,738.58,11211.71,USD,Restaurant
TXN0000020132,2024-12-14T17:37:42,ACC00005424,ATM,344.91,10866.8,JPY,Grocery
TXN0000020133,2024-11-17T02:39:19,ACC00005081,Payment,525.26,10341.54,GBP,Online Store
TXN0000020134,2024-04-12T17:19:12,ACC00001283,Transfer,1632.28,11973.82,USD,Walmart
TXN0000020135,2024-05-24T20:15:13,ACC00005050,Debit,820.54,11153.28,USD,Online Store
TXN0000020136,2024-11-27T14:04:48,ACC00004719,Debit,1997.41,9155.87,GBP,Online Store
TXN0000020137,2024-06-14T00:20:10,ACC00005629,ATM,160.23,8995.64,USD,Starbucks
TXN0000020138,2024-08-05T19:23:54,ACC00001293,ATM,877.02,8118.62,JPY,Amazon
TXN0000020139,2024-02-27T23:32:42,ACC00006252,Transfer,17.01,8135.63,JPY,Restaurant
TXN0000020140,2024-12-08T01:39:21,ACC00000053,Payment,264.46,7871.17,USD,Restaurant
TXN0000020141,2024-07-20T22:49:18,ACC00003734,Transfer,1732.22,9603.39,JPY,Online Store
TXN0000020142,2024-11-25T06:20:01,ACC00007487,Payment,1299.01,8304.38,JPY,Starbucks
TXN0000020143,2024-10-24T07:10:15,ACC00007316,Credit,916.45,9220.83,JPY,Grocery
TXN0000020144,2024-11-12T14:24:34,ACC00009932,Transfer,1529.06,10749.89,GBP,Target
TXN0000020145,2024-11-17T07:58:03,ACC00003968,Credit,187.48,10937.37,EUR,Walmart
TXN0000020146,2024-03-11T13:37:25,ACC00001235,Transfer,103.99,11041.36,USD,Starbucks
TXN0000020147,2024-11-14T17:56:01,ACC00001048,ATM,22.0,11019.36,USD,Starbucks
TXN0000020148,2024-01-05T09:11:16,ACC00009160,Debit,1549.99,9469.37,USD,Target
TXN0000020149,2024-01-27T19:10:21,ACC00006575,ATM,854.41,8614.96,EUR,Online Store
TXN0000020150,2024-08-28T14:20:38,ACC00004809,ATM,562.75,8052.21,EUR,Starbucks
TXN0000020151,2024-03-14T19:28:00,ACC00000590,Credit,1998.16,10050.37,JPY,Target
TXN0000020152,2024-12-07T09:38:08,ACC00008709,Debit,46.82,10003.55,EUR,Grocery
TXN0000020153,2024-08-19T00:48:59,ACC00003288,ATM,1128.25,8875.3,EUR,Starbucks
TXN0000020154,2024-06-29T10:31:34,ACC00003649,Debit,895.88,7979.42,EUR,Starbucks
TXN0000020155,2024-10-16T15:24:14,ACC00005752,Payment,99.31,7880.11,JPY,Shell
TXN0000020156,2024-10-02T23:51:18,ACC00006780,Credit,1471.81,9351.92,GBP,Online Store
TXN0000020157,2024-11-28T19:07:11,ACC00004017,ATM,413.57,8938.35,JPY,Walmart
TXN0000020158,2024-03-02T09:30:45,ACC00002612,ATM,41.99,8896.36,EUR,Restaurant
TXN0000020159,2024-01-08T10:57:44,ACC00007420,Payment,499.36,8397.0,GBP,Walmart
TXN0000020160,2024-06-26T05:06:39,ACC00008772,ATM,1622.86,6774.14,GBP,Walmart
TXN0000020161,2024-06-13T15:26:07,ACC00006148,Transfer,335.93,7110.07,GBP,Target
TXN0000020162,2024-12-06T01:33:29,ACC00000603,Payment,1145.95,5964.12,JPY,Amazon
TXN0000020163,2024-07-17T19:23:36,ACC00009143,Transfer,1002.28,6966.4,EUR,Online Store
TXN0000020164,2024-08-19T04:40:54,ACC00002891,Credit,1581.68,8548.08,EUR,Restaurant
TXN0000020165,2024-07-18T13:24:39,ACC00007429,Credit,338.52,8886.6,JPY,Starbucks
TXN0000020166,2024-09-20T17:33:03,ACC00005385,ATM,1406.69,7479.91,JPY,Target
TXN0000020167,2024-05-13T20:27:48,ACC00001605,Credit,1506.83,8986.74,GBP,Online Store
TXN0000020168,2024-08-21T21:50:14,ACC00003864,ATM,1693.78,7292.96,USD,Amazon
TXN0000020169,2024-11-05T01:21:10,ACC00006003,Debit,1334.06,5958.9,GBP,Restaurant
TXN0000020170,2024-02-21T14:49:24,ACC00008789,Credit,403.95,6362.85,USD,Starbucks
TXN0000020171,2024-12-05T03:31:02,ACC00006966,Transfer,1778.78,8141.63,GBP,Shell
TXN0000020172,2024-11-22T22:14:59,ACC00007934,ATM,1617.19,6524.44,EUR,Amazon
TXN0000020173,2024-02-03T00:55:32,ACC00000103,Credit,154.4,6678.84,JPY,Grocery
TXN0000020174,2024-05-02T17:57:11,ACC00002682,Payment,560.42,6118.42,GBP,Walmart
TXN0000020175,2024-02-24T12:46:41,ACC00009680,Payment,363.56,5754.86,USD,Shell
TXN0000020176,2024-08-13T07:08:26,ACC00008860,Payment,1470.78,4284.08,GBP,Online Store
TXN0000020177,2024-07-14T10:53:29,ACC00003524,Payment,786.29,3497.79,GBP,Target
TXN0000020178,2024-11-26T09:25:03,ACC00008127,ATM,166.2,3331.59,JPY,Amazon
TXN0000020179,2024-01-12T07:51:43,ACC00001286,Payment,1174.27,2157.32,JPY,Restaurant
TXN0000020180,2024-03-29T21:33:37,ACC00008427,Debit,1212.65,944.67,USD,Grocery
TXN0000020181,2024-04-07T02:46:22,ACC00007382,Transfer,1011.78,1956.45,JPY,Shell
TXN0000020182,2024-07-30T22:20:42,ACC00009843,Transfer,1747.96,3704.41,JPY,Restaurant
TXN0000020183,2024-08-31T11:31:17,ACC00009869,Debit,1201.6,2502.81,EUR,Grocery
TXN0000020184,2024-02-03T01:50:51,ACC00002673,ATM,1203.23,1299.58,JPY,Amazon
TXN0000020185,2024-05-07T21:05:15,ACC00000800,Payment,1975.1,-675.52,USD,Grocery
TXN0000020186,2024-11-18T10:36:59,ACC00008210,ATM,12.65,-688.17,EUR,Restaurant
TXN0000020187,2024-03-27T09:02:05,ACC00005176,ATM,650.13,-1338.3,GBP,Restaurant
TXN0000020188,2024-12-25T19:42:53,ACC00006545,Credit,39.59,-1298.71,USD,Starbucks
TXN0000020189,2024-08-11T18:58:23,ACC00009670,Transfer,208.2,-1090.51,EUR,Starbucks
TXN0000020190,2024-05-25T18:50:03,ACC00002430,ATM,943.75,-2034.26,USD,Grocery
TXN0000020191,2024-05-23T13:24:55,ACC00007443,Transfer,281.13,-1753.13,USD,Grocery
TXN0000020192,2024-11-22T09:08:54,ACC00001350,Debit,1310.09,-3063.22,EUR,Target
TXN0000020193,2024-07-06T06:17:08,ACC00008057,Credit,596.3,-2466.92,GBP,Starbucks
TXN0000020194,2024-01-06T04:58:51,ACC00000407,Payment,1185.61,-3652.53,EUR,Shell
TXN0000020195,2024-05-28T02:24:47,ACC00001378,Transfer,584.34,-3068.19,JPY,Online Store
TXN0000020196,2024-07-20T05:10:24,ACC00001576,Credit,241.57,-2826.62,JPY,Restaurant
TXN0000020197,2024-07-28T01:14:16,ACC00000638,Payment,1118.04,-3944.66,USD,Grocery
TXN0000020198,2024-09-21T02:32:17,ACC00004227,Debit,180.66,-4125.32,GBP,Shell
TXN0000020199,2024-05-08T20:50:50,ACC00001784,Payment,1299.33,-5424.65,EUR,Target
TXN0000020200,2024-03-28T00:43:15,ACC00001656,Payment,682.06,-6106.71,GBP,Grocery
TXN0000020201,2024-09-28T03:08:35,ACC00003509,ATM,601.08,-6707.79,EUR,Starbucks
TXN0000020202,2024-10-31T15:42:53,ACC00008328,Transfer,1884.12,-4823.67,GBP,Online Store
TXN0000020203,2024-09-11T13:20:27,ACC00002560,Debit,1132.7,-5956.37,GBP,Starbucks
TXN0000020204,2024-01-04T23:08:04,ACC00006663,Debit,798.14,-6754.51,JPY,Grocery
TXN0000020205,2024-02-04T10:29:36,ACC00001467,Payment,867.48,-7621.99,USD,Target
TXN0000020206,2024-01-06T20:31:50,ACC00003271,Transfer,1798.81,-5823.18,EUR,Grocery
TXN0000020207,2024-07-27T18:00:35,ACC00000445,Credit,1340.15,-4483.03,EUR,Starbucks
TXN0000020208,2024-01-13T10:39:21,ACC00003696,Payment,1674.98,-6158.01,USD,Grocery
TXN0000020209,2024-06-21T19:31:41,ACC00004633,Payment,742.3,-6900.31,USD,Starbucks
TXN0000020210,2024-02-02T18:50:23,ACC00004959,Transfer,859.17,-6041.14,USD,Walmart
TXN0000020211,2024-06-10T07:50:18,ACC00006872,Credit,757.23,-5283.91,USD,Shell
TXN0000020212,2024-12-08T05:07:13,ACC00009442,Credit,333.64,-4950.27,GBP,Online Store
TXN0000020213,2024-03-13T00:03:38,ACC00006433,ATM,1327.25,-6277.52,EUR,Restaurant
TXN0000020214,2024-07-05T16:36:17,ACC00001530,Transfer,865.73,-5411.79,EUR,Starbucks
TXN0000020215,2024-11-01T07:04:28,ACC00001576,ATM,1096.53,-6508.32,JPY,Walmart
TXN0000020216,2024-10-19T22:33:44,ACC00002559,Debit,1927.77,-8436.09,GBP,Target
TXN0000020217,2024-06-16T09:55:06,ACC00008950,ATM,1057.82,-9493.91,GBP,Target
TXN0000020218,2024-07-23T17:42:30,ACC00003915,Transfer,1238.83,-8255.08,GBP,Amazon
TXN0000020219,2024-07-25T01:26:08,ACC00004874,Credit,1103.88,-7151.2,JPY,Starbucks
TXN0000020220,2024-10-19T05:10:08,ACC00003256,ATM,1042.06,-8193.26,GBP,Walmart
TXN0000020221,2024-10-03T18:46:48,ACC00008144,Debit,280.97,-8474.23,USD,Walmart
TXN0000020222,2024-06-08T22:40:24,ACC00004878,Debit,874.31,-9348.54,EUR,Starbucks
TXN0000020223,2024-12-12T10:30:45,ACC00006729,Payment,1719.85,-11068.39,EUR,Amazon
TXN0000020224,2024-03-07T13:32:53,ACC00003123,Credit,1617.7,-9450.69,EUR,Restaurant
TXN0000020225,2024-09-14T19:13:58,ACC00009114,ATM,207.96,-9658.65,EUR,Target
TXN0000020226,2024-02-29T09:11:34,ACC00009550,Credit,1876.87,-7781.78,EUR,Target
TXN0000020227,2024-06-12T08:40:50,ACC00004683,Transfer,488.87,-7292.91,GBP,Restaurant
TXN0000020228,2024-04-19T13:16:02,ACC00005773,Credit,353.23,-6939.68,JPY,Grocery
TXN0000020229,2024-07-21T03:35:50,ACC00005159,Transfer,171.64,-6768.04,USD,Restaurant
TXN0000020230,2024-03-26T07:08:56,ACC00006175,Credit,702.08,-6065.96,EUR,Restaurant
TXN0000020231,2024-07-06T05:46:33,ACC00005877,ATM,292.27,-6358.23,USD,Online Store
TXN0000020232,2024-03-12T02:59:47,ACC00002239,ATM,1507.73,-7865.96,GBP,Target
TXN0000020233,2024-11-22T13:22:41,ACC00002891,Payment,839.61,-8705.57,USD,Shell
TXN0000020234,2024-07-13T08:09:05,ACC00006346,ATM,1603.46,-10309.03,GBP,Walmart
TXN0000020235,2024-12-16T20:22:14,ACC00003143,Credit,463.2,-9845.83,USD,Target
TXN0000020236,2024-08-11T05:45:14,ACC00003338,Credit,1391.29,-8454.54,GBP,Walmart
TXN0000020237,2024-06-05T13:39:44,ACC00000048,ATM,479.94,-8934.48,GBP,Starbucks
TXN0000020238,2024-09-20T06:24:05,ACC00000899,Credit,593.26,-8341.22,JPY,Shell
TXN0000020239,2024-06-30T19:41:58,ACC00006538,ATM,1386.58,-9727.8,JPY,Starbucks
TXN0000020240,2024-08-25T20:00:02,ACC00008347,ATM,1748.57,-11476.37,GBP,Walmart
TXN0000020241,2024-09-06T17:11:12,ACC00003592,Transfer,1082.92,-10393.45,JPY,Starbucks
TXN0000020242,2024-11-03T16:44:53,ACC00006778,Payment,1495.14,-11888.59,JPY,Online Store
TXN0000020243,2024-12-19T14:58:42,ACC00003463,Payment,916.46,-12805.05,USD,Walmart
TXN0000020244,2024-04-16T01:26:02,ACC00005489,Credit,1971.86,-10833.19,JPY,Restaurant
TXN0000020245,2024-10-03T19:43:18,ACC00001098,Payment,1146.95,-11980.14,EUR,Starbucks
TXN0000020246,2024-06-29T20:55:29,ACC00001347,Transfer,776.89,-11203.25,EUR,Online Store
TXN0000020247,2024-01-15T00:24:15,ACC00003889,Transfer,297.48,-10905.77,USD,Starbucks
TXN0000020248,2024-06-13T00:28:24,ACC00001776,ATM,999.0,-11904.77,JPY,Shell
TXN0000020249,2024-01-10T16:11:10,ACC00000493,Debit,855.99,-12760.76,JPY,Shell
TXN0000020250,2024-03-11T22:33:28,ACC00002229,Credit,154.92,-12605.84,USD,Grocery
TXN0000020251,2024-08-31T13:39:38,ACC00005186,ATM,393.83,-12999.67,JPY,Grocery
TXN0000020252,2024-04-05T09:43:40,ACC00009458,ATM,313.02,-13312.69,GBP,Walmart
TXN0000020253,2024-06-15T15:54:25,ACC00002962,Transfer,533.74,-12778.95,JPY,Amazon
TXN0000020254,2024-07-20T05:28:45,ACC00006300,Transfer,365.11,-12413.84,JPY,Amazon
TXN0000020255,2024-10-31T21:54:52,ACC00004439,Debit,995.47,-13409.31,GBP,Starbucks
TXN0000020256,2024-01-25T07:27:25,ACC00000764,Payment,835.55,-14244.86,JPY,Restaurant
TXN0000020257,2024-06-23T23:55:28,ACC00006118,Credit,1336.24,-12908.62,USD,Restaurant
TXN0000020258,2024-03-02T17:42:11,ACC00006940,Payment,1290.02,-14198.64,USD,Shell
TXN0000020259,2024-01-14T22:59:18,ACC00005191,Transfer,1093.06,-13105.58,JPY,Shell
TXN0000020260,2024-03-11T07:19:02,ACC00002688,ATM,453.8,-13559.38,GBP,Target
TXN0000020261,2024-06-07T10:29:08,ACC00007456,Transfer,347.49,-13211.89,EUR,Target
TXN0000020262,2024-08-18T17:33:06,ACC00000609,Transfer,248.65,-12963.24,JPY,Walmart
TXN0000020263,2024-12-06T20:56:34,ACC00000389,ATM,1004.09,-13967.33,JPY,Starbucks
TXN0000020264,2024-12-26T07:28:17,ACC00007607,ATM,470.64,-14437.97,EUR,Grocery
TXN0000020265,2024-06-19T12:54:03,ACC00009148,Debit,81.37,-14519.34,JPY,Target
TXN0000020266,2024-12-10T13:06:54,ACC00009858,Transfer,1217.63,-13301.71,USD,Starbucks
TXN0000020267,2024-12-28T08:57:51,ACC00008164,Credit,616.27,-12685.44,GBP,Restaurant
TXN0000020268,2024-11-24T08:53:09,ACC00006615,Payment,1106.08,-13791.52,GBP,Online Store
TXN0000020269,2024-10-16T08:15:32,ACC00003386,Transfer,1719.09,-12072.43,GBP,Online Store
TXN0000020270,2024-02-22T02:18:39,ACC00002832,ATM,1612.36,-13684.79,GBP,Restaurant
TXN0000020271,2024-11-29T00:14:18,ACC00009471,Payment,507.78,-14192.57,USD,Amazon
TXN0000020272,2024-10-25T01:32:11,ACC00002183,Credit,435.15,-13757.42,JPY,Target
TXN0000020273,2024-01-13T19:29:10,ACC00004853,Transfer,1232.42,-12525.0,EUR,Shell
TXN0000020274,2024-01-31T09:40:32,ACC00008660,Debit,1325.91,-13850.91,USD,Starbucks
TXN0000020275,2024-11-12T18:29:20,ACC00003399,Transfer,1804.66,-12046.25,JPY,Grocery
TXN0000020276,2024-11-17T21:20:27,ACC00007173,Transfer,1283.88,-10762.37,JPY,Shell
TXN0000020277,2024-03-08T07:21:40,ACC00006046,Payment,264.18,-11026.55,USD,Amazon
TXN0000020278,2024-03-16T18:43:31,ACC00001557,Transfer,808.53,-10218.02,USD,Shell
TXN0000020279,2024-07-25T18:24:32,ACC00006430,Credit,1907.14,-8310.88,EUR,Starbucks
TXN0000020280,2024-04-26T13:16:22,ACC00006501,Payment,816.8,-9127.68,USD,Grocery
TXN0000020281,2024-08-13T11:29:53,ACC00007980,Credit,1943.97,-7183.71,USD,Walmart
TXN0000020282,2024-11-16T23:57:20,ACC00005257,ATM,30.19,-7213.9,JPY,Online Store
TXN0000020283,2024-03-06T16:30:35,ACC00008251,Transfer,950.38,-6263.52,GBP,Starbucks
TXN0000020284,2024-02-06T16:37:54,ACC00005812,ATM,992.16,-7255.68,GBP,Walmart
TXN0000020285,2024-09-14T03:32:30,ACC00008675,Debit,1052.48,-8308.16,JPY,Grocery
TXN0000020286,2024-11-22T10:46:01,ACC00005237,ATM,1971.95,-10280.11,EUR,Amazon
TXN0000020287,2024-02-23T19:25:10,ACC00001979,Credit,1633.95,-8646.16,EUR,Online Store
TXN0000020288,2024-03-10T17:45:51,ACC00000141,Transfer,1669.68,-6976.48,USD,Starbucks
TXN0000020289,2024-08-03T09:55:05,ACC00001712,Credit,315.88,-6660.6,USD,Starbucks
TXN0000020290,2024-06-27T02:00:25,ACC00003511,Debit,1412.87,-8073.47,GBP,Walmart
TXN0000020291,2024-01-07T16:29:31,ACC00007216,Debit,64.94,-8138.41,JPY,Amazon
TXN0000020292,2024-09-28T20:54:04,ACC00000317,Debit,444.85,-8583.26,JPY,Shell
TXN0000020293,2024-11-08T10:28:35,ACC00005195,Payment,1132.19,-9715.45,JPY,Amazon
TXN0000020294,2024-12-18T19:40:51,ACC00004951,ATM,80.02,-9795.47,EUR,Starbucks
TXN0000020295,2024-02-24T08:55:28,ACC00001300,Debit,598.1,-10393.57,USD,Online Store
TXN0000020296,2024-02-11T11:26:06,ACC00000065,Transfer,1874.51,-8519.06,USD,Grocery
TXN0000020297,2024-12-25T03:52:54,ACC00000450,Transfer,842.66,-7676.4,USD,Restaurant
TXN0000020298,2024-01-21T02:42:49,ACC00003506,Payment,1778.99,-9455.39,JPY,Target
TXN0000020299,2024-01-18T18:55:44,ACC00003765,Debit,1544.1,-10999.49,GBP,Shell
TXN0000020300,2024-12-29T08:03:27,ACC00001921,Credit,32.64,-10966.85,GBP,Amazon
TXN0000020301,2024-06-22T03:14:48,ACC00007038,ATM,1009.05,-11975.9,JPY,Walmart
TXN0000020302,2024-01-08T07:32:37,ACC00001371,ATM,661.1,-12637.0,GBP,Amazon
TXN0000020303,2024-08-11T05:24:11,ACC00006395,Credit,1107.76,-11529.24,EUR,Online Store
TXN0000020304,2024-12-25T15:17:11,ACC00002261,ATM,426.99,-11956.23,USD,Grocery
TXN0000020305,2024-12-05T15:20:29,ACC00005258,ATM,367.89,-12324.12,JPY,Restaurant
TXN0000020306,2024-01-09T05:28:48,ACC00001927,ATM,947.1,-13271.22,USD,Target
TXN0000020307,2024-02-26T17:12:02,ACC00000316,ATM,320.48,-13591.7,JPY,Amazon
TXN0000020308,2024-04-07T11:35:57,ACC00004798,Credit,450.49,-13141.21,JPY,Starbucks
TXN0000020309,2024-09-29T19:27:40,ACC00001807,Payment,1494.92,-14636.13,USD,Restaurant
TXN0000020310,2024-03-18T16:19:48,ACC00004144,Transfer,1216.8,-13419.33,EUR,Amazon
TXN0000020311,2024-09-21T08:57:47,ACC00000106,Transfer,1954.33,-11465.0,JPY,Online Store
TXN0000020312,2024-05-23T11:48:09,ACC00001896,Transfer,1546.06,-9918.94,EUR,Amazon
TXN0000020313,2024-05-05T11:25:56,ACC00008603,ATM,1482.99,-11401.93,JPY,Starbucks
TXN0000020314,2024-03-06T22:57:38,ACC00003502,Debit,617.0,-12018.93,JPY,Grocery
TXN0000020315,2024-07-31T11:30:36,ACC00008333,Credit,1444.56,-10574.37,GBP,Starbucks
TXN0000020316,2024-12-30T14:41:31,ACC00006375,Payment,1701.62,-12275.99,GBP,Starbucks
TXN0000020317,2024-03-10T00:00:36,ACC00000996,Credit,1029.75,-11246.24,GBP,Starbucks
TXN0000020318,2024-06-12T00:09:00,ACC00008265,Debit,329.2,-11575.44,GBP,Restaurant
TXN0000020319,2024-02-28T12:56:30,ACC00003141,Credit,1915.59,-9659.85,EUR,Shell
TXN0000020320,2024-08-03T16:10:58,ACC00006042,ATM,1212.73,-10872.58,USD,Amazon
TXN0000020321,2024-11-07T19:51:10,ACC00008028,Credit,1563.49,-9309.09,EUR,Restaurant
TXN0000020322,2024-08-09T18:03:20,ACC00005657,Credit,639.28,-8669.81,JPY,Shell
TXN0000020323,2024-11-30T07:58:25,ACC00007507,Credit,1195.7,-7474.11,JPY,Walmart
TXN0000020324,2024-09-13T01:07:10,ACC00008193,ATM,1174.12,-8648.23,GBP,Starbucks
TXN0000020325,2024-01-06T10:18:53,ACC00005105,Debit,50.33,-8698.56,GBP,Online Store
TXN0000020326,2024-06-16T03:05:10,ACC00004894,ATM,1875.15,-10573.71,JPY,Target
TXN0000020327,2024-10-08T09:19:06,ACC00003107,Payment,1978.78,-12552.49,GBP,Target
TXN0000020328,2024-12-04T02:09:37,ACC00007265,Payment,108.71,-12661.2,USD,Shell
TXN0000020329,2024-07-11T10:14:24,ACC00006353,Transfer,685.78,-11975.42,JPY,Starbucks
TXN0000020330,2024-12-07T04:03:34,ACC00000183,ATM,1991.02,-13966.44,EUR,Restaurant
TXN0000020331,2024-08-27T12:20:42,ACC00006044,Debit,1872.11,-15838.55,EUR,Amazon
TXN0000020332,2024-03-24T07:46:04,ACC00001009,Transfer,963.96,-14874.59,GBP,Restaurant
TXN0000020333,2024-01-26T12:48:05,ACC00004147,Payment,1555.38,-16429.97,USD,Restaurant
TXN0000020334,2024-12-05T13:27:26,ACC00008982,Credit,161.11,-16268.86,USD,Target
TXN0000020335,2024-12-01T03:19:13,ACC00000824,Payment,1208.86,-17477.72,EUR,Amazon
TXN0000020336,2024-08-05T13:38:39,ACC00003783,Credit,1277.94,-16199.78,GBP,Online Store
TXN0000020337,2024-12-18T10:32:46,ACC00005124,Credit,559.9,-15639.88,USD,Online Store
TXN0000020338,2024-03-01T15:27:35,ACC00006268,Credit,1284.92,-14354.96,GBP,Target
TXN0000020339,2024-01-23T22:14:18,ACC00004375,ATM,1926.35,-16281.31,USD,Shell
TXN0000020340,2024-09-25T23:23:25,ACC00001350,ATM,1500.48,-17781.79,GBP,Restaurant
TXN0000020341,2024-08-04T01:42:54,ACC00004440,Payment,1969.26,-19751.05,EUR,Restaurant
TXN0000020342,2024-02-03T13:36:18,ACC00005328,Payment,37.44,-19788.49,USD,Shell
TXN0000020343,2024-09-24T10:42:50,ACC00002542,Debit,1597.34,-21385.83,JPY,Restaurant
TXN0000020344,2024-02-11T01:29:57,ACC00004791,Debit,82.95,-21468.78,USD,Target
TXN0000020345,2024-01-13T10:50:46,ACC00007115,Credit,398.91,-21069.87,EUR,Walmart
TXN0000020346,2024-12-18T04:37:05,ACC00006988,Transfer,222.82,-20847.05,USD,Walmart
TXN0000020347,2024-05-02T11:06:03,ACC00002621,Debit,1624.55,-22471.6,EUR,Starbucks
TXN0000020348,2024-10-21T13:50:59,ACC00007607,Credit,1006.5,-21465.1,GBP,Restaurant
TXN0000020349,2024-04-24T09:23:12,ACC00009586,ATM,760.03,-22225.13,USD,Online Store
TXN0000020350,2024-10-09T07:46:06,ACC00005616,Debit,726.44,-22951.57,GBP,Online Store
TXN0000020351,2024-11-05T11:35:01,ACC00003845,Credit,404.77,-22546.8,JPY,Restaurant
TXN0000020352,2024-08-30T08:05:51,ACC00007798,ATM,1717.26,-24264.06,JPY,Target
TXN0000020353,2024-06-19T03:54:29,ACC00004718,Credit,442.13,-23821.93,USD,Starbucks
TXN0000020354,2024-11-01T18:34:26,ACC00002658,ATM,1301.27,-25123.2,GBP,Starbucks
TXN0000020355,2024-05-27T23:17:25,ACC00002953,Payment,666.44,-25789.64,EUR,Walmart
TXN0000020356,2024-08-03T07:35:43,ACC00000139,Credit,1110.97,-24678.67,JPY,Walmart
TXN0000020357,2024-08-20T01:31:07,ACC00003158,Debit,1672.31,-26350.98,JPY,Shell
TXN0000020358,2024-04-02T03:04:44,ACC00000323,Debit,1205.35,-27556.33,JPY,Amazon
TXN0000020359,2024-01-15T11:36:10,ACC00003127,Transfer,1430.88,-26125.45,USD,Starbucks
TXN0000020360,2024-07-31T04:39:26,ACC00000503,Debit,1687.62,-27813.07,EUR,Target
TXN0000020361,2024-06-02T22:42:32,ACC00001607,Payment,507.8,-28320.87,USD,Grocery
TXN0000020362,2024-03-14T03:40:18,ACC00002050,Credit,1337.06,-26983.81,USD,Starbucks
TXN0000020363,2024-08-05T22:42:26,ACC00002241,Debit,745.04,-27728.85,GBP,Walmart
TXN0000020364,2024-02-10T09:54:51,ACC00002725,Debit,1776.6,-29505.45,GBP,Target
TXN0000020365,2024-08-23T22:43:49,ACC00006032,Payment,767.23,-30272.68,EUR,Restaurant
TXN0000020366,2024-06-14T17:00:08,ACC00007130,Credit,1399.28,-28873.4,EUR,Target
TXN0000020367,2024-04-21T13:22:15,ACC00006516,Payment,715.29,-29588.69,GBP,Grocery
TXN0000020368,2024-03-04T09:37:10,ACC00009898,Transfer,1268.35,-28320.34,EUR,Walmart
TXN0000020369,2024-08-22T20:52:22,ACC00001884,ATM,1800.49,-30120.83,JPY,Target
TXN0000020370,2024-06-07T10:32:24,ACC00009669,Transfer,197.96,-29922.87,USD,Starbucks
TXN0000020371,2024-02-12T19:34:27,ACC00008768,Payment,721.15,-30644.02,JPY,Walmart
TXN0000020372,2024-01-03T22:18:00,ACC00003652,Payment,244.01,-30888.03,GBP,Restaurant
TXN0000020373,2024-12-12T13:26:48,ACC00002852,Payment,115.46,-31003.49,USD,Online Store
TXN0000020374,2024-03-20T19:47:22,ACC00006619,ATM,260.89,-31264.38,USD,Amazon
TXN0000020375,2024-03-24T11:30:48,ACC00004260,Transfer,1372.16,-29892.22,USD,Amazon
TXN0000020376,2024-02-28T16:43:39,ACC00002748,Credit,682.27,-29209.95,USD,Walmart
TXN0000020377,2024-08-10T15:32:17,ACC00007325,ATM,613.94,-29823.89,USD,Target
TXN0000020378,2024-10-31T11:32:06,ACC00008894,Credit,214.24,-29609.65,EUR,Shell
TXN0000020379,2024-09-01T00:22:20,ACC00004360,Payment,595.33,-30204.98,GBP,Walmart
TXN0000020380,2024-11-24T06:55:49,ACC00000396,Payment,702.65,-30907.63,JPY,Walmart
TXN0000020381,2024-06-29T10:24:10,ACC00007411,ATM,60.04,-30967.67,JPY,Starbucks
TXN0000020382,2024-10-13T09:23:20,ACC00004587,ATM,1357.01,-32324.68,GBP,Grocery
TXN0000020383,2024-09-16T22:58:42,ACC00005404,Debit,1789.63,-34114.31,USD,Shell
TXN0000020384,2024-08-14T21:04:03,ACC00001379,ATM,153.86,-34268.17,EUR,Grocery
TXN0000020385,2024-07-23T12:01:36,ACC00008968,Credit,1339.31,-32928.86,JPY,Restaurant
TXN0000020386,2024-02-29T02:28:14,ACC00001157,Debit,1772.31,-34701.17,USD,Restaurant
TXN0000020387,2024-04-13T09:30:17,ACC00009923,Credit,1444.17,-33257.0,USD,Walmart
TXN0000020388,2024-06-08T02:32:57,ACC00001837,Payment,1458.9,-34715.9,JPY,Shell
TXN0000020389,2024-10-24T15:14:04,ACC00004670,Debit,1983.92,-36699.82,EUR,Amazon
TXN0000020390,2024-11-04T04:45:03,ACC00005924,ATM,1455.52,-38155.34,GBP,Online Store
TXN0000020391,2024-06-24T19:05:20,ACC00008712,Debit,1348.21,-39503.55,USD,Shell
TXN0000020392,2024-01-11T01:35:41,ACC00002109,Transfer,1423.4,-38080.15,EUR,Grocery
TXN0000020393,2024-06-17T16:53:19,ACC00007287,Payment,49.39,-38129.54,JPY,Online Store
TXN0000020394,2024-06-12T17:00:59,ACC00009490,Payment,610.6,-38740.14,EUR,Target
TXN0000020395,2024-09-11T10:45:10,ACC00003879,Transfer,461.35,-38278.79,JPY,Amazon
TXN0000020396,2024-01-24T22:48:50,ACC00009629,Payment,1072.37,-39351.16,USD,Grocery
TXN0000020397,2024-03-13T04:34:15,ACC00007117,Credit,1771.13,-37580.03,JPY,Online Store
TXN0000020398,2024-08-10T09:55:41,ACC00002089,Transfer,516.82,-37063.21,JPY,Starbucks
TXN0000020399,2024-03-12T09:56:53,ACC00003037,ATM,892.97,-37956.18,JPY,Online Store
TXN0000020400,2024-12-29T09:14:37,ACC00008992,ATM,12.26,-37968.44,USD,Target
TXN0000020401,2024-09-24T16:36:35,ACC00002699,Debit,343.11,-38311.55,EUR,Amazon
TXN0000020402,2024-08-11T03:42:36,ACC00009487,Payment,1282.04,-39593.59,EUR,Starbucks
TXN0000020403,2024-02-01T23:23:08,ACC00003688,Debit,1466.37,-41059.96,EUR,Restaurant
TXN0000020404,2024-05-20T13:39:14,ACC00000340,Payment,165.44,-41225.4,JPY,Online Store
TXN0000020405,2024-03-29T03:30:35,ACC00003192,Payment,817.86,-42043.26,JPY,Starbucks
TXN0000020406,2024-09-02T10:55:43,ACC00000677,Transfer,842.67,-41200.59,GBP,Online Store
TXN0000020407,2024-12-08T22:46:53,ACC00004607,Transfer,1048.34,-40152.25,EUR,Amazon
TXN0000020408,2024-12-11T03:39:45,ACC00002854,Transfer,1191.78,-38960.47,EUR,Walmart
TXN0000020409,2024-07-12T05:17:46,ACC00006471,Payment,569.81,-39530.28,USD,Walmart
TXN0000020410,2024-05-12T07:31:24,ACC00009407,Payment,432.96,-39963.24,GBP,Walmart
TXN0000020411,2024-12-20T21:31:02,ACC00007397,Credit,813.9,-39149.34,USD,Amazon
TXN0000020412,2024-04-07T18:03:30,ACC00005752,Payment,826.23,-39975.57,EUR,Walmart
TXN0000020413,2024-09-08T00:12:25,ACC00005772,ATM,1940.46,-41916.03,GBP,Online Store
TXN0000020414,2024-11-19T01:18:23,ACC00004184,Credit,808.57,-41107.46,GBP,Online Store
TXN0000020415,2024-12-02T00:03:17,ACC00005119,Payment,973.16,-42080.62,GBP,Online Store
TXN0000020416,2024-08-12T20:01:05,ACC00008327,ATM,829.68,-42910.3,USD,Shell
TXN0000020417,2024-04-23T09:33:12,ACC00003934,Debit,1357.08,-44267.38,EUR,Online Store
TXN0000020418,2024-03-30T01:13:32,ACC00006465,Payment,1320.42,-45587.8,JPY,Grocery
TXN0000020419,2024-08-15T18:23:09,ACC00009826,Credit,432.59,-45155.21,EUR,Amazon
TXN0000020420,2024-02-21T10:21:15,ACC00003172,Debit,1813.7,-46968.91,EUR,Grocery
TXN0000020421,2024-02-11T01:07:14,ACC00008241,Debit,1013.35,-47982.26,EUR,Restaurant
TXN0000020422,2024-06-12T23:50:59,ACC00005140,Transfer,1954.17,-46028.09,GBP,Walmart
TXN0000020423,2024-11-17T19:14:20,ACC00002703,ATM,1766.31,-47794.4,EUR,Online Store
TXN0000020424,2024-08-22T13:41:33,ACC00007964,Payment,1727.75,-49522.15,JPY,Walmart
TXN0000020425,2024-06-25T05:25:05,ACC00004143,Payment,1459.24,-50981.39,EUR,Shell
TXN0000020426,2024-05-23T10:52:46,ACC00004678,Payment,1007.72,-51989.11,GBP,Amazon
TXN0000020427,2024-03-11T14:24:35,ACC00006604,Payment,1555.3,-53544.41,GBP,Online Store
TXN0000020428,2024-04-27T16:47:33,ACC00001463,Transfer,881.42,-52662.99,JPY,Starbucks
TXN0000020429,2024-04-19T14:51:28,ACC00005155,ATM,1337.07,-54000.06,USD,Online Store
TXN0000020430,2024-01-20T21:55:50,ACC00004471,Debit,567.74,-54567.8,USD,Target
TXN0000020431,2024-03-06T01:24:44,ACC00008505,ATM,34.48,-54602.28,EUR,Starbucks
TXN0000020432,2024-06-21T04:38:38,ACC00003403,ATM,1959.12,-56561.4,USD,Target
TXN0000020433,2024-01-02T07:37:28,ACC00004977,ATM,1023.14,-57584.54,GBP,Starbucks
TXN0000020434,2024-03-23T22:58:28,ACC00005615,Debit,1147.95,-58732.49,JPY,Online Store
TXN0000020435,2024-06-08T07:38:05,ACC00003166,Transfer,1616.55,-57115.94,JPY,Restaurant
TXN0000020436,2024-10-23T22:33:25,ACC00003393,Payment,787.5,-57903.44,GBP,Restaurant
TXN0000020437,2024-01-19T09:27:58,ACC00007432,Transfer,1956.41,-55947.03,EUR,Starbucks
TXN0000020438,2024-12-06T02:08:11,ACC00004382,Payment,398.59,-56345.62,USD,Online Store
TXN0000020439,2024-07-29T13:26:57,ACC00006928,Transfer,91.77,-56253.85,EUR,Online Store
TXN0000020440,2024-12-06T13:20:59,ACC00009955,Debit,795.0,-57048.85,USD,Shell
TXN0000020441,2024-09-24T19:03:26,ACC00000951,ATM,770.54,-57819.39,USD,Walmart
TXN0000020442,2024-08-19T17:25:38,ACC00005430,Credit,1324.61,-56494.78,GBP,Target
TXN0000020443,2024-10-01T17:46:07,ACC00009435,Debit,987.73,-57482.51,EUR,Walmart
TXN0000020444,2024-07-18T12:38:51,ACC00009331,Debit,1614.56,-59097.07,EUR,Grocery
TXN0000020445,2024-07-04T10:21:16,ACC00008476,Credit,1587.43,-57509.64,JPY,Starbucks
TXN0000020446,2024-05-20T15:12:31,ACC00008258,ATM,1617.74,-59127.38,USD,Online Store
TXN0000020447,2024-09-18T06:23:45,ACC00009397,ATM,952.43,-60079.81,EUR,Walmart
TXN0000020448,2024-05-31T00:12:32,ACC00009842,Credit,1137.68,-58942.13,EUR,Shell
TXN0000020449,2024-05-21T23:43:09,ACC00006028,Credit,218.3,-58723.83,USD,Online Store
TXN0000020450,2024-01-19T01:15:15,ACC00009230,Transfer,1922.4,-56801.43,GBP,Online Store
TXN0000020451,2024-08-17T23:23:35,ACC00007635,Payment,1944.83,-58746.26,JPY,Walmart
TXN0000020452,2024-09-30T08:21:19,ACC00006643,Debit,160.79,-58907.05,JPY,Shell
TXN0000020453,2024-06-09T19:12:36,ACC00007399,Debit,1638.52,-60545.57,JPY,Online Store
TXN0000020454,2024-11-10T05:49:37,ACC00005469,Debit,1678.26,-62223.83,EUR,Shell
TXN0000020455,2024-07-12T20:48:38,ACC00001481,Payment,1153.89,-63377.72,GBP,Starbucks
TXN0000020456,2024-03-28T16:43:17,ACC00006020,ATM,1357.82,-64735.54,JPY,Walmart
TXN0000020457,2024-10-20T22:44:46,ACC00000835,ATM,1239.22,-65974.76,GBP,Restaurant
TXN0000020458,2024-11-21T17:06:53,ACC00009300,Payment,1912.06,-67886.82,EUR,Walmart
TXN0000020459,2024-08-23T15:04:10,ACC00002345,ATM,1664.93,-69551.75,USD,Shell
TXN0000020460,2024-07-28T12:02:39,ACC00009326,Credit,1728.39,-67823.36,EUR,Starbucks
TXN0000020461,2024-10-02T02:59:29,ACC00002250,Transfer,1958.08,-65865.28,GBP,Walmart
TXN0000020462,2024-10-09T07:27:45,ACC00001550,Transfer,167.78,-65697.5,USD,Starbucks
TXN0000020463,2024-04-30T01:33:39,ACC00004891,Credit,853.55,-64843.95,JPY,Restaurant
TXN0000020464,2024-12-26T16:05:10,ACC00008859,Payment,1997.44,-66841.39,EUR,Amazon
TXN0000020465,2024-04-23T06:14:01,ACC00003891,Debit,668.31,-67509.7,JPY,Amazon
TXN0000020466,2024-11-02T16:23:09,ACC00003672,Transfer,1876.38,-65633.32,JPY,Target
TXN0000020467,2024-06-15T13:02:45,ACC00000913,Payment,1710.24,-67343.56,USD,Online Store
TXN0000020468,2024-10-28T15:32:58,ACC00007135,Transfer,820.29,-66523.27,USD,Online Store
TXN0000020469,2024-06-10T13:10:53,ACC00000919,Transfer,1295.97,-65227.3,EUR,Grocery
TXN0000020470,2024-01-02T12:13:18,ACC00001183,Debit,68.78,-65296.08,GBP,Grocery
TXN0000020471,2024-04-02T07:51:49,ACC00005108,ATM,1772.75,-67068.83,JPY,Grocery
TXN0000020472,2024-08-23T07:54:43,ACC00001184,Payment,346.01,-67414.84,GBP,Shell
TXN0000020473,2024-05-01T02:39:09,ACC00006086,Debit,1148.09,-68562.93,USD,Target
TXN0000020474,2024-07-16T15:56:12,ACC00004564,Credit,1062.85,-67500.08,EUR,Grocery
TXN0000020475,2024-09-17T20:56:55,ACC00007405,Credit,1181.22,-66318.86,USD,Grocery
TXN0000020476,2024-09-08T13:31:07,ACC00009312,Debit,192.32,-66511.18,GBP,Target
TXN0000020477,2024-09-15T14:12:44,ACC00007929,Transfer,1534.55,-64976.63,JPY,Restaurant
TXN0000020478,2024-10-01T06:38:49,ACC00009162,Transfer,1916.8,-63059.83,USD,Restaurant
TXN0000020479,2024-03-14T20:43:03,ACC00002245,Credit,282.34,-62777.49,USD,Online Store
TXN0000020480,2024-10-31T05:15:27,ACC00001644,Transfer,859.84,-61917.65,GBP,Amazon
TXN0000020481,2024-09-21T12:23:01,ACC00007641,Debit,1638.59,-63556.24,GBP,Restaurant
TXN0000020482,2024-08-29T21:33:33,ACC00008984,Credit,1074.02,-62482.22,USD,Amazon
TXN0000020483,2024-08-23T05:32:11,ACC00004068,Transfer,728.16,-61754.06,EUR,Restaurant
TXN0000020484,2024-11-30T20:09:42,ACC00002954,Debit,859.39,-62613.45,USD,Starbucks
TXN0000020485,2024-10-23T12:12:08,ACC00005463,Credit,424.74,-62188.71,USD,Walmart
TXN0000020486,2024-07-04T15:11:17,ACC00009952,Credit,147.45,-62041.26,USD,Shell
TXN0000020487,2024-08-07T05:20:46,ACC00008612,Transfer,1259.54,-60781.72,JPY,Online Store
TXN0000020488,2024-05-21T06:23:06,ACC00000794,Debit,703.25,-61484.97,JPY,Online Store
TXN0000020489,2024-01-07T23:32:17,ACC00008338,Payment,387.49,-61872.46,JPY,Shell
TXN0000020490,2024-10-19T01:51:42,ACC00001123,Payment,817.58,-62690.04,GBP,Starbucks
TXN0000020491,2024-04-27T13:51:39,ACC00003316,Debit,933.55,-63623.59,USD,Walmart
TXN0000020492,2024-04-19T02:16:34,ACC00008574,Debit,1024.27,-64647.86,JPY,Walmart
TXN0000020493,2024-04-11T02:37:24,ACC00004725,Transfer,441.8,-64206.06,USD,Online Store
TXN0000020494,2024-11-02T01:07:51,ACC00007360,Debit,1724.2,-65930.26,USD,Online Store
TXN0000020495,2024-05-15T09:39:04,ACC00002363,Payment,1644.82,-67575.08,JPY,Target
TXN0000020496,2024-01-02T20:11:39,ACC00009646,Debit,313.83,-67888.91,JPY,Online Store
TXN0000020497,2024-03-25T13:34:34,ACC00008893,Transfer,885.91,-67003.0,USD,Online Store
TXN0000020498,2024-07-05T18:23:42,ACC00004285,ATM,1420.24,-68423.24,GBP,Grocery
TXN0000020499,2024-02-26T12:19:50,ACC00000024,Transfer,1076.91,-67346.33,EUR,Walmart
TXN0000020500,2024-04-20T01:27:45,ACC00002794,Credit,94.16,-67252.17,GBP,Grocery
TXN0000020501,2024-10-27T16:50:37,ACC00002305,Transfer,387.6,-66864.57,GBP,Grocery
TXN0000020502,2024-11-22T19:26:16,ACC00000953,Debit,1968.66,-68833.23,JPY,Starbucks
TXN0000020503,2024-07-02T11:39:11,ACC00002261,Debit,1725.67,-70558.9,JPY,Restaurant
TXN0000020504,2024-01-08T17:43:21,ACC00003852,Transfer,1532.59,-69026.31,GBP,Restaurant
TXN0000020505,2024-04-21T07:28:54,ACC00007230,Credit,551.33,-68474.98,GBP,Amazon
TXN0000020506,2024-12-23T02:26:45,ACC00006908,Credit,203.37,-68271.61,EUR,Starbucks
TXN0000020507,2024-03-17T18:40:50,ACC00007632,ATM,403.68,-68675.29,USD,Restaurant
TXN0000020508,2024-10-26T08:28:50,ACC00005253,Payment,1370.83,-70046.12,GBP,Target
TXN0000020509,2024-03-27T18:57:16,ACC00009588,Transfer,1504.17,-68541.95,JPY,Starbucks
TXN0000020510,2024-09-20T14:08:16,ACC00001835,Debit,873.09,-69415.04,EUR,Shell
TXN0000020511,2024-02-10T17:25:20,ACC00006938,ATM,180.61,-69595.65,GBP,Online Store
TXN0000020512,2024-04-16T10:21:43,ACC00009372,Credit,175.52,-69420.13,EUR,Walmart
TXN0000020513,2024-06-11T20:32:56,ACC00009180,Credit,1801.82,-67618.31,USD,Online Store
TXN0000020514,2024-09-22T11:26:37,ACC00005870,Debit,1847.69,-69466.0,USD,Grocery
TXN0000020515,2024-11-01T19:18:21,ACC00009873,Debit,1855.81,-71321.81,JPY,Starbucks
TXN0000020516,2024-09-11T15:10:58,ACC00006104,ATM,226.65,-71548.46,USD,Target
TXN0000020517,2024-11-16T09:16:46,ACC00005675,ATM,1627.36,-73175.82,EUR,Starbucks
TXN0000020518,2024-06-10T09:19:25,ACC00008656,Debit,362.71,-73538.53,USD,Amazon
TXN0000020519,2024-10-04T00:29:47,ACC00000696,Debit,1740.57,-75279.1,JPY,Grocery
TXN0000020520,2024-12-07T10:46:35,ACC00002979,Payment,321.94,-75601.04,JPY,Amazon
TXN0000020521,2024-05-31T21:42:20,ACC00009808,Transfer,1270.79,-74330.25,JPY,Amazon
TXN0000020522,2024-10-25T09:07:42,ACC00002834,Transfer,1505.17,-72825.08,EUR,Starbucks
TXN0000020523,2024-05-10T09:00:17,ACC00000292,Credit,1899.69,-70925.39,GBP,Grocery
TXN0000020524,2024-10-24T08:03:18,ACC00000606,Credit,481.02,-70444.37,EUR,Online Store
TXN0000020525,2024-01-16T11:14:05,ACC00004592,Payment,121.35,-70565.72,JPY,Target
TXN0000020526,2024-03-12T14:10:43,ACC00002354,Transfer,395.76,-70169.96,EUR,Walmart
TXN0000020527,2024-11-07T07:04:52,ACC00004032,Transfer,1820.98,-68348.98,USD,Grocery
TXN0000020528,2024-03-28T03:25:07,ACC00008519,ATM,843.33,-69192.31,USD,Walmart
TXN0000020529,2024-03-19T06:55:11,ACC00009990,Transfer,1796.64,-67395.67,GBP,Grocery
TXN0000020530,2024-06-05T07:37:13,ACC00005421,ATM,467.39,-67863.06,GBP,Grocery
TXN0000020531,2024-01-14T10:17:00,ACC00009712,Credit,153.99,-67709.07,GBP,Online Store
TXN0000020532,2024-03-22T07:53:09,ACC00005987,Debit,741.09,-68450.16,GBP,Starbucks
TXN0000020533,2024-02-11T07:36:35,ACC00002262,ATM,1243.79,-69693.95,EUR,Restaurant
TXN0000020534,2024-10-13T12:03:04,ACC00003945,ATM,791.38,-70485.33,JPY,Target
TXN0000020535,2024-10-27T12:46:19,ACC00000329,Debit,1374.14,-71859.47,JPY,Target
TXN0000020536,2024-10-12T07:22:45,ACC00005114,ATM,1554.93,-73414.4,JPY,Online Store
TXN0000020537,2024-11-13T10:24:50,ACC00001703,ATM,1263.38,-74677.78,GBP,Amazon
TXN0000020538,2024-11-26T12:07:37,ACC00007346,Transfer,1360.27,-73317.51,USD,Walmart
TXN0000020539,2024-11-30T04:58:07,ACC00008799,Debit,1425.81,-74743.32,JPY,Online Store
TXN0000020540,2024-02-20T11:09:23,ACC00000069,Payment,1387.02,-76130.34,EUR,Restaurant
TXN0000020541,2024-12-19T11:22:49,ACC00002244,Payment,653.62,-76783.96,JPY,Online Store
TXN0000020542,2024-02-12T14:09:29,ACC00000670,Credit,317.43,-76466.53,JPY,Walmart
TXN0000020543,2024-06-01T13:04:40,ACC00004754,Payment,1747.7,-78214.23,GBP,Target
TXN0000020544,2024-09-17T06:51:54,ACC00008681,Transfer,318.21,-77896.02,EUR,Starbucks
TXN0000020545,2024-12-13T07:00:49,ACC00009033,Credit,1623.16,-76272.86,JPY,Shell
TXN0000020546,2024-07-27T07:21:23,ACC00009230,ATM,137.84,-76410.7,USD,Amazon
TXN0000020547,2024-08-12T10:48:07,ACC00005941,Debit,69.89,-76480.59,EUR,Starbucks
TXN0000020548,2024-04-06T12:02:25,ACC00006336,Transfer,1072.27,-75408.32,JPY,Starbucks
TXN0000020549,2024-07-25T13:57:10,ACC00001201,Credit,1265.62,-74142.7,USD,Restaurant
TXN0000020550,2024-09-15T08:43:51,ACC00000237,Credit,240.83,-73901.87,GBP,Grocery
TXN0000020551,2024-02-18T02:37:06,ACC00009712,Credit,421.06,-73480.81,USD,Online Store
TXN0000020552,2024-04-10T02:58:26,ACC00008817,Debit,229.13,-73709.94,USD,Target
TXN0000020553,2024-02-29T23:38:45,ACC00005560,Transfer,1391.92,-72318.02,JPY,Grocery
TXN0000020554,2024-02-02T20:09:29,ACC00003066,ATM,1048.54,-73366.56,JPY,Shell
TXN0000020555,2024-07-12T21:36:17,ACC00005803,ATM,1084.65,-74451.21,USD,Starbucks
TXN0000020556,2024-04-12T06:33:59,ACC00007950,Credit,1434.03,-73017.18,EUR,Restaurant
TXN0000020557,2024-12-22T13:09:45,ACC00008973,Credit,295.63,-72721.55,GBP,Target
TXN0000020558,2024-07-26T23:20:32,ACC00004830,ATM,401.05,-73122.6,USD,Online Store
TXN0000020559,2024-01-23T10:18:31,ACC00009408,ATM,1676.6,-74799.2,JPY,Online Store
TXN0000020560,2024-02-22T09:49:45,ACC00002329,Debit,73.8,-74873.0,JPY,Starbucks
TXN0000020561,2024-08-25T00:31:30,ACC00006149,Payment,753.25,-75626.25,GBP,Starbucks
TXN0000020562,2024-02-16T10:58:36,ACC00001006,Debit,1297.84,-76924.09,GBP,Shell
TXN0000020563,2024-07-27T08:10:04,ACC00006803,Debit,1459.82,-78383.91,JPY,Grocery
TXN0000020564,2024-10-31T02:27:19,ACC00003872,Transfer,649.73,-77734.18,USD,Amazon
TXN0000020565,2024-10-21T04:11:55,ACC00007630,Debit,212.74,-77946.92,EUR,Shell
TXN0000020566,2024-11-17T10:15:19,ACC00001118,Payment,1666.24,-79613.16,USD,Target
TXN0000020567,2024-02-22T00:35:01,ACC00003142,Credit,1449.34,-78163.82,JPY,Walmart
TXN0000020568,2024-06-20T09:03:17,ACC00002809,Transfer,1970.59,-76193.23,JPY,Amazon
TXN0000020569,2024-03-12T10:57:07,ACC00000860,Credit,1084.46,-75108.77,GBP,Grocery
TXN0000020570,2024-11-13T08:11:58,ACC00005609,Transfer,1240.15,-73868.62,USD,Walmart
TXN0000020571,2024-03-18T13:02:49,ACC00005168,Payment,1728.19,-75596.81,GBP,Walmart
TXN0000020572,2024-12-07T00:41:53,ACC00000491,Payment,1571.73,-77168.54,EUR,Shell
TXN0000020573,2024-09-25T10:27:45,ACC00002363,Credit,371.93,-76796.61,EUR,Amazon
TXN0000020574,2024-05-04T17:23:56,ACC00004829,Transfer,1413.25,-75383.36,EUR,Grocery
TXN0000020575,2024-07-31T19:54:37,ACC00004537,Transfer,360.14,-75023.22,GBP,Target
TXN0000020576,2024-04-24T00:20:55,ACC00006493,Debit,1832.79,-76856.01,GBP,Walmart
TXN0000020577,2024-04-02T21:33:44,ACC00009683,Transfer,52.92,-76803.09,GBP,Target
TXN0000020578,2024-08-06T16:04:29,ACC00008211,ATM,187.25,-76990.34,GBP,Grocery
TXN0000020579,2024-07-27T16:32:15,ACC00008758,Credit,1751.9,-75238.44,USD,Walmart
TXN0000020580,2024-10-05T17:11:30,ACC00005954,Transfer,735.85,-74502.59,USD,Amazon
TXN0000020581,2024-01-17T21:14:40,ACC00004743,Transfer,1238.52,-73264.07,JPY,Shell
TXN0000020582,2024-04-26T09:16:01,ACC00005748,Credit,1081.53,-72182.54,EUR,Online Store
TXN0000020583,2024-08-10T06:01:08,ACC00006475,Payment,585.73,-72768.27,USD,Shell
TXN0000020584,2024-07-09T10:43:17,ACC00000359,Payment,448.36,-73216.63,JPY,Online Store
TXN0000020585,2024-06-08T21:58:28,ACC00001765,Transfer,1532.49,-71684.14,GBP,Online Store
TXN0000020586,2024-11-07T11:06:15,ACC00007816,Credit,848.93,-70835.21,USD,Grocery
TXN0000020587,2024-02-08T08:52:36,ACC00008219,ATM,1825.92,-72661.13,EUR,Restaurant
TXN0000020588,2024-06-09T05:26:58,ACC00009230,ATM,1024.11,-73685.24,GBP,Grocery
TXN0000020589,2024-09-26T14:14:41,ACC00006388,Payment,624.3,-74309.54,GBP,Walmart
TXN0000020590,2024-09-18T18:08:40,ACC00004002,Payment,308.1,-74617.64,EUR,Restaurant
TXN0000020591,2024-10-07T23:37:49,ACC00000657,Payment,1060.64,-75678.28,USD,Walmart
TXN0000020592,2024-01-15T02:03:15,ACC00008266,Payment,438.06,-76116.34,EUR,Shell
TXN0000020593,2024-10-05T21:40:02,ACC00007167,Payment,1065.55,-77181.89,EUR,Walmart
TXN0000020594,2024-11-12T03:14:23,ACC00007606,Payment,265.99,-77447.88,GBP,Amazon
TXN0000020595,2024-02-03T02:32:49,ACC00002169,Transfer,1934.71,-75513.17,USD,Shell
TXN0000020596,2024-07-26T19:04:23,ACC00000358,Debit,680.2,-76193.37,EUR,Grocery
TXN0000020597,2024-01-02T07:44:37,ACC00000767,Payment,1184.02,-77377.39,EUR,Starbucks
TXN0000020598,2024-04-02T02:35:11,ACC00004405,Payment,1201.65,-78579.04,JPY,Restaurant
TXN0000020599,2024-09-02T04:25:54,ACC00005870,Payment,1805.54,-80384.58,USD,Online Store
TXN0000020600,2024-09-19T16:10:01,ACC00005056,Transfer,431.66,-79952.92,EUR,Shell
TXN0000020601,2024-08-11T07:09:46,ACC00006575,Payment,325.88,-80278.8,USD,Shell
TXN0000020602,2024-07-31T20:42:25,ACC00009707,Credit,1759.64,-78519.16,USD,Starbucks
TXN0000020603,2024-07-12T05:30:46,ACC00004885,Credit,207.13,-78312.03,USD,Target
TXN0000020604,2024-01-22T00:10:21,ACC00006920,Debit,1157.36,-79469.39,EUR,Grocery
TXN0000020605,2024-05-18T21:36:14,ACC00001511,Transfer,583.45,-78885.94,USD,Shell
TXN0000020606,2024-02-21T09:59:33,ACC00005458,Transfer,1853.98,-77031.96,JPY,Restaurant
TXN0000020607,2024-02-09T14:38:25,ACC00005364,Payment,1649.76,-78681.72,JPY,Target
TXN0000020608,2024-06-02T11:12:04,ACC00009693,Payment,270.6,-78952.32,GBP,Shell
TXN0000020609,2024-10-19T18:23:04,ACC00000513,ATM,901.01,-79853.33,JPY,Amazon
TXN0000020610,2024-11-04T11:26:20,ACC00005617,Transfer,124.37,-79728.96,JPY,Walmart
TXN0000020611,2024-12-25T07:24:20,ACC00004251,Transfer,273.73,-79455.23,JPY,Online Store
TXN0000020612,2024-10-27T10:10:23,ACC00007270,Credit,1519.71,-77935.52,USD,Grocery
TXN0000020613,2024-07-26T10:13:48,ACC00006326,Payment,1239.35,-79174.87,GBP,Amazon
TXN0000020614,2024-12-21T05:24:02,ACC00007298,Debit,1612.33,-80787.2,USD,Target
TXN0000020615,2024-01-07T01:42:11,ACC00003307,Transfer,1986.43,-78800.77,EUR,Target
TXN0000020616,2024-03-31T12:33:57,ACC00006455,Payment,916.47,-79717.24,GBP,Amazon
TXN0000020617,2024-06-24T00:08:25,ACC00005091,Transfer,1380.97,-78336.27,USD,Amazon
TXN0000020618,2024-10-31T06:07:19,ACC00000995,ATM,522.97,-78859.24,EUR,Online Store
TXN0000020619,2024-10-25T09:29:00,ACC00000814,Payment,1531.5,-80390.74,JPY,Restaurant
TXN0000020620,2024-12-08T20:01:29,ACC00009441,Credit,440.54,-79950.2,USD,Target
TXN0000020621,2024-03-29T15:03:15,ACC00002597,Debit,1593.75,-81543.95,JPY,Grocery
TXN0000020622,2024-07-19T19:11:21,ACC00005354,Debit,361.51,-81905.46,GBP,Walmart
TXN0000020623,2024-10-26T00:25:45,ACC00001146,Transfer,1192.33,-80713.13,EUR,Grocery
TXN0000020624,2024-04-08T14:44:23,ACC00002364,Debit,1238.82,-81951.95,JPY,Starbucks
TXN0000020625,2024-10-02T08:50:20,ACC00008832,ATM,47.1,-81999.05,EUR,Grocery
TXN0000020626,2024-02-12T04:21:38,ACC00000537,Debit,188.01,-82187.06,USD,Restaurant
TXN0000020627,2024-11-13T09:59:40,ACC00004161,ATM,538.37,-82725.43,EUR,Online Store
TXN0000020628,2024-04-02T18:20:29,ACC00007229,Payment,1365.46,-84090.89,GBP,Starbucks
TXN0000020629,2024-06-12T14:25:09,ACC00002651,Credit,109.48,-83981.41,JPY,Grocery
TXN0000020630,2024-11-21T02:17:39,ACC00006018,Payment,1133.89,-85115.3,JPY,Restaurant
TXN0000020631,2024-10-28T12:29:54,ACC00000345,Transfer,1786.06,-83329.24,GBP,Online Store
TXN0000020632,2024-08-30T10:58:01,ACC00008740,Credit,1027.34,-82301.9,EUR,Online Store
TXN0000020633,2024-05-20T22:27:36,ACC00008689,Credit,985.12,-81316.78,EUR,Target
TXN0000020634,2024-05-01T07:05:08,ACC00002103,Transfer,1323.03,-79993.75,JPY,Target
TXN0000020635,2024-07-11T17:54:04,ACC00001313,Credit,599.82,-79393.93,JPY,Grocery
TXN0000020636,2024-01-03T06:50:25,ACC00008960,Credit,1653.14,-77740.79,GBP,Amazon
TXN0000020637,2024-12-20T13:09:36,ACC00005293,Payment,1131.15,-78871.94,JPY,Walmart
TXN0000020638,2024-09-16T19:08:19,ACC00002536,Payment,950.63,-79822.57,GBP,Starbucks
TXN0000020639,2024-11-13T03:49:50,ACC00003169,Transfer,1627.62,-78194.95,EUR,Online Store
TXN0000020640,2024-07-12T03:48:24,ACC00001562,ATM,1295.61,-79490.56,EUR,Shell
TXN0000020641,2024-06-06T16:10:09,ACC00000517,ATM,247.43,-79737.99,USD,Walmart
TXN0000020642,2024-08-30T02:27:42,ACC00007999,Payment,736.58,-80474.57,GBP,Shell
TXN0000020643,2024-05-24T10:11:01,ACC00005343,Payment,26.77,-80501.34,USD,Amazon
TXN0000020644,2024-12-07T19:54:38,ACC00002263,Credit,710.49,-79790.85,JPY,Amazon
TXN0000020645,2024-01-13T14:30:04,ACC00007077,Transfer,706.99,-79083.86,GBP,Starbucks
TXN0000020646,2024-10-08T09:52:43,ACC00004935,ATM,617.7,-79701.56,USD,Online Store
TXN0000020647,2024-08-15T09:12:41,ACC00008173,Credit,1968.54,-77733.02,USD,Target
TXN0000020648,2024-02-28T17:40:01,ACC00004266,Transfer,1483.75,-76249.27,EUR,Restaurant
TXN0000020649,2024-09-05T10:31:40,ACC00008571,ATM,1937.85,-78187.12,EUR,Restaurant
TXN0000020650,2024-06-07T12:22:35,ACC00001102,Debit,1917.04,-80104.16,JPY,Shell
TXN0000020651,2024-07-20T15:03:34,ACC00001098,Payment,984.12,-81088.28,EUR,Online Store
TXN0000020652,2024-09-27T08:55:35,ACC00001219,Debit,1849.94,-82938.22,JPY,Starbucks
TXN0000020653,2024-01-05T17:02:21,ACC00000675,Payment,211.88,-83150.1,GBP,Walmart
TXN0000020654,2024-04-06T14:15:50,ACC00008641,Transfer,1310.63,-81839.47,EUR,Amazon
TXN0000020655,2024-03-18T21:04:44,ACC00004789,Debit,1965.61,-83805.08,GBP,Grocery
TXN0000020656,2024-05-11T21:58:47,ACC00004706,Payment,1209.56,-85014.64,JPY,Target
TXN0000020657,2024-01-28T08:42:13,ACC00003774,Credit,1767.45,-83247.19,GBP,Amazon
TXN0000020658,2024-05-24T05:36:16,ACC00000883,ATM,579.8,-83826.99,JPY,Online Store
TXN0000020659,2024-03-18T21:38:54,ACC00005701,Payment,1555.88,-85382.87,JPY,Restaurant
TXN0000020660,2024-07-29T12:18:56,ACC00003269,Payment,880.49,-86263.36,GBP,Grocery
TXN0000020661,2024-05-23T17:19:50,ACC00009119,Credit,248.98,-86014.38,EUR,Walmart
TXN0000020662,2024-06-29T22:56:50,ACC00007417,Transfer,1994.73,-84019.65,JPY,Shell
TXN0000020663,2024-05-19T02:33:29,ACC00004755,ATM,540.97,-84560.62,USD,Amazon
TXN0000020664,2024-05-11T08:08:58,ACC00004652,Transfer,1383.54,-83177.08,EUR,Amazon
TXN0000020665,2024-08-10T13:10:55,ACC00003636,Credit,1589.86,-81587.22,USD,Shell
TXN0000020666,2024-08-22T09:55:54,ACC00001171,Credit,1379.16,-80208.06,EUR,Amazon
TXN0000020667,2024-03-05T15:41:00,ACC00006281,Credit,1671.88,-78536.18,JPY,Walmart
TXN0000020668,2024-08-18T00:55:51,ACC00008163,Debit,532.07,-79068.25,EUR,Online Store
TXN0000020669,2024-11-02T06:52:45,ACC00006174,Credit,467.08,-78601.17,EUR,Target
TXN0000020670,2024-09-27T07:07:06,ACC00000497,ATM,1034.93,-79636.1,GBP,Amazon
TXN0000020671,2024-07-29T01:28:03,ACC00009832,Debit,1450.73,-81086.83,JPY,Target
TXN0000020672,2024-05-02T01:08:51,ACC00005599,Transfer,175.43,-80911.4,EUR,Online Store
TXN0000020673,2024-09-04T11:25:34,ACC00008328,ATM,701.67,-81613.07,GBP,Grocery
TXN0000020674,2024-06-30T07:43:23,ACC00007094,ATM,1738.62,-83351.69,EUR,Online Store
TXN0000020675,2024-10-27T01:06:59,ACC00005442,Payment,1393.11,-84744.8,JPY,Target
TXN0000020676,2024-03-01T00:11:51,ACC00002179,ATM,1100.16,-85844.96,USD,Restaurant
TXN0000020677,2024-04-19T20:56:21,ACC00004299,Transfer,1637.65,-84207.31,JPY,Restaurant
TXN0000020678,2024-05-08T23:23:53,ACC00002100,Credit,1064.51,-83142.8,EUR,Online Store
TXN0000020679,2024-06-15T01:33:09,ACC00003890,Debit,1708.03,-84850.83,USD,Starbucks
TXN0000020680,2024-08-29T06:46:04,ACC00001149,Debit,1896.73,-86747.56,EUR,Restaurant
TXN0000020681,2024-10-23T09:46:07,ACC00009803,ATM,1473.33,-88220.89,EUR,Restaurant
TXN0000020682,2024-07-22T14:38:01,ACC00003429,Payment,751.02,-88971.91,USD,Grocery
TXN0000020683,2024-12-26T05:02:49,ACC00006896,Payment,433.82,-89405.73,EUR,Target
TXN0000020684,2024-11-12T05:31:35,ACC00005362,Credit,1392.77,-88012.96,EUR,Amazon
TXN0000020685,2024-02-20T06:56:49,ACC00009930,Debit,1781.63,-89794.59,GBP,Online Store
TXN0000020686,2024-11-02T20:38:48,ACC00006434,Payment,1023.21,-90817.8,EUR,Amazon
TXN0000020687,2024-04-13T10:29:47,ACC00004828,Credit,1535.63,-89282.17,USD,Amazon
TXN0000020688,2024-01-17T07:05:30,ACC00003575,Debit,1422.01,-90704.18,GBP,Online Store
TXN0000020689,2024-07-21T16:59:16,ACC00005543,Debit,1942.64,-92646.82,JPY,Walmart
TXN0000020690,2024-05-12T07:03:53,ACC00003037,Debit,470.03,-93116.85,EUR,Online Store
TXN0000020691,2024-02-09T01:05:24,ACC00002354,Debit,938.53,-94055.38,GBP,Grocery
TXN0000020692,2024-05-12T13:52:43,ACC00001653,Credit,1132.92,-92922.46,GBP,Amazon
TXN0000020693,2024-05-08T04:11:52,ACC00008994,Credit,1195.43,-91727.03,JPY,Shell
TXN0000020694,2024-03-24T10:38:18,ACC00008481,Transfer,1336.36,-90390.67,JPY,Amazon
TXN0000020695,2024-12-07T08:24:03,ACC00006729,Payment,1954.63,-92345.3,EUR,Grocery
TXN0000020696,2024-12-02T23:23:53,ACC00009233,Credit,192.71,-92152.59,USD,Restaurant
TXN0000020697,2024-08-25T03:25:48,ACC00001221,Debit,1380.74,-93533.33,GBP,Starbucks
TXN0000020698,2024-12-26T02:49:38,ACC00000512,Transfer,89.01,-93444.32,EUR,Target
TXN0000020699,2024-02-27T10:53:22,ACC00001651,Debit,96.5,-93540.82,EUR,Shell
TXN0000020700,2024-09-02T18:40:34,ACC00000917,ATM,902.9,-94443.72,USD,Amazon
TXN0000020701,2024-04-14T04:39:47,ACC00006942,Debit,701.69,-95145.41,JPY,Grocery
TXN0000020702,2024-04-28T18:50:05,ACC00005829,Debit,1634.29,-96779.7,EUR,Online Store
TXN0000020703,2024-07-21T23:05:20,ACC00002248,Debit,1265.95,-98045.65,USD,Target
TXN0000020704,2024-05-10T05:24:36,ACC00004506,ATM,678.25,-98723.9,USD,Target
TXN0000020705,2024-09-14T04:22:15,ACC00005548,ATM,963.26,-99687.16,JPY,Grocery
TXN0000020706,2024-06-08T03:11:40,ACC00001568,ATM,681.66,-100368.82,EUR,Walmart
TXN0000020707,2024-10-29T12:36:48,ACC00004363,ATM,882.28,-101251.1,EUR,Shell
TXN0000020708,2024-06-16T01:18:45,ACC00005679,ATM,858.34,-102109.44,EUR,Grocery
TXN0000020709,2024-02-04T15:39:31,ACC00000187,Transfer,960.79,-101148.65,EUR,Target
TXN0000020710,2024-02-05T18:26:24,ACC00000175,Transfer,770.69,-100377.96,GBP,Shell
TXN0000020711,2024-07-06T22:51:02,ACC00007862,Payment,1087.76,-101465.72,JPY,Walmart
TXN0000020712,2024-08-23T16:23:32,ACC00007579,Credit,884.41,-100581.31,USD,Amazon
TXN0000020713,2024-01-10T12:41:05,ACC00003614,Credit,1023.39,-99557.92,EUR,Amazon
TXN0000020714,2024-08-24T03:42:00,ACC00002204,ATM,530.24,-100088.16,JPY,Target
TXN0000020715,2024-09-08T09:01:02,ACC00004204,ATM,463.27,-100551.43,GBP,Walmart
TXN0000020716,2024-03-03T08:13:56,ACC00001249,Transfer,212.56,-100338.87,EUR,Online Store
TXN0000020717,2024-01-18T22:12:25,ACC00007802,Credit,460.94,-99877.93,USD,Walmart
TXN0000020718,2024-06-17T07:43:34,ACC00004310,Credit,1357.96,-98519.97,USD,Grocery
TXN0000020719,2024-06-17T16:49:57,ACC00005944,Credit,1881.79,-96638.18,GBP,Grocery
TXN0000020720,2024-06-05T10:59:23,ACC00003200,ATM,1966.85,-98605.03,EUR,Online Store
TXN0000020721,2024-08-21T02:23:06,ACC00003165,Payment,1721.98,-100327.01,JPY,Restaurant
TXN0000020722,2024-07-20T15:16:39,ACC00007559,Payment,50.87,-100377.88,JPY,Online Store
TXN0000020723,2024-12-07T01:01:08,ACC00000981,Debit,1505.85,-101883.73,GBP,Starbucks
TXN0000020724,2024-09-22T07:56:25,ACC00006671,Credit,1585.23,-100298.5,GBP,Walmart
TXN0000020725,2024-05-03T14:49:58,ACC00002417,Debit,947.5,-101246.0,GBP,Restaurant
TXN0000020726,2024-03-22T11:10:26,ACC00006254,Credit,662.39,-100583.61,USD,Shell
TXN0000020727,2024-04-02T02:39:56,ACC00007045,Debit,47.86,-100631.47,JPY,Grocery
TXN0000020728,2024-01-14T09:53:11,ACC00000079,ATM,1787.87,-102419.34,JPY,Starbucks
TXN0000020729,2024-05-27T18:24:21,ACC00000451,ATM,333.24,-102752.58,GBP,Shell
TXN0000020730,2024-06-05T21:06:17,ACC00008566,Credit,1968.92,-100783.66,EUR,Grocery
TXN0000020731,2024-10-04T02:18:46,ACC00009293,Credit,1017.34,-99766.32,EUR,Target
TXN0000020732,2024-09-10T09:15:58,ACC00003400,Payment,23.33,-99789.65,USD,Walmart
TXN0000020733,2024-10-08T06:54:45,ACC00003650,Credit,1097.06,-98692.59,GBP,Amazon
TXN0000020734,2024-07-20T05:29:34,ACC00001313,Credit,1808.1,-96884.49,EUR,Shell
TXN0000020735,2024-05-28T13:58:03,ACC00008121,Transfer,1938.1,-94946.39,USD,Online Store
TXN0000020736,2024-02-24T20:02:25,ACC00002314,Payment,587.65,-95534.04,GBP,Shell
TXN0000020737,2024-09-22T21:53:37,ACC00003207,Debit,1657.98,-97192.02,EUR,Online Store
TXN0000020738,2024-04-26T15:58:10,ACC00000013,Transfer,532.49,-96659.53,USD,Online Store
TXN0000020739,2024-11-07T10:44:18,ACC00007045,Transfer,1244.37,-95415.16,EUR,Starbucks
TXN0000020740,2024-10-22T22:23:16,ACC00005019,ATM,1490.76,-96905.92,JPY,Starbucks
TXN0000020741,2024-12-28T16:49:41,ACC00008293,Transfer,1489.54,-95416.38,EUR,Walmart
TXN0000020742,2024-08-31T07:51:03,ACC00008799,ATM,1951.36,-97367.74,GBP,Amazon
TXN0000020743,2024-10-30T22:15:26,ACC00003457,Transfer,871.9,-96495.84,JPY,Restaurant
TXN0000020744,2024-06-30T13:20:37,ACC00002439,Credit,46.64,-96449.2,USD,Walmart
TXN0000020745,2024-04-16T02:08:41,ACC00005129,Payment,1014.09,-97463.29,USD,Restaurant
TXN0000020746,2024-03-20T01:28:52,ACC00006280,Debit,489.75,-97953.04,GBP,Target
TXN0000020747,2024-06-28T18:10:07,ACC00008037,ATM,1065.63,-99018.67,USD,Shell
TXN0000020748,2024-11-06T18:14:19,ACC00009281,Transfer,429.33,-98589.34,GBP,Grocery
TXN0000020749,2024-10-09T11:00:46,ACC00000693,Debit,1767.62,-100356.96,GBP,Starbucks
TXN0000020750,2024-02-11T12:55:08,ACC00004582,Debit,1270.99,-101627.95,JPY,Online Store
TXN0000020751,2024-05-08T18:27:15,ACC00006881,Transfer,482.43,-101145.52,EUR,Target
TXN0000020752,2024-10-16T22:15:15,ACC00004885,Transfer,1922.52,-99223.0,USD,Walmart
TXN0000020753,2024-10-22T23:21:07,ACC00001571,Transfer,163.52,-99059.48,JPY,Shell
TXN0000020754,2024-03-22T05:06:19,ACC00005990,Credit,662.25,-98397.23,JPY,Walmart
TXN0000020755,2024-12-15T09:00:32,ACC00002751,Payment,755.86,-99153.09,USD,Starbucks
TXN0000020756,2024-07-21T02:17:45,ACC00006239,Debit,1340.85,-100493.94,GBP,Online Store
TXN0000020757,2024-08-27T03:10:26,ACC00009386,Payment,1140.55,-101634.49,USD,Starbucks
TXN0000020758,2024-08-08T10:35:42,ACC00007709,Debit,1490.66,-103125.15,EUR,Starbucks
TXN0000020759,2024-01-19T15:49:33,ACC00005206,Debit,1596.26,-104721.41,GBP,Online Store
TXN0000020760,2024-04-28T13:57:27,ACC00007952,Debit,1834.8,-106556.21,JPY,Amazon
TXN0000020761,2024-01-21T03:15:22,ACC00000868,ATM,523.54,-107079.75,JPY,Starbucks
TXN0000020762,2024-01-19T10:47:20,ACC00002722,Debit,1239.54,-108319.29,JPY,Restaurant
TXN0000020763,2024-11-03T05:03:51,ACC00007463,ATM,1570.74,-109890.03,USD,Amazon
TXN0000020764,2024-05-28T15:36:12,ACC00000934,Debit,504.82,-110394.85,GBP,Starbucks
TXN0000020765,2024-05-28T14:29:28,ACC00003204,Credit,784.5,-109610.35,GBP,Online Store
TXN0000020766,2024-03-09T21:56:14,ACC00000489,Payment,1368.95,-110979.3,EUR,Starbucks
TXN0000020767,2024-10-08T00:44:52,ACC00003347,Transfer,221.59,-110757.71,USD,Shell
TXN0000020768,2024-01-11T01:30:34,ACC00003739,ATM,1548.62,-112306.33,JPY,Grocery
TXN0000020769,2024-12-01T19:29:33,ACC00007470,Credit,1018.24,-111288.09,EUR,Online Store
TXN0000020770,2024-02-19T07:38:25,ACC00009034,ATM,574.8,-111862.89,USD,Amazon
TXN0000020771,2024-08-09T23:49:27,ACC00004214,Payment,1471.24,-113334.13,GBP,Amazon
TXN0000020772,2024-12-19T03:41:55,ACC00006382,ATM,798.47,-114132.6,JPY,Grocery
TXN0000020773,2024-05-22T17:08:32,ACC00005781,Payment,1145.17,-115277.77,EUR,Walmart
TXN0000020774,2024-06-15T10:03:57,ACC00001194,Transfer,174.32,-115103.45,GBP,Shell
TXN0000020775,2024-02-21T07:47:14,ACC00003802,Payment,1948.83,-117052.28,USD,Grocery
TXN0000020776,2024-09-25T05:57:44,ACC00009016,Payment,1973.15,-119025.43,USD,Online Store
TXN0000020777,2024-09-12T14:26:59,ACC00008207,Transfer,272.92,-118752.51,USD,Amazon
TXN0000020778,2024-09-01T21:11:33,ACC00001337,Debit,1873.51,-120626.02,GBP,Walmart
TXN0000020779,2024-01-02T09:42:40,ACC00009427,Debit,901.43,-121527.45,GBP,Walmart
TXN0000020780,2024-05-10T06:48:51,ACC00004109,Debit,738.72,-122266.17,JPY,Grocery
TXN0000020781,2024-09-01T15:41:17,ACC00009356,Transfer,1370.57,-120895.6,GBP,Walmart
TXN0000020782,2024-09-10T03:38:58,ACC00002945,Debit,93.09,-120988.69,JPY,Starbucks
TXN0000020783,2024-10-30T15:59:29,ACC00007648,Transfer,1092.28,-119896.41,USD,Walmart
TXN0000020784,2024-09-26T16:34:21,ACC00008564,Debit,116.83,-120013.24,EUR,Grocery
TXN0000020785,2024-09-03T04:43:18,ACC00007439,Credit,535.37,-119477.87,GBP,Walmart
TXN0000020786,2024-11-04T04:00:11,ACC00002287,Transfer,1312.31,-118165.56,JPY,Restaurant
TXN0000020787,2024-04-01T17:05:11,ACC00001768,Credit,267.11,-117898.45,GBP,Grocery
TXN0000020788,2024-06-11T17:38:16,ACC00001400,Credit,1351.43,-116547.02,USD,Amazon
TXN0000020789,2024-11-28T22:49:56,ACC00002199,Payment,56.4,-116603.42,USD,Target
TXN0000020790,2024-02-04T13:33:06,ACC00002456,Payment,263.16,-116866.58,EUR,Shell
TXN0000020791,2024-06-23T06:44:53,ACC00004245,Transfer,384.84,-116481.74,USD,Restaurant
TXN0000020792,2024-09-28T00:23:53,ACC00006506,Debit,1550.77,-118032.51,USD,Grocery
TXN0000020793,2024-03-05T11:02:10,ACC00005842,ATM,1178.1,-119210.61,USD,Restaurant
TXN0000020794,2024-01-31T02:57:42,ACC00000563,Debit,1862.18,-121072.79,JPY,Grocery
TXN0000020795,2024-05-12T09:12:17,ACC00000522,Debit,703.8,-121776.59,GBP,Starbucks
TXN0000020796,2024-01-17T16:33:35,ACC00007693,ATM,185.31,-121961.9,GBP,Restaurant
TXN0000020797,2024-09-04T08:41:00,ACC00004081,Credit,1565.11,-120396.79,JPY,Restaurant
TXN0000020798,2024-08-24T04:54:16,ACC00005283,Transfer,1140.03,-119256.76,JPY,Walmart
TXN0000020799,2024-07-05T03:05:57,ACC00002003,Debit,665.51,-119922.27,JPY,Restaurant
TXN0000020800,2024-05-29T11:26:07,ACC00004574,Payment,1452.94,-121375.21,GBP,Target
TXN0000020801,2024-02-05T20:38:09,ACC00000516,Credit,1171.6,-120203.61,EUR,Walmart
TXN0000020802,2024-07-03T07:52:34,ACC00002198,Transfer,1645.18,-118558.43,USD,Online Store
TXN0000020803,2024-06-21T03:33:17,ACC00007955,Debit,877.51,-119435.94,USD,Starbucks
TXN0000020804,2024-07-18T22:46:17,ACC00000666,Payment,644.4,-120080.34,USD,Shell
TXN0000020805,2024-06-30T10:36:51,ACC00003889,ATM,726.64,-120806.98,EUR,Online Store
TXN0000020806,2024-08-11T20:26:37,ACC00009289,Transfer,809.24,-119997.74,GBP,Restaurant
TXN0000020807,2024-07-02T15:27:18,ACC00005225,Payment,291.65,-120289.39,JPY,Online Store
TXN0000020808,2024-08-22T16:55:21,ACC00001309,ATM,241.2,-120530.59,JPY,Walmart
TXN0000020809,2024-01-28T00:05:01,ACC00000820,Transfer,692.52,-119838.07,JPY,Amazon
TXN0000020810,2024-01-23T11:39:10,ACC00008115,Credit,1351.22,-118486.85,USD,Target
TXN0000020811,2024-05-05T18:59:33,ACC00008530,Transfer,1421.79,-117065.06,USD,Target
TXN0000020812,2024-05-11T16:30:27,ACC00004065,Transfer,291.79,-116773.27,GBP,Grocery
TXN0000020813,2024-02-17T16:29:21,ACC00009457,Transfer,660.52,-116112.75,EUR,Target
TXN0000020814,2024-10-22T21:24:14,ACC00001570,Credit,273.38,-115839.37,EUR,Amazon
TXN0000020815,2024-05-11T06:58:16,ACC00001364,Transfer,1684.36,-114155.01,USD,Shell
TXN0000020816,2024-05-10T20:42:44,ACC00002728,Credit,1338.38,-112816.63,EUR,Grocery
TXN0000020817,2024-12-28T18:49:55,ACC00007476,Transfer,1897.49,-110919.14,GBP,Amazon
TXN0000020818,2024-09-29T17:37:28,ACC00001015,ATM,370.27,-111289.41,JPY,Restaurant
TXN0000020819,2024-07-30T14:25:35,ACC00002100,Transfer,706.65,-110582.76,EUR,Online Store
TXN0000020820,2024-07-25T21:30:47,ACC00009751,Credit,1992.38,-108590.38,USD,Target
TXN0000020821,2024-03-14T06:23:17,ACC00002666,Credit,1657.32,-106933.06,GBP,Shell
TXN0000020822,2024-12-22T15:51:42,ACC00007908,Credit,1311.56,-105621.5,GBP,Target
TXN0000020823,2024-07-16T06:48:23,ACC00007869,ATM,520.88,-106142.38,JPY,Amazon
TXN0000020824,2024-02-16T13:53:41,ACC00007320,Debit,708.25,-106850.63,EUR,Starbucks
TXN0000020825,2024-01-27T16:29:44,ACC00003450,Transfer,1288.05,-105562.58,JPY,Walmart
TXN0000020826,2024-04-17T02:13:45,ACC00006744,Transfer,681.51,-104881.07,JPY,Shell
TXN0000020827,2024-05-18T23:29:07,ACC00007439,Debit,1785.59,-106666.66,GBP,Online Store
TXN0000020828,2024-01-10T03:52:55,ACC00006828,ATM,1197.25,-107863.91,EUR,Amazon
TXN0000020829,2024-08-28T04:02:31,ACC00007394,Transfer,32.41,-107831.5,GBP,Restaurant
TXN0000020830,2024-08-16T13:06:01,ACC00008640,Payment,117.57,-107949.07,GBP,Restaurant
TXN0000020831,2024-04-21T07:05:42,ACC00000600,Credit,1117.15,-106831.92,JPY,Online Store
TXN0000020832,2024-04-21T00:46:02,ACC00007075,ATM,81.97,-106913.89,USD,Online Store
TXN0000020833,2024-06-24T13:43:14,ACC00004340,ATM,478.41,-107392.3,USD,Walmart
TXN0000020834,2024-01-04T09:06:04,ACC00005440,ATM,825.4,-108217.7,GBP,Walmart
TXN0000020835,2024-05-23T19:09:41,ACC00007145,Transfer,490.54,-107727.16,GBP,Amazon
TXN0000020836,2024-08-24T11:32:21,ACC00003986,Transfer,948.69,-106778.47,JPY,Starbucks
TXN0000020837,2024-11-19T16:35:27,ACC00008169,ATM,919.45,-107697.92,JPY,Grocery
TXN0000020838,2024-08-31T22:10:18,ACC00005183,Payment,1322.31,-109020.23,USD,Shell
TXN0000020839,2024-03-05T10:29:13,ACC00002197,Credit,1864.39,-107155.84,JPY,Amazon
TXN0000020840,2024-09-23T07:52:03,ACC00009479,Payment,202.07,-107357.91,JPY,Amazon
TXN0000020841,2024-01-19T10:27:27,ACC00002107,ATM,1734.4,-109092.31,EUR,Shell
TXN0000020842,2024-11-05T20:20:48,ACC00000033,ATM,659.53,-109751.84,JPY,Restaurant
TXN0000020843,2024-12-23T13:17:53,ACC00006184,Debit,497.45,-110249.29,EUR,Online Store
TXN0000020844,2024-03-10T09:49:35,ACC00008293,ATM,472.27,-110721.56,GBP,Shell
TXN0000020845,2024-12-02T06:27:39,ACC00009174,Credit,169.64,-110551.92,EUR,Restaurant
TXN0000020846,2024-12-27T22:22:16,ACC00003914,Payment,1839.28,-112391.2,GBP,Amazon
TXN0000020847,2024-12-03T04:56:04,ACC00005493,ATM,643.83,-113035.03,EUR,Online Store
TXN0000020848,2024-08-31T14:57:54,ACC00003029,ATM,470.75,-113505.78,JPY,Online Store
TXN0000020849,2024-02-24T13:44:27,ACC00005726,Credit,1705.33,-111800.45,EUR,Online Store
TXN0000020850,2024-02-24T23:51:59,ACC00003099,Debit,779.6,-112580.05,USD,Grocery
TXN0000020851,2024-02-17T07:36:57,ACC00002460,Credit,219.57,-112360.48,USD,Online Store
TXN0000020852,2024-06-01T13:14:11,ACC00009247,Credit,704.11,-111656.37,EUR,Restaurant
TXN0000020853,2024-03-10T22:32:05,ACC00003596,Debit,1440.03,-113096.4,EUR,Walmart
TXN0000020854,2024-09-21T01:14:47,ACC00004488,Credit,1640.44,-111455.96,USD,Online Store
TXN0000020855,2024-02-04T22:47:03,ACC00009510,Debit,1732.5,-113188.46,GBP,Grocery
TXN0000020856,2024-02-13T22:26:56,ACC00003815,Debit,703.83,-113892.29,GBP,Amazon
TXN0000020857,2024-09-10T12:44:25,ACC00007223,ATM,681.04,-114573.33,USD,Shell
TXN0000020858,2024-09-29T15:51:05,ACC00007527,Debit,1667.86,-116241.19,JPY,Target
TXN0000020859,2024-06-03T06:34:34,ACC00009611,Credit,374.52,-115866.67,JPY,Online Store
TXN0000020860,2024-04-20T23:42:03,ACC00002777,Payment,794.73,-116661.4,JPY,Starbucks
TXN0000020861,2024-10-23T20:17:06,ACC00002912,ATM,1068.14,-117729.54,GBP,Shell
TXN0000020862,2024-01-16T02:48:24,ACC00008509,Payment,174.93,-117904.47,GBP,Walmart
TXN0000020863,2024-05-06T13:09:52,ACC00008609,Credit,850.4,-117054.07,EUR,Walmart
TXN0000020864,2024-01-20T10:04:45,ACC00002239,ATM,1710.15,-118764.22,GBP,Starbucks
TXN0000020865,2024-12-09T11:15:10,ACC00009097,ATM,591.96,-119356.18,EUR,Grocery
TXN0000020866,2024-10-26T02:26:40,ACC00008483,Transfer,124.34,-119231.84,GBP,Shell
TXN0000020867,2024-09-04T10:18:34,ACC00000329,Payment,1001.64,-120233.48,EUR,Restaurant
TXN0000020868,2024-07-15T21:07:42,ACC00004362,ATM,435.16,-120668.64,USD,Restaurant
TXN0000020869,2024-11-29T16:50:35,ACC00005696,ATM,1779.18,-122447.82,JPY,Walmart
TXN0000020870,2024-01-01T16:43:57,ACC00003621,Payment,238.5,-122686.32,GBP,Starbucks
TXN0000020871,2024-03-04T12:04:48,ACC00001757,Credit,1703.52,-120982.8,JPY,Target
TXN0000020872,2024-11-07T11:30:15,ACC00001076,Payment,772.02,-121754.82,GBP,Online Store
TXN0000020873,2024-04-09T19:08:34,ACC00004849,Transfer,1482.31,-120272.51,GBP,Target
TXN0000020874,2024-09-11T00:10:22,ACC00004594,Transfer,367.92,-119904.59,GBP,Restaurant
TXN0000020875,2024-09-20T03:41:55,ACC00006113,Debit,1253.36,-121157.95,GBP,Restaurant
TXN0000020876,2024-05-30T18:31:24,ACC00007969,ATM,37.35,-121195.3,EUR,Amazon
TXN0000020877,2024-02-28T12:46:23,ACC00003713,Payment,1101.89,-122297.19,JPY,Shell
TXN0000020878,2024-10-14T01:39:03,ACC00008391,Credit,1597.58,-120699.61,EUR,Target
TXN0000020879,2024-08-01T20:38:02,ACC00004984,Transfer,1274.82,-119424.79,JPY,Amazon
TXN0000020880,2024-07-13T14:02:59,ACC00001624,Payment,1959.83,-121384.62,USD,Online Store
TXN0000020881,2024-10-16T15:59:49,ACC00008951,Debit,106.35,-121490.97,USD,Starbucks
TXN0000020882,2024-08-17T12:49:32,ACC00005674,Transfer,1084.67,-120406.3,JPY,Target
TXN0000020883,2024-06-23T17:10:14,ACC00009442,ATM,444.05,-120850.35,EUR,Online Store
TXN0000020884,2024-10-18T00:10:32,ACC00001876,Payment,1913.93,-122764.28,EUR,Restaurant
TXN0000020885,2024-02-15T10:33:28,ACC00003235,Transfer,1454.49,-121309.79,GBP,Walmart
TXN0000020886,2024-05-08T07:22:17,ACC00003905,Credit,1004.08,-120305.71,EUR,Walmart
TXN0000020887,2024-09-17T09:51:08,ACC00007804,Credit,1963.9,-118341.81,USD,Online Store
TXN0000020888,2024-06-28T01:04:46,ACC00004952,ATM,1626.79,-119968.6,JPY,Amazon
TXN0000020889,2024-09-27T17:52:08,ACC00000488,Payment,572.79,-120541.39,JPY,Restaurant
TXN0000020890,2024-10-26T01:14:58,ACC00008911,Payment,574.48,-121115.87,GBP,Online Store
TXN0000020891,2024-09-21T21:41:52,ACC00008728,ATM,853.53,-121969.4,USD,Restaurant
TXN0000020892,2024-12-15T13:59:36,ACC00009929,Credit,1004.84,-120964.56,JPY,Shell
TXN0000020893,2024-03-31T10:50:10,ACC00006834,Debit,797.27,-121761.83,USD,Amazon
TXN0000020894,2024-05-31T19:22:29,ACC00002106,Payment,1081.31,-122843.14,EUR,Grocery
TXN0000020895,2024-11-14T06:41:52,ACC00006837,Payment,1745.23,-124588.37,JPY,Shell
TXN0000020896,2024-07-03T01:04:34,ACC00009048,Payment,1221.84,-125810.21,GBP,Shell
TXN0000020897,2024-11-11T03:09:14,ACC00007039,Transfer,1253.54,-124556.67,USD,Amazon
TXN0000020898,2024-06-17T15:03:59,ACC00006805,Transfer,400.1,-124156.57,GBP,Starbucks
TXN0000020899,2024-11-18T07:10:25,ACC00003868,Transfer,35.29,-124121.28,EUR,Target
TXN0000020900,2024-10-26T08:16:20,ACC00007197,Transfer,1202.48,-122918.8,EUR,Shell
TXN0000020901,2024-06-05T05:01:18,ACC00001640,Payment,1522.53,-124441.33,JPY,Shell
TXN0000020902,2024-06-21T16:47:00,ACC00003093,Debit,1625.51,-126066.84,GBP,Walmart
TXN0000020903,2024-11-22T12:16:37,ACC00002652,Transfer,13.78,-126053.06,EUR,Starbucks
TXN0000020904,2024-11-07T14:01:19,ACC00007874,Payment,804.88,-126857.94,EUR,Amazon
TXN0000020905,2024-04-14T08:06:10,ACC00000603,Payment,1694.18,-128552.12,JPY,Online Store
TXN0000020906,2024-07-28T00:01:10,ACC00004797,Credit,1134.39,-127417.73,USD,Amazon
TXN0000020907,2024-09-16T13:24:04,ACC00009463,Debit,1891.37,-129309.1,JPY,Shell
TXN0000020908,2024-02-04T07:09:46,ACC00000534,Credit,1233.33,-128075.77,GBP,Shell
TXN0000020909,2024-09-23T12:30:25,ACC00004008,Transfer,1190.73,-126885.04,USD,Grocery
TXN0000020910,2024-07-31T19:37:10,ACC00000257,Credit,112.22,-126772.82,USD,Starbucks
TXN0000020911,2024-08-12T12:29:22,ACC00001898,Debit,566.57,-127339.39,USD,Restaurant
TXN0000020912,2024-01-11T14:07:27,ACC00004644,Credit,1729.97,-125609.42,GBP,Restaurant
TXN0000020913,2024-06-30T16:05:54,ACC00007072,ATM,291.85,-125901.27,JPY,Amazon
TXN0000020914,2024-08-19T04:36:21,ACC00006028,Debit,210.08,-126111.35,USD,Target
TXN0000020915,2024-03-09T18:32:44,ACC00004099,Payment,1084.44,-127195.79,GBP,Online Store
TXN0000020916,2024-06-22T00:27:40,ACC00002672,Credit,817.15,-126378.64,USD,Shell
TXN0000020917,2024-07-05T03:29:47,ACC00001351,Credit,1676.89,-124701.75,USD,Restaurant
TXN0000020918,2024-07-20T13:07:51,ACC00008821,Transfer,20.62,-124681.13,JPY,Amazon
TXN0000020919,2024-10-05T13:02:21,ACC00006548,Credit,1057.24,-123623.89,USD,Online Store
TXN0000020920,2024-12-30T10:08:34,ACC00001696,ATM,917.29,-124541.18,EUR,Amazon
TXN0000020921,2024-05-20T13:27:12,ACC00000253,ATM,128.3,-124669.48,USD,Walmart
TXN0000020922,2024-07-09T04:43:58,ACC00008352,Payment,1685.11,-126354.59,JPY,Grocery
TXN0000020923,2024-04-07T19:50:16,ACC00001402,Credit,1761.69,-124592.9,USD,Starbucks
TXN0000020924,2024-03-29T16:06:06,ACC00008689,Payment,1423.53,-126016.43,JPY,Online Store
TXN0000020925,2024-12-21T05:49:33,ACC00001266,Credit,772.01,-125244.42,GBP,Walmart
TXN0000020926,2024-07-17T03:10:51,ACC00001784,Payment,111.89,-125356.31,JPY,Restaurant
TXN0000020927,2024-06-21T18:51:51,ACC00002895,Debit,268.85,-125625.16,JPY,Amazon
TXN0000020928,2024-03-06T22:08:08,ACC00003470,ATM,72.29,-125697.45,JPY,Walmart
TXN0000020929,2024-11-30T19:31:00,ACC00003175,ATM,203.27,-125900.72,USD,Walmart
TXN0000020930,2024-01-28T02:31:00,ACC00007228,Credit,374.5,-125526.22,JPY,Shell
TXN0000020931,2024-06-16T11:06:11,ACC00002976,Credit,1171.58,-124354.64,JPY,Grocery
TXN0000020932,2024-07-16T01:43:45,ACC00001164,Payment,1076.55,-125431.19,USD,Starbucks
TXN0000020933,2024-09-07T10:12:52,ACC00006877,Transfer,1405.8,-124025.39,EUR,Amazon
TXN0000020934,2024-01-14T14:22:33,ACC00005008,Transfer,1954.23,-122071.16,GBP,Walmart
TXN0000020935,2024-12-07T14:12:24,ACC00005996,Debit,867.93,-122939.09,JPY,Amazon
TXN0000020936,2024-02-02T04:06:32,ACC00008860,Debit,1625.14,-124564.23,EUR,Starbucks
TXN0000020937,2024-10-06T10:47:08,ACC00004540,Debit,169.23,-124733.46,GBP,Starbucks
TXN0000020938,2024-07-10T21:04:21,ACC00003521,ATM,382.7,-125116.16,GBP,Shell
TXN0000020939,2024-05-30T08:20:57,ACC00000296,ATM,69.02,-125185.18,USD,Walmart
TXN0000020940,2024-01-03T16:46:12,ACC00000944,Credit,340.21,-124844.97,JPY,Amazon
TXN0000020941,2024-04-17T02:07:55,ACC00005986,Credit,735.82,-124109.15,GBP,Walmart
TXN0000020942,2024-03-23T20:25:18,ACC00004889,Transfer,1346.61,-122762.54,JPY,Walmart
TXN0000020943,2024-07-26T23:52:02,ACC00009511,Credit,12.76,-122749.78,USD,Grocery
TXN0000020944,2024-09-27T19:02:10,ACC00004306,Transfer,1016.4,-121733.38,USD,Shell
TXN0000020945,2024-12-22T18:07:25,ACC00004052,Payment,1128.03,-122861.41,EUR,Starbucks
TXN0000020946,2024-07-29T06:13:54,ACC00005702,Payment,124.9,-122986.31,GBP,Starbucks
TXN0000020947,2024-06-02T08:38:57,ACC00003177,Payment,1752.76,-124739.07,EUR,Target
TXN0000020948,2024-09-18T17:01:56,ACC00008013,Debit,1477.56,-126216.63,EUR,Shell
TXN0000020949,2024-06-29T05:01:46,ACC00000547,Transfer,897.13,-125319.5,EUR,Shell
TXN0000020950,2024-10-18T01:36:19,ACC00006367,Credit,398.81,-124920.69,GBP,Walmart
TXN0000020951,2024-07-13T22:44:34,ACC00006333,Credit,1886.88,-123033.81,JPY,Starbucks
TXN0000020952,2024-04-19T19:37:28,ACC00008520,Credit,819.76,-122214.05,JPY,Walmart
TXN0000020953,2024-01-25T22:55:54,ACC00007206,Transfer,760.53,-121453.52,EUR,Grocery
TXN0000020954,2024-05-24T18:50:31,ACC00007701,Debit,871.27,-122324.79,EUR,Online Store
TXN0000020955,2024-09-27T16:33:11,ACC00004997,Payment,166.47,-122491.26,GBP,Online Store
TXN0000020956,2024-06-25T15:26:58,ACC00003090,ATM,741.59,-123232.85,GBP,Walmart
TXN0000020957,2024-05-31T06:55:25,ACC00003117,Payment,1542.26,-124775.11,EUR,Restaurant
TXN0000020958,2024-09-05T19:16:42,ACC00002532,Debit,1335.6,-126110.71,EUR,Target
TXN0000020959,2024-12-16T00:11:02,ACC00003283,Transfer,1383.05,-124727.66,JPY,Target
TXN0000020960,2024-10-31T07:39:00,ACC00001416,Debit,1165.71,-125893.37,EUR,Restaurant
TXN0000020961,2024-11-17T22:00:38,ACC00000099,Credit,1055.89,-124837.48,EUR,Amazon
TXN0000020962,2024-09-02T11:50:15,ACC00008161,Payment,1683.01,-126520.49,EUR,Target
TXN0000020963,2024-02-11T07:13:50,ACC00000372,Payment,1868.86,-128389.35,JPY,Walmart
TXN0000020964,2024-04-24T20:28:59,ACC00003136,Payment,1553.22,-129942.57,JPY,Online Store
TXN0000020965,2024-07-09T09:22:25,ACC00004214,ATM,53.67,-129996.24,EUR,Grocery
TXN0000020966,2024-12-09T07:11:54,ACC00002013,Transfer,1719.62,-128276.62,GBP,Restaurant
TXN0000020967,2024-08-08T09:46:07,ACC00008479,Transfer,1097.17,-127179.45,GBP,Online Store
TXN0000020968,2024-06-06T21:29:25,ACC00001368,ATM,993.04,-128172.49,JPY,Restaurant
TXN0000020969,2024-04-03T19:15:00,ACC00006376,Credit,297.11,-127875.38,GBP,Starbucks
TXN0000020970,2024-11-30T01:23:18,ACC00006599,ATM,138.93,-128014.31,JPY,Shell
TXN0000020971,2024-05-05T17:31:32,ACC00007029,Payment,1598.56,-129612.87,JPY,Restaurant
TXN0000020972,2024-01-12T17:13:32,ACC00005892,Debit,1686.96,-131299.83,EUR,Shell
TXN0000020973,2024-12-19T05:36:21,ACC00008360,Payment,109.14,-131408.97,USD,Online Store
TXN0000020974,2024-03-01T00:30:01,ACC00002443,Debit,1003.75,-132412.72,JPY,Shell
TXN0000020975,2024-12-28T03:14:00,ACC00003512,Payment,12.86,-132425.58,JPY,Walmart
TXN0000020976,2024-10-30T14:38:26,ACC00009806,Credit,1105.61,-131319.97,USD,Online Store
TXN0000020977,2024-11-21T18:33:08,ACC00009209,Payment,720.05,-132040.02,GBP,Starbucks
TXN0000020978,2024-04-23T12:38:51,ACC00003689,ATM,937.33,-132977.35,USD,Shell
TXN0000020979,2024-04-28T02:53:33,ACC00009964,ATM,873.17,-133850.52,USD,Online Store
TXN0000020980,2024-11-17T14:44:09,ACC00004966,Transfer,1174.66,-132675.86,USD,Grocery
TXN0000020981,2024-03-08T23:36:18,ACC00001315,Debit,570.18,-133246.04,JPY,Walmart
TXN0000020982,2024-07-13T03:46:49,ACC00008878,Payment,64.69,-133310.73,USD,Grocery
TXN0000020983,2024-03-29T21:13:01,ACC00004469,Payment,556.41,-133867.14,USD,Shell
TXN0000020984,2024-08-25T23:45:49,ACC00007215,Debit,1546.18,-135413.32,EUR,Shell
TXN0000020985,2024-08-07T11:20:19,ACC00004789,Payment,874.5,-136287.82,JPY,Grocery
TXN0000020986,2024-05-19T18:12:10,ACC00000346,Debit,1476.97,-137764.79,GBP,Online Store
TXN0000020987,2024-04-26T03:05:51,ACC00006414,Debit,1491.77,-139256.56,USD,Online Store
TXN0000020988,2024-03-17T06:32:24,ACC00004892,ATM,1112.1,-140368.66,EUR,Starbucks
TXN0000020989,2024-05-14T19:35:04,ACC00000180,Credit,1088.36,-139280.3,EUR,Restaurant
TXN0000020990,2024-08-19T04:48:04,ACC00001658,Credit,504.41,-138775.89,GBP,Starbucks
TXN0000020991,2024-01-01T00:29:03,ACC00000322,Transfer,1252.11,-137523.78,EUR,Target
TXN0000020992,2024-05-19T10:19:55,ACC00008253,Credit,729.32,-136794.46,USD,Amazon
TXN0000020993,2024-01-01T00:20:19,ACC00007110,Credit,208.51,-136585.95,EUR,Grocery
TXN0000020994,2024-10-17T12:15:03,ACC00004619,Credit,1036.17,-135549.78,EUR,Online Store
TXN0000020995,2024-11-05T16:45:59,ACC00007494,Transfer,1637.65,-133912.13,USD,Amazon
TXN0000020996,2024-03-30T22:05:47,ACC00006864,Debit,1885.9,-135798.03,GBP,Starbucks
TXN0000020997,2024-06-08T13:33:59,ACC00007301,Debit,692.91,-136490.94,EUR,Grocery
TXN0000020998,2024-01-24T17:28:17,ACC00008162,Payment,1502.5,-137993.44,EUR,Target
TXN0000020999,2024-09-16T03:47:23,ACC00003971,Debit,1045.88,-139039.32,USD,Online Store
TXN0000021000,2024-06-23T09:08:05,ACC00002437,Payment,1395.91,-140435.23,GBP,Amazon
TXN0000021001,2024-04-09T20:37:36,ACC00001313,Transfer,1070.78,-139364.45,USD,Shell
TXN0000021002,2024-02-13T17:32:24,ACC00002965,Transfer,49.16,-139315.29,GBP,Shell
TXN0000021003,2024-02-15T19:12:24,ACC00007891,Credit,389.27,-138926.02,EUR,Amazon
TXN0000021004,2024-04-10T18:51:50,ACC00002657,ATM,1614.82,-140540.84,EUR,Online Store
TXN0000021005,2024-02-07T22:47:31,ACC00002505,Transfer,397.9,-140142.94,GBP,Starbucks
TXN0000021006,2024-06-17T13:08:08,ACC00000731,Payment,287.79,-140430.73,USD,Grocery
TXN0000021007,2024-08-27T22:20:57,ACC00001291,Payment,1303.37,-141734.1,EUR,Online Store
TXN0000021008,2024-06-29T09:52:48,ACC00004379,Debit,484.29,-142218.39,USD,Restaurant
TXN0000021009,2024-06-30T07:38:38,ACC00001117,Debit,725.22,-142943.61,EUR,Online Store
TXN0000021010,2024-08-09T06:39:49,ACC00009418,ATM,1562.79,-144506.4,USD,Grocery
TXN0000021011,2024-01-19T17:20:27,ACC00008136,Credit,411.84,-144094.56,JPY,Target
TXN0000021012,2024-12-12T14:56:49,ACC00007346,Credit,1772.89,-142321.67,GBP,Starbucks
TXN0000021013,2024-08-15T00:26:30,ACC00005915,Debit,529.27,-142850.94,GBP,Restaurant
TXN0000021014,2024-12-12T04:33:07,ACC00004095,Debit,1921.2,-144772.14,EUR,Restaurant
TXN0000021015,2024-06-14T20:31:27,ACC00005629,Payment,755.72,-145527.86,JPY,Restaurant
TXN0000021016,2024-07-03T13:26:27,ACC00001471,ATM,1391.38,-146919.24,EUR,Target
TXN0000021017,2024-04-04T19:09:50,ACC00000211,Transfer,1509.37,-145409.87,EUR,Target
TXN0000021018,2024-09-18T05:31:56,ACC00007954,Transfer,1997.02,-143412.85,EUR,Amazon
TXN0000021019,2024-08-18T05:51:25,ACC00005162,Payment,525.27,-143938.12,USD,Walmart
TXN0000021020,2024-01-19T22:56:46,ACC00009080,Transfer,206.77,-143731.35,JPY,Walmart
TXN0000021021,2024-05-17T22:11:53,ACC00003959,Transfer,168.16,-143563.19,USD,Amazon
TXN0000021022,2024-09-10T01:26:41,ACC00004930,Transfer,1283.06,-142280.13,USD,Amazon
TXN0000021023,2024-08-05T15:52:32,ACC00002548,ATM,425.1,-142705.23,JPY,Shell
TXN0000021024,2024-07-14T17:34:57,ACC00007308,ATM,1001.4,-143706.63,GBP,Grocery
TXN0000021025,2024-04-25T20:08:27,ACC00001780,ATM,1661.42,-145368.05,GBP,Target
TXN0000021026,2024-10-26T11:08:09,ACC00004813,Credit,906.23,-144461.82,EUR,Target
TXN0000021027,2024-10-11T11:28:35,ACC00000758,Credit,20.65,-144441.17,GBP,Target
TXN0000021028,2024-05-14T16:10:29,ACC00007787,Payment,1170.63,-145611.8,USD,Grocery
TXN0000021029,2024-08-25T11:45:35,ACC00007493,ATM,1805.79,-147417.59,GBP,Shell
TXN0000021030,2024-03-29T23:43:30,ACC00004478,Credit,1614.72,-145802.87,GBP,Amazon
TXN0000021031,2024-04-18T12:18:09,ACC00005979,Debit,644.23,-146447.1,EUR,Online Store
TXN0000021032,2024-11-23T13:14:54,ACC00005319,Transfer,559.66,-145887.44,EUR,Target
TXN0000021033,2024-09-24T07:47:34,ACC00001554,Credit,313.42,-145574.02,JPY,Target
TXN0000021034,2024-11-05T03:55:41,ACC00008052,Credit,483.39,-145090.63,GBP,Target
TXN0000021035,2024-04-01T11:23:40,ACC00005899,Transfer,1692.13,-143398.5,EUR,Restaurant
TXN0000021036,2024-12-23T09:31:17,ACC00006072,Credit,872.61,-142525.89,USD,Restaurant
TXN0000021037,2024-01-07T06:34:48,ACC00005223,Credit,590.4,-141935.49,EUR,Grocery
TXN0000021038,2024-10-11T10:35:04,ACC00002431,Payment,1491.88,-143427.37,GBP,Grocery
TXN0000021039,2024-08-01T01:37:36,ACC00008602,Transfer,1235.05,-142192.32,JPY,Walmart
TXN0000021040,2024-06-17T08:11:42,ACC00003131,ATM,1372.55,-143564.87,JPY,Shell
TXN0000021041,2024-06-29T14:08:16,ACC00001060,Transfer,1701.57,-141863.3,USD,Amazon
TXN0000021042,2024-10-30T20:32:21,ACC00006821,Debit,1796.6,-143659.9,GBP,Starbucks
TXN0000021043,2024-04-20T14:44:32,ACC00002836,Transfer,193.56,-143466.34,USD,Shell
TXN0000021044,2024-04-04T06:24:42,ACC00004578,Debit,229.03,-143695.37,EUR,Online Store
TXN0000021045,2024-02-29T01:29:46,ACC00003273,ATM,1011.73,-144707.1,EUR,Starbucks
TXN0000021046,2024-03-18T23:40:03,ACC00003756,ATM,827.24,-145534.34,EUR,Restaurant
TXN0000021047,2024-12-01T08:08:51,ACC00004520,ATM,358.71,-145893.05,EUR,Walmart
TXN0000021048,2024-01-11T04:36:01,ACC00001512,Transfer,536.34,-145356.71,GBP,Shell
TXN0000021049,2024-06-24T11:49:44,ACC00004373,Debit,1635.19,-146991.9,GBP,Grocery
TXN0000021050,2024-04-23T17:23:07,ACC00007307,Payment,1225.86,-148217.76,JPY,Shell
TXN0000021051,2024-12-20T16:14:27,ACC00001995,ATM,414.99,-148632.75,USD,Grocery
TXN0000021052,2024-03-26T17:40:07,ACC00008057,Transfer,662.26,-147970.49,JPY,Grocery
TXN0000021053,2024-01-04T11:30:31,ACC00003237,ATM,986.21,-148956.7,GBP,Target
TXN0000021054,2024-10-24T08:04:58,ACC00002597,Payment,112.68,-149069.38,USD,Walmart
TXN0000021055,2024-01-11T04:40:14,ACC00002976,Transfer,240.42,-148828.96,EUR,Amazon
TXN0000021056,2024-12-11T07:48:34,ACC00004860,ATM,741.42,-149570.38,EUR,Shell
TXN0000021057,2024-01-12T05:48:30,ACC00009833,Payment,1894.47,-151464.85,EUR,Online Store
TXN0000021058,2024-06-17T20:59:15,ACC00002530,Transfer,1806.0,-149658.85,GBP,Walmart
TXN0000021059,2024-07-16T19:22:23,ACC00003356,Credit,1428.94,-148229.91,GBP,Grocery
TXN0000021060,2024-05-24T11:07:56,ACC00000623,Payment,235.31,-148465.22,USD,Amazon
TXN0000021061,2024-04-03T06:52:48,ACC00006779,Debit,1471.77,-149936.99,USD,Online Store
TXN0000021062,2024-06-09T04:55:02,ACC00005593,Credit,891.66,-149045.33,EUR,Grocery
TXN0000021063,2024-12-13T23:59:29,ACC00000784,ATM,839.37,-149884.7,EUR,Amazon
TXN0000021064,2024-02-08T03:51:12,ACC00004096,Debit,1272.08,-151156.78,GBP,Walmart
TXN0000021065,2024-10-18T06:44:28,ACC00002827,ATM,97.11,-151253.89,JPY,Amazon
TXN0000021066,2024-07-25T14:37:48,ACC00005434,ATM,48.08,-151301.97,GBP,Restaurant
TXN0000021067,2024-08-03T22:02:42,ACC00000117,Debit,202.59,-151504.56,USD,Online Store
TXN0000021068,2024-08-03T12:18:18,ACC00006785,Debit,895.13,-152399.69,EUR,Target
TXN0000021069,2024-02-27T15:14:36,ACC00005066,Credit,1121.07,-151278.62,USD,Grocery
TXN0000021070,2024-06-12T15:06:17,ACC00005088,Debit,1199.57,-152478.19,USD,Restaurant
TXN0000021071,2024-03-13T01:27:39,ACC00005888,Debit,239.15,-152717.34,GBP,Target
TXN0000021072,2024-08-21T09:06:01,ACC00009203,Credit,361.31,-152356.03,USD,Amazon
TXN0000021073,2024-02-28T15:33:10,ACC00006364,ATM,937.03,-153293.06,EUR,Starbucks
TXN0000021074,2024-06-27T04:01:01,ACC00002429,Credit,814.46,-152478.6,USD,Online Store
TXN0000021075,2024-03-20T15:10:38,ACC00000247,Payment,799.37,-153277.97,EUR,Target
TXN0000021076,2024-07-27T15:56:16,ACC00005831,ATM,192.93,-153470.9,USD,Walmart
TXN0000021077,2024-03-31T17:25:50,ACC00001407,Payment,1891.04,-155361.94,USD,Walmart
TXN0000021078,2024-03-17T20:09:30,ACC00003729,Credit,1413.26,-153948.68,USD,Walmart
TXN0000021079,2024-09-11T20:55:05,ACC00006469,Credit,1617.19,-152331.49,USD,Amazon
TXN0000021080,2024-03-25T03:36:55,ACC00007693,Debit,128.03,-152459.52,GBP,Restaurant
TXN0000021081,2024-09-16T01:00:21,ACC00005830,Transfer,943.36,-151516.16,JPY,Walmart
TXN0000021082,2024-06-20T02:58:34,ACC00006851,Payment,1425.36,-152941.52,JPY,Starbucks
TXN0000021083,2024-12-17T05:49:18,ACC00002413,Transfer,759.0,-152182.52,JPY,Walmart
TXN0000021084,2024-09-30T10:06:56,ACC00006924,Credit,270.8,-151911.72,EUR,Online Store
TXN0000021085,2024-03-30T23:12:57,ACC00000024,Credit,1357.12,-150554.6,USD,Starbucks
TXN0000021086,2024-05-26T10:36:54,ACC00003738,Transfer,1546.15,-149008.45,GBP,Amazon
TXN0000021087,2024-07-18T17:03:11,ACC00005198,ATM,869.66,-149878.11,JPY,Starbucks
TXN0000021088,2024-05-06T22:00:03,ACC00003185,Payment,314.64,-150192.75,USD,Walmart
TXN0000021089,2024-01-14T06:24:05,ACC00006036,Transfer,1691.25,-148501.5,USD,Online Store
TXN0000021090,2024-12-11T13:56:51,ACC00004975,Debit,1952.9,-150454.4,USD,Online Store
TXN0000021091,2024-06-21T18:08:45,ACC00006879,ATM,957.92,-151412.32,GBP,Online Store
TXN0000021092,2024-01-10T16:47:09,ACC00007413,Payment,357.65,-151769.97,GBP,Grocery
TXN0000021093,2024-03-30T10:56:45,ACC00008926,Transfer,27.31,-151742.66,EUR,Restaurant
TXN0000021094,2024-10-04T21:36:31,ACC00000202,ATM,1770.8,-153513.46,JPY,Grocery
TXN0000021095,2024-12-08T12:10:44,ACC00009439,Payment,117.84,-153631.3,GBP,Shell
TXN0000021096,2024-03-27T22:50:05,ACC00005912,ATM,1194.29,-154825.59,USD,Target
TXN0000021097,2024-05-31T02:59:23,ACC00000468,Credit,1806.2,-153019.39,USD,Online Store
TXN0000021098,2024-04-10T01:43:53,ACC00006498,ATM,1791.4,-154810.79,EUR,Starbucks
TXN0000021099,2024-09-12T16:13:07,ACC00000613,Payment,57.69,-154868.48,JPY,Walmart
TXN0000021100,2024-01-04T20:06:53,ACC00006608,Debit,1433.69,-156302.17,JPY,Shell
TXN0000021101,2024-01-07T16:26:42,ACC00002399,Credit,1830.78,-154471.39,JPY,Online Store
TXN0000021102,2024-06-08T12:20:10,ACC00009423,Transfer,1453.38,-153018.01,EUR,Restaurant
TXN0000021103,2024-05-06T09:26:25,ACC00005951,Transfer,1849.19,-151168.82,EUR,Online Store
TXN0000021104,2024-10-06T22:14:24,ACC00006820,Transfer,429.06,-150739.76,EUR,Online Store
TXN0000021105,2024-05-11T14:36:07,ACC00002809,ATM,779.02,-151518.78,EUR,Shell
TXN0000021106,2024-03-16T22:51:20,ACC00000913,Credit,560.8,-150957.98,USD,Online Store
TXN0000021107,2024-02-18T17:09:55,ACC00009162,ATM,1233.96,-152191.94,EUR,Shell
TXN0000021108,2024-09-02T12:35:57,ACC00009982,Payment,1957.19,-154149.13,JPY,Restaurant
TXN0000021109,2024-05-07T05:05:11,ACC00005642,ATM,413.94,-154563.07,GBP,Shell
TXN0000021110,2024-07-08T05:57:22,ACC00002275,Credit,1679.33,-152883.74,USD,Online Store
TXN0000021111,2024-05-14T12:13:52,ACC00004374,Transfer,1539.73,-151344.01,JPY,Target
TXN0000021112,2024-02-25T19:45:48,ACC00002167,Transfer,916.37,-150427.64,GBP,Starbucks
TXN0000021113,2024-09-06T18:11:44,ACC00001920,Debit,954.88,-151382.52,GBP,Walmart
TXN0000021114,2024-06-23T22:21:08,ACC00009988,Debit,448.46,-151830.98,EUR,Restaurant
TXN0000021115,2024-02-19T02:08:49,ACC00007373,Payment,891.74,-152722.72,USD,Amazon
TXN0000021116,2024-06-20T14:38:52,ACC00003325,Credit,240.62,-152482.1,EUR,Grocery
TXN0000021117,2024-09-18T16:10:32,ACC00008496,Transfer,502.54,-151979.56,GBP,Grocery
TXN0000021118,2024-11-10T19:21:44,ACC00001007,ATM,998.08,-152977.64,USD,Restaurant
TXN0000021119,2024-02-20T15:10:00,ACC00008638,Debit,1874.55,-154852.19,JPY,Online Store
TXN0000021120,2024-03-29T02:10:27,ACC00005285,Credit,1377.9,-153474.29,GBP,Shell
TXN0000021121,2024-10-22T21:30:03,ACC00004368,Credit,179.79,-153294.5,JPY,Restaurant
TXN0000021122,2024-06-14T21:55:11,ACC00005259,Debit,262.86,-153557.36,EUR,Target
TXN0000021123,2024-09-13T00:43:40,ACC00000006,Debit,1951.76,-155509.12,GBP,Walmart
TXN0000021124,2024-08-21T19:39:53,ACC00000203,ATM,1470.85,-156979.97,USD,Starbucks
TXN0000021125,2024-01-03T15:46:11,ACC00002154,Debit,316.54,-157296.51,GBP,Starbucks
TXN0000021126,2024-09-14T09:04:16,ACC00009904,Transfer,1593.35,-155703.16,USD,Starbucks
TXN0000021127,2024-11-20T19:00:26,ACC00002536,ATM,1440.73,-157143.89,USD,Target
TXN0000021128,2024-11-08T18:01:41,ACC00000627,Debit,19.67,-157163.56,JPY,Amazon
TXN0000021129,2024-12-27T04:28:49,ACC00004431,Debit,296.8,-157460.36,EUR,Amazon
TXN0000021130,2024-01-27T07:15:33,ACC00006154,Payment,65.04,-157525.4,JPY,Walmart
TXN0000021131,2024-05-15T13:09:17,ACC00000812,Debit,430.89,-157956.29,EUR,Shell
TXN0000021132,2024-11-30T02:55:54,ACC00009539,Payment,1000.22,-158956.51,JPY,Starbucks
TXN0000021133,2024-06-27T19:16:55,ACC00006953,Payment,661.6,-159618.11,JPY,Starbucks
TXN0000021134,2024-06-26T00:16:44,ACC00006944,Transfer,1052.24,-158565.87,USD,Amazon
TXN0000021135,2024-08-18T03:17:41,ACC00008958,Payment,733.05,-159298.92,EUR,Shell
TXN0000021136,2024-04-30T04:15:28,ACC00004674,ATM,1215.97,-160514.89,USD,Starbucks
TXN0000021137,2024-01-06T23:53:17,ACC00000115,Debit,1989.58,-162504.47,GBP,Starbucks
TXN0000021138,2024-10-14T04:27:51,ACC00007577,Transfer,1675.84,-160828.63,JPY,Shell
TXN0000021139,2024-11-08T09:22:06,ACC00008047,Debit,472.48,-161301.11,GBP,Target
TXN0000021140,2024-01-21T19:38:07,ACC00005723,Credit,1880.01,-159421.1,JPY,Online Store
TXN0000021141,2024-09-19T20:21:58,ACC00007171,Payment,754.35,-160175.45,EUR,Starbucks
TXN0000021142,2024-04-17T23:08:57,ACC00002534,Transfer,1502.1,-158673.35,EUR,Target
TXN0000021143,2024-03-21T09:15:34,ACC00001687,Debit,912.88,-159586.23,USD,Amazon
TXN0000021144,2024-09-02T03:16:53,ACC00008415,Transfer,1255.03,-158331.2,GBP,Grocery
TXN0000021145,2024-01-06T03:19:39,ACC00006069,Debit,964.44,-159295.64,JPY,Starbucks
TXN0000021146,2024-03-02T15:08:54,ACC00003746,Payment,1415.25,-160710.89,JPY,Grocery
TXN0000021147,2024-03-13T19:49:46,ACC00000790,Payment,1656.29,-162367.18,USD,Online Store
TXN0000021148,2024-03-18T02:28:38,ACC00007236,Debit,1515.65,-163882.83,USD,Walmart
TXN0000021149,2024-06-04T04:09:02,ACC00001902,Debit,1578.71,-165461.54,GBP,Grocery
TXN0000021150,2024-03-07T12:48:32,ACC00001198,Debit,24.77,-165486.31,GBP,Starbucks
TXN0000021151,2024-11-10T14:49:31,ACC00001675,Debit,923.01,-166409.32,GBP,Walmart
TXN0000021152,2024-09-20T23:08:28,ACC00005605,Credit,524.3,-165885.02,GBP,Grocery
TXN0000021153,2024-02-09T00:15:59,ACC00002811,Debit,312.77,-166197.79,JPY,Target
TXN0000021154,2024-06-11T11:30:12,ACC00006985,Credit,1872.17,-164325.62,JPY,Online Store
TXN0000021155,2024-11-22T11:57:28,ACC00002103,Transfer,459.82,-163865.8,USD,Restaurant
TXN0000021156,2024-08-24T14:20:12,ACC00004985,Payment,186.89,-164052.69,USD,Walmart
TXN0000021157,2024-02-05T22:37:20,ACC00003091,Transfer,1918.73,-162133.96,JPY,Target
TXN0000021158,2024-08-04T13:50:23,ACC00006779,ATM,625.13,-162759.09,GBP,Grocery
TXN0000021159,2024-11-23T00:42:48,ACC00008355,ATM,54.51,-162813.6,USD,Shell
TXN0000021160,2024-12-01T17:04:20,ACC00006576,ATM,337.27,-163150.87,GBP,Starbucks
TXN0000021161,2024-02-27T02:09:02,ACC00008698,Credit,1275.19,-161875.68,JPY,Online Store
TXN0000021162,2024-07-26T15:06:20,ACC00001098,Transfer,97.91,-161777.77,USD,Grocery
TXN0000021163,2024-02-15T21:29:20,ACC00003280,ATM,1606.97,-163384.74,JPY,Grocery
TXN0000021164,2024-09-08T21:12:23,ACC00001851,Credit,1585.6,-161799.14,USD,Walmart
TXN0000021165,2024-12-06T23:32:56,ACC00009601,Debit,690.6,-162489.74,USD,Online Store
TXN0000021166,2024-11-30T01:03:45,ACC00008068,Transfer,932.93,-161556.81,JPY,Amazon
TXN0000021167,2024-02-11T18:16:30,ACC00007032,Debit,1128.08,-162684.89,USD,Grocery
TXN0000021168,2024-10-26T02:04:59,ACC00006588,Credit,967.04,-161717.85,USD,Target
TXN0000021169,2024-11-06T03:14:05,ACC00001553,Payment,1105.86,-162823.71,GBP,Amazon
TXN0000021170,2024-11-21T06:00:55,ACC00002807,ATM,621.18,-163444.89,EUR,Online Store
TXN0000021171,2024-11-26T08:01:10,ACC00008585,Payment,724.44,-164169.33,USD,Walmart
TXN0000021172,2024-12-24T11:27:37,ACC00002255,Credit,927.79,-163241.54,JPY,Starbucks
TXN0000021173,2024-06-05T12:54:21,ACC00003707,Credit,768.41,-162473.13,JPY,Walmart
TXN0000021174,2024-11-29T15:09:09,ACC00008435,Credit,917.02,-161556.11,EUR,Grocery
TXN0000021175,2024-08-02T11:28:35,ACC00000751,Payment,264.28,-161820.39,JPY,Target
TXN0000021176,2024-08-30T10:17:37,ACC00005960,ATM,1876.4,-163696.79,EUR,Starbucks
TXN0000021177,2024-12-10T14:38:26,ACC00008931,Payment,1675.3,-165372.09,USD,Target
TXN0000021178,2024-01-12T23:55:30,ACC00008286,Transfer,1137.63,-164234.46,EUR,Amazon
TXN0000021179,2024-03-14T19:13:22,ACC00003635,Credit,1073.65,-163160.81,JPY,Online Store
TXN0000021180,2024-12-07T23:33:02,ACC00003144,Credit,402.65,-162758.16,JPY,Online Store
TXN0000021181,2024-07-04T05:48:58,ACC00009164,Transfer,737.53,-162020.63,JPY,Walmart
TXN0000021182,2024-12-02T07:53:21,ACC00009684,Payment,1948.04,-163968.67,EUR,Amazon
TXN0000021183,2024-12-26T06:14:05,ACC00008681,Payment,314.05,-164282.72,USD,Amazon
TXN0000021184,2024-09-28T01:15:20,ACC00003573,Credit,1797.5,-162485.22,EUR,Grocery
TXN0000021185,2024-04-14T08:55:25,ACC00006526,Payment,793.9,-163279.12,USD,Walmart
TXN0000021186,2024-08-04T01:43:08,ACC00001355,Debit,1822.64,-165101.76,USD,Target
TXN0000021187,2024-03-03T15:28:36,ACC00008725,ATM,350.12,-165451.88,USD,Online Store
TXN0000021188,2024-05-05T03:31:54,ACC00001390,Debit,1733.14,-167185.02,GBP,Amazon
TXN0000021189,2024-01-31T01:23:58,ACC00004045,Transfer,481.84,-166703.18,EUR,Target
TXN0000021190,2024-01-21T04:59:26,ACC00001222,Transfer,191.45,-166511.73,EUR,Restaurant
TXN0000021191,2024-12-20T03:44:14,ACC00002020,Transfer,443.32,-166068.41,JPY,Grocery
TXN0000021192,2024-12-11T01:16:41,ACC00006239,Credit,676.85,-165391.56,JPY,Walmart
TXN0000021193,2024-05-08T06:51:03,ACC00001333,ATM,665.19,-166056.75,EUR,Target
TXN0000021194,2024-09-02T22:44:50,ACC00002565,Payment,1336.36,-167393.11,USD,Amazon
TXN0000021195,2024-10-23T07:01:51,ACC00005954,Credit,1847.6,-165545.51,EUR,Walmart
TXN0000021196,2024-05-01T06:46:39,ACC00006336,ATM,1129.38,-166674.89,EUR,Restaurant
TXN0000021197,2024-07-12T16:23:07,ACC00006078,Credit,1304.68,-165370.21,GBP,Starbucks
TXN0000021198,2024-04-16T01:46:09,ACC00007839,Payment,644.58,-166014.79,GBP,Restaurant
TXN0000021199,2024-12-07T16:29:01,ACC00004107,Credit,689.45,-165325.34,JPY,Starbucks
TXN0000021200,2024-07-06T10:04:41,ACC00002487,Credit,917.84,-164407.5,JPY,Walmart
TXN0000021201,2024-12-07T01:12:21,ACC00006962,Debit,303.95,-164711.45,JPY,Starbucks
TXN0000021202,2024-10-09T06:55:37,ACC00001151,Transfer,292.95,-164418.5,USD,Online Store
TXN0000021203,2024-05-29T01:12:49,ACC00002309,Credit,91.65,-164326.85,JPY,Online Store
TXN0000021204,2024-06-01T03:25:14,ACC00008561,ATM,582.61,-164909.46,JPY,Online Store
TXN0000021205,2024-09-24T01:04:05,ACC00008677,Transfer,1622.11,-163287.35,USD,Restaurant
TXN0000021206,2024-11-03T07:18:46,ACC00004966,Transfer,897.59,-162389.76,EUR,Restaurant
TXN0000021207,2024-10-15T13:34:48,ACC00004951,Payment,269.63,-162659.39,USD,Shell
TXN0000021208,2024-01-22T16:01:16,ACC00007780,ATM,1348.8,-164008.19,EUR,Restaurant
TXN0000021209,2024-04-06T08:04:07,ACC00001565,Credit,1655.39,-162352.8,EUR,Grocery
TXN0000021210,2024-06-12T15:33:52,ACC00002313,Transfer,306.95,-162045.85,GBP,Amazon
TXN0000021211,2024-05-10T08:32:20,ACC00005851,Transfer,1560.55,-160485.3,EUR,Online Store
TXN0000021212,2024-03-07T23:19:26,ACC00004637,Payment,1220.35,-161705.65,EUR,Amazon
TXN0000021213,2024-06-22T01:06:06,ACC00000364,Payment,65.47,-161771.12,EUR,Grocery
TXN0000021214,2024-09-17T00:48:45,ACC00004072,ATM,1237.02,-163008.14,JPY,Amazon
TXN0000021215,2024-04-18T05:47:42,ACC00006817,Transfer,1615.23,-161392.91,USD,Grocery
TXN0000021216,2024-04-12T22:28:31,ACC00007905,Credit,539.47,-160853.44,EUR,Shell
TXN0000021217,2024-07-08T00:11:28,ACC00004090,Transfer,955.3,-159898.14,USD,Shell
TXN0000021218,2024-01-06T04:01:11,ACC00006244,Credit,364.65,-159533.49,EUR,Shell
TXN0000021219,2024-08-08T13:14:02,ACC00001380,ATM,1363.19,-160896.68,JPY,Walmart
TXN0000021220,2024-05-01T11:16:32,ACC00003445,ATM,215.69,-161112.37,JPY,Shell
TXN0000021221,2024-12-18T21:41:44,ACC00009774,Transfer,152.24,-160960.13,EUR,Starbucks
TXN0000021222,2024-09-07T18:33:51,ACC00007631,Credit,811.6,-160148.53,USD,Grocery
TXN0000021223,2024-03-18T08:13:41,ACC00008832,ATM,632.63,-160781.16,GBP,Target
TXN0000021224,2024-04-16T19:08:07,ACC00004453,Payment,217.24,-160998.4,USD,Amazon
TXN0000021225,2024-12-22T14:37:30,ACC00004490,Payment,154.49,-161152.89,GBP,Starbucks
TXN0000021226,2024-02-21T22:58:42,ACC00002682,Transfer,1587.79,-159565.1,GBP,Walmart
TXN0000021227,2024-12-13T13:10:34,ACC00008444,Transfer,1200.59,-158364.51,GBP,Starbucks
TXN0000021228,2024-02-25T02:05:57,ACC00006198,Debit,1197.67,-159562.18,USD,Online Store
TXN0000021229,2024-11-21T12:39:39,ACC00001523,Debit,861.42,-160423.6,JPY,Online Store
TXN0000021230,2024-05-22T11:08:41,ACC00003470,Payment,205.67,-160629.27,EUR,Walmart
TXN0000021231,2024-11-29T21:36:01,ACC00007724,Payment,1640.98,-162270.25,EUR,Target
TXN0000021232,2024-10-27T20:23:24,ACC00007267,Credit,1452.13,-160818.12,USD,Walmart
TXN0000021233,2024-07-05T03:27:01,ACC00002037,Credit,1097.62,-159720.5,USD,Amazon
TXN0000021234,2024-04-18T18:17:02,ACC00009313,Payment,1922.65,-161643.15,USD,Target
TXN0000021235,2024-01-01T20:32:45,ACC00009746,ATM,1608.93,-163252.08,JPY,Shell
TXN0000021236,2024-08-06T11:24:18,ACC00000152,Payment,1941.06,-165193.14,JPY,Online Store
TXN0000021237,2024-02-20T20:20:27,ACC00008544,Credit,1792.01,-163401.13,USD,Target
TXN0000021238,2024-12-21T23:13:56,ACC00003195,Credit,1196.76,-162204.37,EUR,Starbucks
TXN0000021239,2024-03-07T12:32:48,ACC00003988,Debit,1582.33,-163786.7,GBP,Grocery
TXN0000021240,2024-03-12T08:48:33,ACC00004490,Payment,735.66,-164522.36,EUR,Starbucks
TXN0000021241,2024-11-14T02:50:54,ACC00000907,ATM,1106.63,-165628.99,JPY,Shell
TXN0000021242,2024-02-25T23:32:40,ACC00008888,Credit,1683.95,-163945.04,GBP,Online Store
TXN0000021243,2024-08-31T07:33:18,ACC00009501,Debit,1480.87,-165425.91,EUR,Walmart
TXN0000021244,2024-01-30T12:59:21,ACC00002222,Transfer,1948.59,-163477.32,USD,Starbucks
TXN0000021245,2024-05-21T07:25:30,ACC00008286,Debit,574.84,-164052.16,EUR,Amazon
TXN0000021246,2024-02-26T11:58:38,ACC00005660,Debit,1267.92,-165320.08,USD,Shell
TXN0000021247,2024-08-31T13:38:12,ACC00002262,Credit,1721.54,-163598.54,EUR,Amazon
TXN0000021248,2024-04-23T18:32:40,ACC00004410,Credit,1198.78,-162399.76,USD,Target
TXN0000021249,2024-01-23T02:01:21,ACC00005740,Debit,1415.87,-163815.63,JPY,Restaurant
TXN0000021250,2024-03-03T03:51:20,ACC00008535,Credit,1214.31,-162601.32,USD,Restaurant
TXN0000021251,2024-07-16T11:38:53,ACC00003457,Debit,1773.27,-164374.59,JPY,Shell
TXN0000021252,2024-08-07T08:02:11,ACC00008185,Payment,1255.89,-165630.48,USD,Walmart
TXN0000021253,2024-05-16T19:16:36,ACC00002618,Credit,616.7,-165013.78,USD,Starbucks
TXN0000021254,2024-09-17T04:02:52,ACC00005758,Credit,394.68,-164619.1,GBP,Online Store
TXN0000021255,2024-12-01T12:14:21,ACC00005943,Credit,955.17,-163663.93,GBP,Target
TXN0000021256,2024-02-24T00:57:17,ACC00007504,Payment,1202.65,-164866.58,JPY,Walmart
TXN0000021257,2024-11-01T17:13:36,ACC00001719,Credit,287.73,-164578.85,JPY,Target
TXN0000021258,2024-05-03T23:55:00,ACC00007226,Credit,1693.0,-162885.85,JPY,Starbucks
TXN0000021259,2024-01-09T20:11:40,ACC00007104,Debit,1111.25,-163997.1,JPY,Walmart
TXN0000021260,2024-02-18T08:00:00,ACC00005605,Payment,717.99,-164715.09,GBP,Amazon
TXN0000021261,2024-02-29T19:45:41,ACC00004592,Debit,1329.6,-166044.69,GBP,Amazon
TXN0000021262,2024-10-23T21:08:44,ACC00004526,Credit,105.86,-165938.83,GBP,Starbucks
TXN0000021263,2024-02-12T12:07:48,ACC00004774,Transfer,715.91,-165222.92,USD,Shell
TXN0000021264,2024-12-24T05:26:28,ACC00003032,Payment,1863.36,-167086.28,USD,Online Store
TXN0000021265,2024-11-17T16:39:21,ACC00002919,ATM,163.5,-167249.78,EUR,Amazon
TXN0000021266,2024-01-22T23:55:28,ACC00004679,Transfer,1428.48,-165821.3,JPY,Restaurant
TXN0000021267,2024-08-25T09:46:31,ACC00005307,Debit,1021.48,-166842.78,USD,Shell
TXN0000021268,2024-10-10T18:07:11,ACC00008232,Payment,1521.08,-168363.86,EUR,Restaurant
TXN0000021269,2024-11-01T22:57:58,ACC00008628,Credit,44.36,-168319.5,EUR,Grocery
TXN0000021270,2024-07-20T21:33:05,ACC00003605,Transfer,1079.58,-167239.92,JPY,Online Store
TXN0000021271,2024-11-18T00:40:21,ACC00000012,Debit,1518.26,-168758.18,JPY,Shell
TXN0000021272,2024-01-18T12:04:24,ACC00009255,Payment,651.69,-169409.87,EUR,Shell
TXN0000021273,2024-05-27T14:50:31,ACC00006776,Transfer,1754.57,-167655.3,GBP,Amazon
TXN0000021274,2024-07-19T06:46:18,ACC00007918,Payment,831.27,-168486.57,EUR,Grocery
TXN0000021275,2024-11-19T12:20:23,ACC00001738,Debit,311.01,-168797.58,EUR,Grocery
TXN0000021276,2024-02-17T09:10:00,ACC00006547,Transfer,19.64,-168777.94,JPY,Restaurant
TXN0000021277,2024-04-08T08:50:59,ACC00009843,Credit,338.4,-168439.54,JPY,Amazon
TXN0000021278,2024-07-12T00:52:15,ACC00004820,Transfer,524.16,-167915.38,JPY,Grocery
TXN0000021279,2024-11-06T07:44:24,ACC00002025,Debit,231.73,-168147.11,GBP,Grocery
TXN0000021280,2024-02-14T15:07:22,ACC00009953,Debit,1177.54,-169324.65,JPY,Shell
TXN0000021281,2024-10-16T12:58:46,ACC00007746,Debit,529.22,-169853.87,JPY,Starbucks
TXN0000021282,2024-10-11T10:24:09,ACC00001455,Transfer,505.61,-169348.26,USD,Shell
TXN0000021283,2024-01-01T14:56:30,ACC00008245,Debit,916.87,-170265.13,EUR,Grocery
TXN0000021284,2024-04-26T14:39:22,ACC00000712,Credit,1731.94,-168533.19,JPY,Online Store
TXN0000021285,2024-02-13T00:04:19,ACC00003682,ATM,373.81,-168907.0,JPY,Shell
TXN0000021286,2024-07-28T23:37:17,ACC00008581,Debit,555.84,-169462.84,JPY,Target
TXN0000021287,2024-12-10T07:11:40,ACC00006118,Credit,1735.52,-167727.32,GBP,Grocery
TXN0000021288,2024-02-17T06:51:09,ACC00000979,Transfer,1741.33,-165985.99,JPY,Target
TXN0000021289,2024-10-25T16:32:44,ACC00003117,Credit,1174.96,-164811.03,JPY,Online Store
TXN0000021290,2024-01-25T20:49:12,ACC00006785,Transfer,1906.32,-162904.71,GBP,Amazon
TXN0000021291,2024-11-18T03:23:52,ACC00000255,Debit,1044.9,-163949.61,EUR,Shell
TXN0000021292,2024-06-09T06:38:50,ACC00009514,Credit,1896.07,-162053.54,JPY,Shell
TXN0000021293,2024-01-20T11:13:29,ACC00006076,Payment,87.87,-162141.41,USD,Restaurant
TXN0000021294,2024-11-05T07:10:09,ACC00002408,Payment,160.27,-162301.68,USD,Starbucks
TXN0000021295,2024-10-25T12:07:43,ACC00001487,Credit,1534.91,-160766.77,EUR,Grocery
TXN0000021296,2024-08-31T00:07:53,ACC00006693,Transfer,77.27,-160689.5,USD,Target
TXN0000021297,2024-08-31T11:08:52,ACC00001366,Transfer,1214.11,-159475.39,GBP,Grocery
TXN0000021298,2024-09-26T00:38:00,ACC00008266,Debit,829.64,-160305.03,USD,Grocery
TXN0000021299,2024-08-15T17:09:36,ACC00000972,Payment,931.35,-161236.38,GBP,Starbucks
TXN0000021300,2024-01-23T06:37:24,ACC00005204,Credit,1095.57,-160140.81,USD,Shell
TXN0000021301,2024-11-28T08:28:14,ACC00009516,Payment,1341.6,-161482.41,USD,Shell
TXN0000021302,2024-10-31T21:29:52,ACC00001708,Payment,545.05,-162027.46,USD,Walmart
TXN0000021303,2024-09-01T23:12:25,ACC00005200,Credit,1432.24,-160595.22,JPY,Online Store
TXN0000021304,2024-08-24T09:57:52,ACC00002566,ATM,306.52,-160901.74,EUR,Grocery
TXN0000021305,2024-09-21T12:46:44,ACC00003246,ATM,478.26,-161380.0,USD,Shell
TXN0000021306,2024-03-27T08:42:55,ACC00004775,Transfer,580.67,-160799.33,JPY,Target
TXN0000021307,2024-09-18T10:14:34,ACC00006801,Transfer,892.14,-159907.19,GBP,Walmart
TXN0000021308,2024-06-16T00:34:22,ACC00007021,Credit,29.1,-159878.09,JPY,Shell
TXN0000021309,2024-01-03T13:20:30,ACC00009840,Debit,1797.35,-161675.44,GBP,Target
TXN0000021310,2024-05-15T22:11:47,ACC00001137,Credit,354.66,-161320.78,GBP,Target
TXN0000021311,2024-12-28T03:30:46,ACC00003336,Transfer,693.72,-160627.06,GBP,Walmart
TXN0000021312,2024-01-12T12:26:24,ACC00001533,Credit,1664.68,-158962.38,GBP,Grocery
TXN0000021313,2024-02-10T02:31:07,ACC00004526,Credit,1266.84,-157695.54,USD,Target
TXN0000021314,2024-08-22T20:23:13,ACC00006651,Debit,1264.21,-158959.75,GBP,Amazon
TXN0000021315,2024-05-02T02:51:59,ACC00006330,Debit,271.48,-159231.23,GBP,Amazon
TXN0000021316,2024-01-06T07:42:33,ACC00003237,Credit,1261.9,-157969.33,EUR,Restaurant
TXN0000021317,2024-02-11T21:29:31,ACC00000640,Debit,248.48,-158217.81,JPY,Target
TXN0000021318,2024-10-02T03:08:25,ACC00007784,Transfer,1223.65,-156994.16,GBP,Shell
TXN0000021319,2024-02-24T04:50:03,ACC00002754,Credit,91.18,-156902.98,GBP,Restaurant
TXN0000021320,2024-05-04T12:45:09,ACC00008109,Credit,1855.21,-155047.77,GBP,Shell
TXN0000021321,2024-12-14T10:25:34,ACC00006747,Credit,1347.12,-153700.65,GBP,Target
TXN0000021322,2024-03-24T15:14:26,ACC00004077,ATM,1501.94,-155202.59,EUR,Grocery
TXN0000021323,2024-11-20T07:17:52,ACC00005848,Debit,1285.75,-156488.34,USD,Amazon
TXN0000021324,2024-08-27T19:10:41,ACC00003592,Payment,418.68,-156907.02,GBP,Restaurant
TXN0000021325,2024-04-28T06:58:29,ACC00006277,ATM,472.5,-157379.52,JPY,Target
TXN0000021326,2024-08-10T21:28:15,ACC00002578,Transfer,290.61,-157088.91,EUR,Restaurant
TXN0000021327,2024-05-28T03:52:15,ACC00001238,Payment,852.43,-157941.34,USD,Target
TXN0000021328,2024-08-19T16:40:52,ACC00009438,Credit,799.05,-157142.29,EUR,Starbucks
TXN0000021329,2024-12-16T20:56:45,ACC00003314,Credit,1203.59,-155938.7,EUR,Restaurant
TXN0000021330,2024-02-23T16:43:20,ACC00007693,Credit,718.49,-155220.21,USD,Online Store
TXN0000021331,2024-05-03T10:58:45,ACC00004999,Payment,1373.65,-156593.86,EUR,Amazon
TXN0000021332,2024-06-17T15:12:16,ACC00003504,Payment,1772.17,-158366.03,USD,Walmart
TXN0000021333,2024-05-02T14:41:51,ACC00008578,Transfer,904.09,-157461.94,GBP,Shell
TXN0000021334,2024-07-08T22:37:33,ACC00002862,Payment,773.36,-158235.3,EUR,Starbucks
TXN0000021335,2024-05-29T07:20:29,ACC00001154,Debit,1789.78,-160025.08,USD,Walmart
TXN0000021336,2024-01-26T16:05:29,ACC00003382,Payment,564.64,-160589.72,JPY,Amazon
TXN0000021337,2024-10-15T20:58:35,ACC00005350,Payment,382.14,-160971.86,USD,Starbucks
TXN0000021338,2024-01-23T09:55:41,ACC00002280,Credit,1877.12,-159094.74,EUR,Shell
TXN0000021339,2024-01-11T12:20:56,ACC00003784,ATM,1699.95,-160794.69,EUR,Restaurant
TXN0000021340,2024-08-25T17:32:26,ACC00005812,Credit,1018.97,-159775.72,JPY,Amazon
TXN0000021341,2024-07-28T10:22:53,ACC00005521,Transfer,1732.75,-158042.97,EUR,Grocery
TXN0000021342,2024-10-09T09:03:40,ACC00006370,Debit,633.23,-158676.2,EUR,Grocery
TXN0000021343,2024-08-10T19:49:36,ACC00005631,Debit,125.19,-158801.39,JPY,Shell
TXN0000021344,2024-06-18T13:20:26,ACC00007708,Payment,1072.93,-159874.32,JPY,Walmart
TXN0000021345,2024-11-13T07:42:59,ACC00002389,Transfer,881.31,-158993.01,JPY,Grocery
TXN0000021346,2024-12-18T13:55:48,ACC00008449,Credit,1906.65,-157086.36,EUR,Starbucks
TXN0000021347,2024-08-22T07:18:45,ACC00005647,Debit,306.92,-157393.28,EUR,Grocery
TXN0000021348,2024-07-17T13:03:22,ACC00008356,Credit,951.34,-156441.94,EUR,Shell
TXN0000021349,2024-05-20T23:21:48,ACC00000423,ATM,293.18,-156735.12,JPY,Grocery
TXN0000021350,2024-12-10T01:37:55,ACC00003092,Credit,1746.55,-154988.57,EUR,Walmart
TXN0000021351,2024-07-15T05:42:34,ACC00007661,Credit,1733.25,-153255.32,JPY,Starbucks
TXN0000021352,2024-09-29T09:56:08,ACC00000638,ATM,703.15,-153958.47,USD,Target
TXN0000021353,2024-07-17T02:43:54,ACC00008105,Transfer,324.03,-153634.44,EUR,Walmart
TXN0000021354,2024-01-19T15:10:00,ACC00000491,Payment,1115.53,-154749.97,EUR,Grocery
TXN0000021355,2024-03-20T00:57:43,ACC00001672,Credit,1267.52,-153482.45,GBP,Walmart
TXN0000021356,2024-10-26T05:24:47,ACC00003159,ATM,1492.27,-154974.72,JPY,Restaurant
TXN0000021357,2024-02-29T07:21:22,ACC00000606,Debit,1841.73,-156816.45,USD,Amazon
TXN0000021358,2024-01-01T10:16:27,ACC00009721,Payment,627.76,-157444.21,EUR,Grocery
TXN0000021359,2024-03-04T17:37:06,ACC00000411,ATM,237.47,-157681.68,JPY,Online Store
TXN0000021360,2024-10-10T05:13:36,ACC00006304,Debit,460.99,-158142.67,EUR,Target
TXN0000021361,2024-09-12T16:23:54,ACC00002365,Transfer,1370.32,-156772.35,GBP,Target
TXN0000021362,2024-03-19T05:03:07,ACC00001878,Debit,1137.95,-157910.3,USD,Amazon
TXN0000021363,2024-10-27T17:04:21,ACC00009024,Payment,1722.81,-159633.11,EUR,Grocery
TXN0000021364,2024-11-26T16:52:00,ACC00006631,Credit,1934.51,-157698.6,USD,Grocery
TXN0000021365,2024-09-11T16:43:06,ACC00008457,Debit,1934.76,-159633.36,JPY,Grocery
TXN0000021366,2024-08-12T10:12:09,ACC00002056,Transfer,1496.16,-158137.2,JPY,Amazon
TXN0000021367,2024-04-24T02:21:55,ACC00004044,Debit,1300.54,-159437.74,JPY,Amazon
TXN0000021368,2024-01-20T19:37:39,ACC00004538,Credit,1586.79,-157850.95,GBP,Online Store
TXN0000021369,2024-05-27T23:06:05,ACC00009568,Transfer,1551.42,-156299.53,EUR,Target
TXN0000021370,2024-08-09T09:15:02,ACC00006542,Credit,1148.14,-155151.39,JPY,Target
TXN0000021371,2024-11-30T04:27:33,ACC00008511,Payment,1610.92,-156762.31,GBP,Target
TXN0000021372,2024-01-14T15:21:48,ACC00006189,Transfer,1494.48,-155267.83,JPY,Starbucks
TXN0000021373,2024-01-10T09:48:29,ACC00001173,ATM,37.22,-155305.05,GBP,Starbucks
TXN0000021374,2024-08-15T02:10:08,ACC00004656,Payment,1078.1,-156383.15,USD,Target
TXN0000021375,2024-07-30T07:03:58,ACC00009951,ATM,1456.77,-157839.92,USD,Restaurant
TXN0000021376,2024-03-03T02:17:32,ACC00003704,Credit,1094.69,-156745.23,JPY,Walmart
TXN0000021377,2024-03-17T16:20:14,ACC00000224,ATM,1438.93,-158184.16,EUR,Grocery
TXN0000021378,2024-12-24T13:27:51,ACC00000923,Credit,148.33,-158035.83,USD,Starbucks
TXN0000021379,2024-07-04T00:10:29,ACC00005259,Debit,921.25,-158957.08,GBP,Starbucks
TXN0000021380,2024-08-06T00:32:26,ACC00007973,ATM,1196.46,-160153.54,USD,Grocery
TXN0000021381,2024-12-09T03:20:45,ACC00001046,Transfer,1407.95,-158745.59,JPY,Target
TXN0000021382,2024-06-12T06:53:42,ACC00005856,Credit,108.33,-158637.26,EUR,Starbucks
TXN0000021383,2024-09-28T16:31:32,ACC00003506,Payment,1295.7,-159932.96,EUR,Shell
TXN0000021384,2024-01-25T18:19:37,ACC00003067,Transfer,675.04,-159257.92,GBP,Amazon
TXN0000021385,2024-06-19T23:43:32,ACC00009787,Transfer,124.3,-159133.62,USD,Amazon
TXN0000021386,2024-01-17T10:02:28,ACC00007208,Credit,723.98,-158409.64,USD,Grocery
TXN0000021387,2024-10-03T10:13:08,ACC00005426,Transfer,717.5,-157692.14,USD,Walmart
TXN0000021388,2024-10-25T15:22:13,ACC00007871,Debit,382.43,-158074.57,EUR,Online Store
TXN0000021389,2024-09-23T09:06:55,ACC00000165,Debit,647.7,-158722.27,GBP,Shell
TXN0000021390,2024-08-08T13:47:19,ACC00003437,Debit,366.23,-159088.5,GBP,Online Store
TXN0000021391,2024-06-02T14:41:53,ACC00008580,Payment,1685.69,-160774.19,USD,Online Store
TXN0000021392,2024-10-31T09:53:13,ACC00005725,Payment,306.03,-161080.22,GBP,Grocery
TXN0000021393,2024-02-26T22:50:21,ACC00001864,Transfer,1405.49,-159674.73,GBP,Starbucks
TXN0000021394,2024-02-19T18:23:23,ACC00007428,Payment,1075.91,-160750.64,EUR,Amazon
TXN0000021395,2024-08-24T10:42:57,ACC00009269,Credit,604.04,-160146.6,GBP,Shell
TXN0000021396,2024-11-11T08:20:30,ACC00007827,Payment,1980.48,-162127.08,JPY,Online Store
TXN0000021397,2024-01-15T07:36:35,ACC00006444,Transfer,1344.73,-160782.35,JPY,Grocery
TXN0000021398,2024-08-14T06:49:03,ACC00006067,Transfer,191.85,-160590.5,USD,Target
TXN0000021399,2024-11-27T04:29:28,ACC00002406,Credit,942.36,-159648.14,JPY,Online Store
TXN0000021400,2024-11-28T00:11:11,ACC00006973,Credit,860.03,-158788.11,JPY,Shell
TXN0000021401,2024-12-19T22:26:20,ACC00000273,Credit,1405.41,-157382.7,JPY,Walmart
TXN0000021402,2024-02-13T04:43:04,ACC00006516,ATM,938.94,-158321.64,EUR,Target
TXN0000021403,2024-07-30T04:07:25,ACC00009001,Transfer,1551.6,-156770.04,JPY,Restaurant
TXN0000021404,2024-05-01T01:26:52,ACC00001225,ATM,1274.38,-158044.42,JPY,Target
TXN0000021405,2024-05-19T03:40:58,ACC00003273,Payment,1643.99,-159688.41,USD,Starbucks
TXN0000021406,2024-12-14T07:39:01,ACC00005124,ATM,1507.48,-161195.89,JPY,Target
TXN0000021407,2024-02-24T03:08:01,ACC00000256,Transfer,1715.51,-159480.38,JPY,Online Store
TXN0000021408,2024-03-03T16:58:13,ACC00002348,Credit,1469.24,-158011.14,GBP,Restaurant
TXN0000021409,2024-01-14T07:07:35,ACC00008500,ATM,93.4,-158104.54,JPY,Online Store
TXN0000021410,2024-01-25T11:32:19,ACC00000470,Credit,1454.27,-156650.27,EUR,Shell
TXN0000021411,2024-09-15T08:52:52,ACC00002295,Payment,45.25,-156695.52,GBP,Walmart
TXN0000021412,2024-08-14T14:50:15,ACC00005463,Debit,380.27,-157075.79,USD,Grocery
TXN0000021413,2024-09-16T16:19:47,ACC00000946,Transfer,400.54,-156675.25,USD,Target
TXN0000021414,2024-07-29T23:29:36,ACC00002740,Transfer,1879.05,-154796.2,GBP,Walmart
TXN0000021415,2024-01-08T15:37:48,ACC00000244,Debit,441.77,-155237.97,GBP,Amazon
TXN0000021416,2024-02-06T02:40:25,ACC00004515,Transfer,566.12,-154671.85,USD,Starbucks
TXN0000021417,2024-12-25T21:30:41,ACC00004347,Payment,1956.6,-156628.45,JPY,Grocery
TXN0000021418,2024-09-19T11:35:25,ACC00009813,ATM,883.54,-157511.99,GBP,Amazon
TXN0000021419,2024-07-01T04:18:12,ACC00005295,Payment,1100.4,-158612.39,JPY,Grocery
TXN0000021420,2024-04-11T08:38:45,ACC00009603,Credit,193.39,-158419.0,JPY,Online Store
TXN0000021421,2024-09-05T00:01:59,ACC00002211,Transfer,1476.69,-156942.31,EUR,Starbucks
TXN0000021422,2024-01-17T10:49:05,ACC00008598,ATM,1911.87,-158854.18,EUR,Starbucks
TXN0000021423,2024-05-19T09:05:01,ACC00009542,Credit,940.45,-157913.73,JPY,Starbucks
TXN0000021424,2024-02-18T15:27:20,ACC00001746,Payment,666.16,-158579.89,JPY,Restaurant
TXN0000021425,2024-09-24T01:07:14,ACC00002528,Transfer,756.04,-157823.85,GBP,Online Store
TXN0000021426,2024-03-06T06:07:37,ACC00004832,ATM,1909.35,-159733.2,JPY,Amazon
TXN0000021427,2024-01-10T13:06:39,ACC00001551,Payment,1342.82,-161076.02,USD,Walmart
TXN0000021428,2024-05-06T20:47:26,ACC00008102,Transfer,543.34,-160532.68,EUR,Target
TXN0000021429,2024-08-12T16:53:00,ACC00002800,Payment,1761.54,-162294.22,JPY,Target
TXN0000021430,2024-12-13T04:09:05,ACC00000315,Credit,431.69,-161862.53,JPY,Target
TXN0000021431,2024-01-31T12:53:14,ACC00000585,Credit,1708.69,-160153.84,USD,Grocery
TXN0000021432,2024-11-07T13:19:32,ACC00002255,Payment,208.74,-160362.58,EUR,Walmart
TXN0000021433,2024-01-17T02:18:43,ACC00003762,Credit,1907.94,-158454.64,USD,Target
TXN0000021434,2024-02-01T13:13:42,ACC00002613,Transfer,1856.55,-156598.09,JPY,Restaurant
TXN0000021435,2024-09-27T13:32:46,ACC00008495,ATM,518.89,-157116.98,GBP,Starbucks
TXN0000021436,2024-10-05T12:38:58,ACC00005945,Payment,416.75,-157533.73,USD,Restaurant
TXN0000021437,2024-11-21T03:38:55,ACC00007568,Credit,1653.19,-155880.54,GBP,Shell
TXN0000021438,2024-07-01T14:28:06,ACC00000565,Transfer,1352.37,-154528.17,EUR,Walmart
TXN0000021439,2024-04-16T00:50:14,ACC00008310,Payment,441.34,-154969.51,EUR,Walmart
TXN0000021440,2024-12-11T00:54:14,ACC00009117,Payment,781.93,-155751.44,USD,Grocery
TXN0000021441,2024-09-27T12:27:26,ACC00006237,Debit,674.17,-156425.61,EUR,Amazon
TXN0000021442,2024-01-18T19:35:30,ACC00001102,Payment,1807.42,-158233.03,USD,Shell
TXN0000021443,2024-11-28T03:44:16,ACC00006526,ATM,1463.54,-159696.57,GBP,Target
TXN0000021444,2024-04-23T18:42:33,ACC00008821,Transfer,262.87,-159433.7,USD,Amazon
TXN0000021445,2024-09-12T23:47:04,ACC00008866,Credit,405.21,-159028.49,EUR,Amazon
TXN0000021446,2024-10-27T16:02:45,ACC00000152,Payment,845.68,-159874.17,GBP,Shell
TXN0000021447,2024-09-22T07:26:54,ACC00006921,ATM,1045.75,-160919.92,EUR,Online Store
TXN0000021448,2024-01-14T12:39:46,ACC00000835,Transfer,644.29,-160275.63,GBP,Walmart
TXN0000021449,2024-09-17T03:09:14,ACC00000394,Credit,1120.65,-159154.98,GBP,Walmart
TXN0000021450,2024-06-03T09:12:23,ACC00008607,Payment,1401.44,-160556.42,EUR,Amazon
TXN0000021451,2024-05-12T05:43:37,ACC00008365,ATM,1393.36,-161949.78,GBP,Online Store
TXN0000021452,2024-07-28T06:19:43,ACC00007708,Credit,1952.47,-159997.31,GBP,Online Store
TXN0000021453,2024-12-23T08:13:04,ACC00003636,Transfer,700.71,-159296.6,JPY,Online Store
TXN0000021454,2024-07-18T21:58:27,ACC00001309,Credit,1335.61,-157960.99,USD,Walmart
TXN0000021455,2024-07-07T11:12:51,ACC00006044,Debit,1121.78,-159082.77,EUR,Starbucks
TXN0000021456,2024-02-28T06:11:45,ACC00001343,Debit,1606.76,-160689.53,JPY,Restaurant
TXN0000021457,2024-03-06T00:57:41,ACC00009760,Payment,661.69,-161351.22,JPY,Walmart
TXN0000021458,2024-08-05T05:36:43,ACC00005921,Transfer,208.78,-161142.44,EUR,Online Store
TXN0000021459,2024-02-16T11:00:54,ACC00005279,Credit,1502.31,-159640.13,JPY,Walmart
TXN0000021460,2024-03-15T01:31:53,ACC00002841,Transfer,1364.38,-158275.75,GBP,Online Store
TXN0000021461,2024-01-09T21:43:23,ACC00004101,Transfer,702.16,-157573.59,JPY,Starbucks
TXN0000021462,2024-12-14T12:31:31,ACC00002716,Credit,672.26,-156901.33,EUR,Amazon
TXN0000021463,2024-09-01T22:55:35,ACC00000522,Debit,201.69,-157103.02,EUR,Restaurant
TXN0000021464,2024-04-20T21:07:17,ACC00002956,Credit,236.34,-156866.68,GBP,Online Store
TXN0000021465,2024-10-31T00:47:03,ACC00008313,Credit,42.78,-156823.9,JPY,Starbucks
TXN0000021466,2024-09-10T14:10:51,ACC00001766,Payment,1991.55,-158815.45,USD,Shell
TXN0000021467,2024-06-07T22:25:31,ACC00004422,ATM,731.92,-159547.37,USD,Grocery
TXN0000021468,2024-09-01T19:10:36,ACC00006566,Debit,781.86,-160329.23,USD,Target
TXN0000021469,2024-10-18T03:45:58,ACC00006221,ATM,1317.61,-161646.84,JPY,Amazon
TXN0000021470,2024-07-04T06:20:54,ACC00000897,Transfer,1021.26,-160625.58,USD,Restaurant
TXN0000021471,2024-12-19T20:07:20,ACC00000647,Payment,1688.61,-162314.19,USD,Starbucks
TXN0000021472,2024-10-20T13:26:25,ACC00006896,Payment,808.25,-163122.44,EUR,Shell
TXN0000021473,2024-12-28T13:57:49,ACC00001847,Payment,681.42,-163803.86,JPY,Starbucks
TXN0000021474,2024-02-27T19:26:17,ACC00003558,ATM,1605.52,-165409.38,JPY,Shell
TXN0000021475,2024-06-29T03:34:16,ACC00008742,Debit,225.46,-165634.84,JPY,Grocery
TXN0000021476,2024-09-05T13:48:31,ACC00002738,Transfer,1175.34,-164459.5,USD,Online Store
TXN0000021477,2024-10-15T19:09:07,ACC00007334,Debit,1000.49,-165459.99,JPY,Grocery
TXN0000021478,2024-01-26T12:59:59,ACC00009771,Transfer,1797.53,-163662.46,USD,Starbucks
TXN0000021479,2024-10-05T13:42:09,ACC00009005,Debit,1805.97,-165468.43,EUR,Grocery
TXN0000021480,2024-10-31T04:30:06,ACC00001093,Transfer,834.56,-164633.87,EUR,Amazon
TXN0000021481,2024-10-10T09:48:12,ACC00001191,Payment,1466.17,-166100.04,EUR,Online Store
TXN0000021482,2024-11-18T20:21:05,ACC00002217,Credit,1874.58,-164225.46,EUR,Shell
TXN0000021483,2024-10-31T17:29:21,ACC00007551,Credit,1579.05,-162646.41,GBP,Shell
TXN0000021484,2024-06-17T08:05:34,ACC00009242,Debit,288.54,-162934.95,USD,Online Store
TXN0000021485,2024-05-01T20:16:11,ACC00001245,Transfer,1541.24,-161393.71,USD,Target
TXN0000021486,2024-11-10T18:30:53,ACC00006880,Payment,792.4,-162186.11,EUR,Starbucks
TXN0000021487,2024-09-19T12:16:22,ACC00004086,Debit,942.79,-163128.9,EUR,Shell
TXN0000021488,2024-10-21T17:09:21,ACC00007609,Credit,824.23,-162304.67,USD,Amazon
TXN0000021489,2024-10-01T21:36:55,ACC00009164,Debit,1981.31,-164285.98,USD,Amazon
TXN0000021490,2024-12-13T12:38:45,ACC00008151,Payment,1267.28,-165553.26,GBP,Grocery
TXN0000021491,2024-01-17T19:53:08,ACC00001498,Transfer,1679.9,-163873.36,JPY,Restaurant
TXN0000021492,2024-01-19T17:14:06,ACC00007175,ATM,1756.5,-165629.86,GBP,Walmart
TXN0000021493,2024-05-27T17:28:29,ACC00004176,Transfer,1114.55,-164515.31,GBP,Online Store
TXN0000021494,2024-04-19T09:45:24,ACC00002138,Debit,265.52,-164780.83,USD,Amazon
TXN0000021495,2024-08-25T09:30:49,ACC00004996,Credit,268.92,-164511.91,USD,Online Store
TXN0000021496,2024-07-18T22:16:55,ACC00009964,Credit,1128.43,-163383.48,USD,Amazon
TXN0000021497,2024-11-09T22:00:48,ACC00008696,Transfer,1783.26,-161600.22,JPY,Restaurant
TXN0000021498,2024-10-05T13:14:46,ACC00003327,Credit,119.91,-161480.31,GBP,Walmart
TXN0000021499,2024-04-20T07:19:48,ACC00000427,ATM,560.26,-162040.57,JPY,Restaurant
TXN0000021500,2024-12-03T12:39:23,ACC00009210,Debit,605.82,-162646.39,EUR,Online Store
TXN0000021501,2024-07-11T19:13:42,ACC00005424,Transfer,1828.44,-160817.95,JPY,Starbucks
TXN0000021502,2024-12-12T08:28:59,ACC00008384,Payment,1266.89,-162084.84,GBP,Restaurant
TXN0000021503,2024-06-06T21:49:49,ACC00004426,Payment,554.43,-162639.27,EUR,Online Store
TXN0000021504,2024-10-24T08:29:13,ACC00007768,Debit,419.46,-163058.73,USD,Online Store
TXN0000021505,2024-09-12T08:00:41,ACC00005139,ATM,450.75,-163509.48,JPY,Restaurant
TXN0000021506,2024-07-09T15:55:42,ACC00003402,Transfer,1352.41,-162157.07,GBP,Restaurant
TXN0000021507,2024-08-28T11:56:41,ACC00007273,Payment,400.58,-162557.65,GBP,Grocery
TXN0000021508,2024-06-21T13:30:05,ACC00006195,Debit,171.59,-162729.24,EUR,Restaurant
TXN0000021509,2024-07-01T00:34:36,ACC00006390,Debit,701.08,-163430.32,GBP,Online Store
TXN0000021510,2024-01-25T10:31:25,ACC00002204,Credit,30.03,-163400.29,USD,Grocery
TXN0000021511,2024-03-14T11:38:52,ACC00005050,Debit,291.97,-163692.26,GBP,Restaurant
TXN0000021512,2024-05-28T00:28:13,ACC00001053,Transfer,667.04,-163025.22,USD,Starbucks
TXN0000021513,2024-01-22T05:20:22,ACC00006852,Debit,475.31,-163500.53,EUR,Amazon
TXN0000021514,2024-05-13T13:11:09,ACC00002397,Credit,692.23,-162808.3,GBP,Online Store
TXN0000021515,2024-12-11T08:43:59,ACC00003441,Debit,765.92,-163574.22,JPY,Amazon
TXN0000021516,2024-01-15T17:46:28,ACC00000554,ATM,136.04,-163710.26,GBP,Online Store
TXN0000021517,2024-03-15T07:13:00,ACC00001122,Debit,873.06,-164583.32,JPY,Target
TXN0000021518,2024-10-07T18:11:42,ACC00008219,Transfer,1074.09,-163509.23,GBP,Target
TXN0000021519,2024-11-20T09:53:55,ACC00009460,Payment,472.3,-163981.53,GBP,Target
TXN0000021520,2024-09-19T15:22:30,ACC00004986,ATM,1978.17,-165959.7,GBP,Online Store
TXN0000021521,2024-03-12T10:37:08,ACC00001755,ATM,973.71,-166933.41,JPY,Target
TXN0000021522,2024-07-08T08:08:13,ACC00002801,ATM,1165.42,-168098.83,GBP,Online Store
TXN0000021523,2024-04-23T10:00:57,ACC00004932,Debit,867.83,-168966.66,EUR,Shell
TXN0000021524,2024-02-14T14:25:10,ACC00008308,Transfer,982.96,-167983.7,GBP,Restaurant
TXN0000021525,2024-08-08T03:35:15,ACC00003371,Payment,1726.84,-169710.54,JPY,Starbucks
TXN0000021526,2024-07-17T10:59:53,ACC00001342,Transfer,288.31,-169422.23,USD,Restaurant
TXN0000021527,2024-01-14T02:06:57,ACC00003151,Payment,1095.59,-170517.82,JPY,Amazon
TXN0000021528,2024-01-27T01:09:46,ACC00001839,ATM,396.97,-170914.79,USD,Shell
TXN0000021529,2024-06-27T13:35:45,ACC00007161,Credit,1412.24,-169502.55,USD,Online Store
TXN0000021530,2024-08-29T06:49:01,ACC00001451,Credit,123.74,-169378.81,USD,Grocery
TXN0000021531,2024-06-29T07:15:31,ACC00006182,Payment,1770.43,-171149.24,GBP,Amazon
TXN0000021532,2024-11-01T17:02:43,ACC00000436,Credit,637.41,-170511.83,JPY,Amazon
TXN0000021533,2024-09-02T06:46:20,ACC00005329,Transfer,961.12,-169550.71,EUR,Online Store
TXN0000021534,2024-09-12T09:47:11,ACC00007116,Transfer,808.96,-168741.75,GBP,Online Store
TXN0000021535,2024-09-16T15:07:08,ACC00003774,ATM,1268.81,-170010.56,GBP,Shell
TXN0000021536,2024-04-30T09:31:06,ACC00005098,ATM,687.0,-170697.56,EUR,Online Store
TXN0000021537,2024-12-27T14:31:22,ACC00003823,Debit,1488.7,-172186.26,USD,Grocery
TXN0000021538,2024-01-26T22:15:34,ACC00003467,Payment,1326.65,-173512.91,USD,Grocery
TXN0000021539,2024-11-13T13:10:14,ACC00006502,Transfer,353.07,-173159.84,USD,Target
TXN0000021540,2024-09-11T08:44:59,ACC00007899,Transfer,1415.47,-171744.37,GBP,Starbucks
TXN0000021541,2024-03-07T17:24:13,ACC00006709,Transfer,303.59,-171440.78,JPY,Starbucks
TXN0000021542,2024-12-06T03:42:47,ACC00005395,Transfer,1145.79,-170294.99,GBP,Amazon
TXN0000021543,2024-04-06T15:37:04,ACC00002119,ATM,819.72,-171114.71,EUR,Grocery
TXN0000021544,2024-02-26T20:04:40,ACC00002910,Debit,436.73,-171551.44,GBP,Grocery
TXN0000021545,2024-01-12T11:17:54,ACC00006246,Credit,1849.53,-169701.91,JPY,Grocery
TXN0000021546,2024-05-05T12:34:36,ACC00002312,Credit,750.16,-168951.75,USD,Amazon
TXN0000021547,2024-08-11T21:57:01,ACC00008636,Debit,1126.39,-170078.14,GBP,Walmart
TXN0000021548,2024-03-17T23:15:55,ACC00007008,Transfer,1898.54,-168179.6,EUR,Grocery
TXN0000021549,2024-05-18T13:39:56,ACC00004217,Payment,1032.51,-169212.11,EUR,Starbucks
TXN0000021550,2024-07-16T15:30:18,ACC00007880,ATM,1908.3,-171120.41,GBP,Starbucks
TXN0000021551,2024-06-08T22:04:50,ACC00008115,Debit,644.77,-171765.18,USD,Target
TXN0000021552,2024-07-24T03:31:38,ACC00003571,Transfer,1426.15,-170339.03,GBP,Starbucks
TXN0000021553,2024-09-23T06:26:20,ACC00005520,Payment,243.93,-170582.96,EUR,Starbucks
TXN0000021554,2024-04-27T06:51:11,ACC00002663,Credit,1365.68,-169217.28,JPY,Starbucks
TXN0000021555,2024-05-25T16:47:42,ACC00008749,Credit,337.11,-168880.17,GBP,Restaurant
TXN0000021556,2024-05-23T16:38:05,ACC00000875,Debit,1444.33,-170324.5,EUR,Restaurant
TXN0000021557,2024-01-14T18:06:45,ACC00008840,Payment,1811.56,-172136.06,GBP,Online Store
TXN0000021558,2024-10-13T18:43:42,ACC00009615,Transfer,1539.16,-170596.9,JPY,Grocery
TXN0000021559,2024-06-24T10:33:52,ACC00001027,Debit,858.67,-171455.57,USD,Restaurant
TXN0000021560,2024-05-05T23:52:07,ACC00005911,Debit,260.62,-171716.19,GBP,Walmart
TXN0000021561,2024-10-29T21:22:09,ACC00006130,Transfer,1697.19,-170019.0,JPY,Walmart
TXN0000021562,2024-02-26T17:45:12,ACC00000846,Debit,388.33,-170407.33,EUR,Restaurant
TXN0000021563,2024-12-22T23:06:51,ACC00007140,Transfer,1127.82,-169279.51,EUR,Grocery
TXN0000021564,2024-09-07T21:26:49,ACC00007373,Transfer,1383.73,-167895.78,JPY,Amazon
TXN0000021565,2024-01-06T07:14:49,ACC00004358,Transfer,1509.46,-166386.32,USD,Amazon
TXN0000021566,2024-06-02T00:29:42,ACC00009211,ATM,1840.12,-168226.44,JPY,Grocery
TXN0000021567,2024-11-04T09:39:44,ACC00002328,Payment,52.7,-168279.14,EUR,Shell
TXN0000021568,2024-05-01T09:46:47,ACC00006666,Credit,583.89,-167695.25,EUR,Walmart
TXN0000021569,2024-04-23T05:07:12,ACC00000159,Payment,1940.53,-169635.78,EUR,Walmart
TXN0000021570,2024-11-05T23:19:33,ACC00000490,Transfer,1055.56,-168580.22,JPY,Online Store
TXN0000021571,2024-02-07T03:21:30,ACC00003614,ATM,1432.25,-170012.47,USD,Starbucks
TXN0000021572,2024-12-13T16:29:26,ACC00007589,Payment,1094.05,-171106.52,GBP,Amazon
TXN0000021573,2024-08-20T01:01:13,ACC00006177,Transfer,1458.86,-169647.66,JPY,Starbucks
TXN0000021574,2024-06-28T03:58:14,ACC00001198,Payment,1234.56,-170882.22,USD,Starbucks
TXN0000021575,2024-06-22T10:34:52,ACC00001192,ATM,249.09,-171131.31,GBP,Online Store
TXN0000021576,2024-12-16T01:01:21,ACC00003943,ATM,203.36,-171334.67,EUR,Starbucks
TXN0000021577,2024-02-08T22:13:28,ACC00002050,ATM,377.39,-171712.06,JPY,Amazon
TXN0000021578,2024-08-16T21:26:47,ACC00005096,Credit,35.75,-171676.31,GBP,Grocery
TXN0000021579,2024-09-04T08:14:52,ACC00001584,ATM,249.95,-171926.26,EUR,Online Store
TXN0000021580,2024-01-11T00:18:32,ACC00007042,Transfer,1066.49,-170859.77,JPY,Walmart
TXN0000021581,2024-03-25T11:07:58,ACC00002047,Transfer,1221.39,-169638.38,GBP,Starbucks
TXN0000021582,2024-06-24T06:56:10,ACC00006337,ATM,988.34,-170626.72,JPY,Shell
TXN0000021583,2024-04-29T09:23:40,ACC00005866,Debit,1269.09,-171895.81,EUR,Restaurant
TXN0000021584,2024-10-31T14:25:15,ACC00009551,Transfer,1254.36,-170641.45,GBP,Restaurant
TXN0000021585,2024-09-26T02:10:14,ACC00004124,ATM,1208.13,-171849.58,GBP,Target
TXN0000021586,2024-08-18T14:59:39,ACC00000282,Payment,1179.94,-173029.52,GBP,Online Store
TXN0000021587,2024-02-01T14:31:49,ACC00001042,Credit,92.34,-172937.18,USD,Restaurant
TXN0000021588,2024-11-28T05:48:22,ACC00006493,ATM,1156.94,-174094.12,JPY,Restaurant
TXN0000021589,2024-02-14T16:05:54,ACC00001129,ATM,752.5,-174846.62,GBP,Online Store
TXN0000021590,2024-03-21T04:58:16,ACC00004320,Transfer,876.96,-173969.66,GBP,Walmart
TXN0000021591,2024-08-24T16:15:48,ACC00001626,Payment,706.32,-174675.98,EUR,Restaurant
TXN0000021592,2024-09-20T12:56:19,ACC00006894,ATM,149.75,-174825.73,GBP,Target
TXN0000021593,2024-08-25T23:34:11,ACC00004651,ATM,1130.18,-175955.91,USD,Online Store
TXN0000021594,2024-04-17T14:50:39,ACC00000395,Debit,1812.27,-177768.18,GBP,Grocery
TXN0000021595,2024-01-18T21:20:18,ACC00002404,ATM,1398.32,-179166.5,EUR,Starbucks
TXN0000021596,2024-10-08T22:37:42,ACC00009093,Debit,572.95,-179739.45,USD,Amazon
TXN0000021597,2024-01-23T18:05:45,ACC00002565,Payment,654.8,-180394.25,USD,Amazon
TXN0000021598,2024-01-12T09:53:56,ACC00003110,Debit,518.81,-180913.06,GBP,Grocery
TXN0000021599,2024-07-25T02:56:09,ACC00006638,Transfer,1903.61,-179009.45,JPY,Grocery
TXN0000021600,2024-05-26T04:57:39,ACC00007597,Payment,763.54,-179772.99,GBP,Amazon
TXN0000021601,2024-02-13T18:24:36,ACC00008208,Transfer,1122.43,-178650.56,JPY,Amazon
TXN0000021602,2024-06-16T13:25:42,ACC00004244,ATM,495.94,-179146.5,JPY,Shell
TXN0000021603,2024-10-19T23:47:04,ACC00009488,Debit,548.91,-179695.41,EUR,Starbucks
TXN0000021604,2024-03-14T11:46:19,ACC00005293,Payment,1010.58,-180705.99,JPY,Restaurant
TXN0000021605,2024-09-12T22:28:49,ACC00004151,Credit,480.28,-180225.71,GBP,Amazon
TXN0000021606,2024-04-04T06:20:07,ACC00008887,Credit,1412.79,-178812.92,EUR,Amazon
TXN0000021607,2024-05-20T16:08:17,ACC00001108,ATM,1991.38,-180804.3,USD,Walmart
TXN0000021608,2024-09-30T21:42:28,ACC00006691,Transfer,1107.48,-179696.82,USD,Restaurant
TXN0000021609,2024-08-30T19:53:49,ACC00001219,Payment,1493.44,-181190.26,JPY,Starbucks
TXN0000021610,2024-03-25T23:09:43,ACC00007991,Payment,1735.32,-182925.58,USD,Restaurant
TXN0000021611,2024-07-03T05:23:31,ACC00001180,ATM,902.16,-183827.74,EUR,Online Store
TXN0000021612,2024-04-02T01:16:58,ACC00009258,Debit,100.73,-183928.47,JPY,Grocery
TXN0000021613,2024-08-13T12:32:38,ACC00000483,Payment,573.16,-184501.63,EUR,Starbucks
TXN0000021614,2024-09-25T23:10:17,ACC00004619,Credit,1079.13,-183422.5,USD,Restaurant
TXN0000021615,2024-04-16T03:20:14,ACC00003089,Debit,18.5,-183441.0,GBP,Walmart
TXN0000021616,2024-04-07T19:21:52,ACC00000484,Debit,1607.35,-185048.35,JPY,Target
TXN0000021617,2024-04-13T10:15:08,ACC00004155,Credit,1495.31,-183553.04,EUR,Grocery
TXN0000021618,2024-03-21T10:53:45,ACC00008142,Transfer,1659.85,-181893.19,JPY,Starbucks
TXN0000021619,2024-07-17T23:33:02,ACC00005882,Debit,1884.78,-183777.97,USD,Starbucks
TXN0000021620,2024-09-22T01:19:40,ACC00001902,Credit,1717.63,-182060.34,GBP,Grocery
TXN0000021621,2024-09-05T06:26:51,ACC00004141,Transfer,808.28,-181252.06,EUR,Grocery
TXN0000021622,2024-06-04T14:49:04,ACC00007144,Payment,1207.28,-182459.34,EUR,Restaurant
TXN0000021623,2024-02-02T07:06:25,ACC00006459,Credit,763.81,-181695.53,EUR,Online Store
TXN0000021624,2024-04-15T10:11:37,ACC00007817,Transfer,321.06,-181374.47,GBP,Restaurant
TXN0000021625,2024-03-17T06:59:00,ACC00003172,Debit,451.78,-181826.25,EUR,Grocery
TXN0000021626,2024-03-30T17:32:49,ACC00009206,ATM,275.88,-182102.13,GBP,Shell
TXN0000021627,2024-05-24T03:19:15,ACC00009684,Debit,1146.2,-183248.33,EUR,Shell
TXN0000021628,2024-11-05T05:02:48,ACC00005023,ATM,171.76,-183420.09,JPY,Grocery
TXN0000021629,2024-09-07T05:39:41,ACC00004908,Credit,1538.37,-181881.72,EUR,Grocery
TXN0000021630,2024-10-24T08:53:23,ACC00002438,ATM,1348.74,-183230.46,EUR,Walmart
TXN0000021631,2024-10-19T06:57:45,ACC00001184,ATM,810.68,-184041.14,EUR,Target
TXN0000021632,2024-01-07T12:38:36,ACC00001835,Transfer,1208.85,-182832.29,USD,Amazon
TXN0000021633,2024-09-03T23:14:50,ACC00003955,Debit,1730.18,-184562.47,USD,Amazon
TXN0000021634,2024-07-18T17:46:21,ACC00002098,Payment,1319.79,-185882.26,USD,Starbucks
TXN0000021635,2024-12-27T13:05:45,ACC00009629,Debit,1348.4,-187230.66,EUR,Target
TXN0000021636,2024-01-24T12:14:10,ACC00005304,Payment,1058.44,-188289.1,JPY,Target
TXN0000021637,2024-06-28T17:58:02,ACC00003023,Transfer,1446.85,-186842.25,USD,Target
TXN0000021638,2024-09-16T15:25:28,ACC00009758,Payment,1275.83,-188118.08,GBP,Walmart
TXN0000021639,2024-03-17T17:53:48,ACC00005051,Payment,1864.67,-189982.75,EUR,Restaurant
TXN0000021640,2024-07-06T20:44:57,ACC00005415,Payment,1922.92,-191905.67,EUR,Amazon
TXN0000021641,2024-04-04T01:25:53,ACC00008195,ATM,1642.84,-193548.51,USD,Online Store
TXN0000021642,2024-05-12T22:41:55,ACC00007810,Debit,1686.87,-195235.38,EUR,Shell
TXN0000021643,2024-02-12T04:09:36,ACC00004410,Credit,1166.17,-194069.21,EUR,Shell
TXN0000021644,2024-04-11T14:45:47,ACC00000882,Credit,381.59,-193687.62,USD,Walmart
TXN0000021645,2024-10-06T02:26:40,ACC00003734,Debit,1090.79,-194778.41,USD,Amazon
TXN0000021646,2024-01-11T20:20:45,ACC00004878,ATM,415.57,-195193.98,USD,Shell
TXN0000021647,2024-12-24T05:02:38,ACC00007889,ATM,1222.15,-196416.13,EUR,Starbucks
TXN0000021648,2024-05-04T18:16:32,ACC00005066,Payment,1320.82,-197736.95,GBP,Starbucks
TXN0000021649,2024-08-14T02:59:26,ACC00009460,Payment,1463.22,-199200.17,JPY,Walmart
TXN0000021650,2024-12-08T00:56:01,ACC00009677,Debit,186.6,-199386.77,EUR,Amazon
TXN0000021651,2024-06-07T04:11:11,ACC00007970,Transfer,853.11,-198533.66,GBP,Grocery
TXN0000021652,2024-08-19T23:52:06,ACC00001590,Credit,813.51,-197720.15,USD,Starbucks
TXN0000021653,2024-07-23T17:38:03,ACC00004339,Payment,756.08,-198476.23,EUR,Restaurant
TXN0000021654,2024-05-04T15:07:00,ACC00007960,Transfer,1104.38,-197371.85,USD,Walmart
TXN0000021655,2024-02-03T22:49:08,ACC00008296,ATM,478.3,-197850.15,EUR,Starbucks
TXN0000021656,2024-09-08T14:00:00,ACC00006913,Transfer,1291.88,-196558.27,GBP,Grocery
TXN0000021657,2024-07-17T01:14:47,ACC00003990,Credit,1922.38,-194635.89,JPY,Shell
TXN0000021658,2024-07-08T19:49:30,ACC00001275,Payment,1085.74,-195721.63,USD,Shell
TXN0000021659,2024-10-12T06:43:31,ACC00009614,Debit,850.64,-196572.27,USD,Online Store
TXN0000021660,2024-10-30T01:27:19,ACC00004929,Credit,1128.33,-195443.94,USD,Walmart
TXN0000021661,2024-02-09T06:45:12,ACC00003334,Payment,26.78,-195470.72,USD,Shell
TXN0000021662,2024-05-04T09:15:57,ACC00007509,Payment,891.4,-196362.12,USD,Restaurant
TXN0000021663,2024-11-21T15:02:14,ACC00000466,Payment,1586.23,-197948.35,EUR,Shell
TXN0000021664,2024-10-23T08:29:15,ACC00009193,ATM,1345.15,-199293.5,EUR,Shell
TXN0000021665,2024-07-01T22:49:38,ACC00007415,Credit,734.7,-198558.8,GBP,Restaurant
TXN0000021666,2024-12-17T23:59:04,ACC00006887,ATM,1085.79,-199644.59,EUR,Online Store
TXN0000021667,2024-04-10T21:31:16,ACC00008825,Transfer,1906.89,-197737.7,USD,Shell
TXN0000021668,2024-02-22T00:12:12,ACC00008206,Payment,946.03,-198683.73,EUR,Grocery
TXN0000021669,2024-01-24T18:41:37,ACC00002785,Debit,998.62,-199682.35,USD,Starbucks
TXN0000021670,2024-12-16T11:05:36,ACC00001548,Payment,668.25,-200350.6,JPY,Walmart
TXN0000021671,2024-08-08T15:50:31,ACC00007304,ATM,1615.83,-201966.43,USD,Restaurant
TXN0000021672,2024-08-01T08:06:29,ACC00000540,Payment,953.64,-202920.07,JPY,Starbucks
TXN0000021673,2024-01-21T06:27:48,ACC00001817,ATM,1862.8,-204782.87,GBP,Target
TXN0000021674,2024-09-09T19:59:30,ACC00005894,Transfer,886.19,-203896.68,GBP,Target
TXN0000021675,2024-05-31T09:21:18,ACC00000121,Debit,467.15,-204363.83,EUR,Shell
TXN0000021676,2024-04-17T08:19:07,ACC00001222,Debit,592.17,-204956.0,USD,Grocery
TXN0000021677,2024-11-19T21:01:59,ACC00007485,ATM,1991.71,-206947.71,USD,Walmart
TXN0000021678,2024-12-14T23:35:52,ACC00001409,Debit,529.46,-207477.17,JPY,Restaurant
TXN0000021679,2024-07-26T20:26:24,ACC00007240,Transfer,195.09,-207282.08,USD,Restaurant
TXN0000021680,2024-07-01T23:36:47,ACC00007842,Payment,1118.01,-208400.09,JPY,Grocery
TXN0000021681,2024-11-10T15:48:32,ACC00006805,Debit,324.34,-208724.43,GBP,Walmart
TXN0000021682,2024-07-07T09:23:11,ACC00004314,Credit,432.4,-208292.03,GBP,Restaurant
TXN0000021683,2024-06-14T19:00:15,ACC00008726,ATM,1775.55,-210067.58,JPY,Target
TXN0000021684,2024-12-08T15:07:06,ACC00004855,Credit,1649.13,-208418.45,EUR,Shell
TXN0000021685,2024-03-21T06:58:30,ACC00001079,Payment,126.08,-208544.53,EUR,Target
TXN0000021686,2024-12-28T18:15:44,ACC00004818,Transfer,920.96,-207623.57,GBP,Shell
TXN0000021687,2024-04-07T21:24:38,ACC00004178,Payment,895.16,-208518.73,JPY,Shell
TXN0000021688,2024-05-07T07:16:42,ACC00007327,Transfer,1989.28,-206529.45,JPY,Online Store
TXN0000021689,2024-07-29T04:11:02,ACC00004384,Debit,504.06,-207033.51,JPY,Shell
TXN0000021690,2024-01-30T12:58:41,ACC00008046,Credit,625.56,-206407.95,JPY,Shell
TXN0000021691,2024-07-29T22:00:12,ACC00002382,Payment,1541.56,-207949.51,USD,Starbucks
TXN0000021692,2024-05-06T06:11:28,ACC00005400,Transfer,1225.62,-206723.89,EUR,Restaurant
TXN0000021693,2024-11-18T08:18:56,ACC00006373,Credit,176.95,-206546.94,EUR,Restaurant
TXN0000021694,2024-06-01T13:48:30,ACC00003783,Debit,1663.22,-208210.16,EUR,Starbucks
TXN0000021695,2024-09-02T08:20:54,ACC00006010,Debit,1128.83,-209338.99,GBP,Target
TXN0000021696,2024-05-25T08:46:04,ACC00006901,Debit,881.79,-210220.78,USD,Grocery
TXN0000021697,2024-11-13T19:51:42,ACC00008443,Debit,17.96,-210238.74,GBP,Restaurant
TXN0000021698,2024-07-08T02:03:54,ACC00007031,Debit,340.38,-210579.12,JPY,Amazon
TXN0000021699,2024-08-30T04:27:25,ACC00008716,Debit,92.16,-210671.28,USD,Online Store
TXN0000021700,2024-08-10T15:51:21,ACC00004676,Transfer,941.33,-209729.95,EUR,Amazon
TXN0000021701,2024-03-25T10:11:45,ACC00002741,Payment,1779.54,-211509.49,GBP,Starbucks
TXN0000021702,2024-07-01T18:22:44,ACC00005278,ATM,1726.51,-213236.0,EUR,Restaurant
TXN0000021703,2024-10-28T13:12:48,ACC00008891,ATM,1464.73,-214700.73,GBP,Target
TXN0000021704,2024-01-13T13:16:12,ACC00002422,Transfer,1548.74,-213151.99,JPY,Shell
TXN0000021705,2024-10-07T08:02:59,ACC00008019,Transfer,1734.88,-211417.11,EUR,Online Store
TXN0000021706,2024-04-08T00:38:55,ACC00008259,Credit,1979.08,-209438.03,EUR,Starbucks
TXN0000021707,2024-05-11T16:26:16,ACC00009507,Transfer,693.04,-208744.99,GBP,Shell
TXN0000021708,2024-01-14T18:03:56,ACC00005155,Credit,1209.15,-207535.84,JPY,Grocery
TXN0000021709,2024-09-14T08:56:12,ACC00004602,Credit,863.29,-206672.55,GBP,Grocery
TXN0000021710,2024-04-10T16:29:01,ACC00002189,ATM,1787.69,-208460.24,EUR,Amazon
TXN0000021711,2024-05-03T08:40:25,ACC00009241,Transfer,282.46,-208177.78,JPY,Starbucks
TXN0000021712,2024-02-26T13:29:25,ACC00002929,ATM,1708.14,-209885.92,USD,Grocery
TXN0000021713,2024-05-16T12:36:12,ACC00006624,ATM,1984.12,-211870.04,EUR,Restaurant
TXN0000021714,2024-02-06T21:55:22,ACC00001867,Credit,538.39,-211331.65,USD,Walmart
TXN0000021715,2024-05-11T13:50:27,ACC00007339,Payment,1843.66,-213175.31,JPY,Online Store
TXN0000021716,2024-01-27T21:42:43,ACC00002273,ATM,791.51,-213966.82,EUR,Shell
TXN0000021717,2024-06-22T04:00:10,ACC00006188,ATM,717.53,-214684.35,EUR,Restaurant
TXN0000021718,2024-10-14T23:25:21,ACC00005990,Credit,1129.93,-213554.42,EUR,Starbucks
TXN0000021719,2024-03-18T03:25:14,ACC00004655,Credit,973.73,-212580.69,EUR,Online Store
TXN0000021720,2024-02-07T16:28:25,ACC00004023,Payment,253.13,-212833.82,EUR,Starbucks
TXN0000021721,2024-07-12T07:46:29,ACC00006731,ATM,945.27,-213779.09,EUR,Shell
TXN0000021722,2024-10-21T17:26:24,ACC00006592,Transfer,279.58,-213499.51,GBP,Shell
TXN0000021723,2024-04-13T14:07:30,ACC00002220,Debit,1385.76,-214885.27,GBP,Online Store
TXN0000021724,2024-10-19T19:24:05,ACC00008938,ATM,1409.47,-216294.74,JPY,Target
TXN0000021725,2024-10-29T18:18:10,ACC00001650,Transfer,334.54,-215960.2,GBP,Grocery
TXN0000021726,2024-09-23T06:11:32,ACC00003798,Payment,1588.76,-217548.96,GBP,Amazon
TXN0000021727,2024-10-06T03:34:15,ACC00002438,Transfer,120.74,-217428.22,USD,Restaurant
TXN0000021728,2024-05-18T09:44:17,ACC00006774,Credit,697.95,-216730.27,GBP,Grocery
TXN0000021729,2024-09-14T02:57:12,ACC00001159,Debit,1742.34,-218472.61,USD,Shell
TXN0000021730,2024-10-29T19:55:43,ACC00006123,ATM,839.41,-219312.02,EUR,Target
TXN0000021731,2024-02-09T04:37:04,ACC00003124,Debit,268.74,-219580.76,JPY,Target
TXN0000021732,2024-03-25T21:19:41,ACC00000133,Payment,1977.71,-221558.47,GBP,Target
TXN0000021733,2024-01-31T07:23:23,ACC00009043,Credit,572.61,-220985.86,EUR,Starbucks
TXN0000021734,2024-01-13T15:44:42,ACC00001002,ATM,1405.59,-222391.45,EUR,Starbucks
TXN0000021735,2024-03-16T23:19:57,ACC00001234,Transfer,379.28,-222012.17,GBP,Walmart
TXN0000021736,2024-08-09T13:57:00,ACC00006832,Debit,231.97,-222244.14,JPY,Starbucks
TXN0000021737,2024-02-21T06:59:58,ACC00007176,Debit,1408.76,-223652.9,EUR,Online Store
TXN0000021738,2024-06-04T10:07:31,ACC00000140,Transfer,449.79,-223203.11,GBP,Target
TXN0000021739,2024-04-14T00:32:46,ACC00006490,ATM,1345.76,-224548.87,EUR,Amazon
TXN0000021740,2024-08-14T20:20:50,ACC00008035,Payment,276.1,-224824.97,JPY,Restaurant
TXN0000021741,2024-09-18T08:34:24,ACC00007927,Payment,38.36,-224863.33,USD,Amazon
TXN0000021742,2024-07-23T07:46:58,ACC00002541,Transfer,936.27,-223927.06,USD,Walmart
TXN0000021743,2024-12-06T13:38:18,ACC00006989,Transfer,1640.79,-222286.27,GBP,Amazon
TXN0000021744,2024-09-20T18:16:48,ACC00006122,Payment,151.67,-222437.94,EUR,Restaurant
TXN0000021745,2024-10-24T11:31:27,ACC00004973,Payment,1306.33,-223744.27,GBP,Grocery
TXN0000021746,2024-02-01T19:05:14,ACC00006484,Transfer,637.47,-223106.8,USD,Restaurant
TXN0000021747,2024-04-11T19:52:14,ACC00008148,Payment,268.47,-223375.27,GBP,Restaurant
TXN0000021748,2024-10-14T19:36:44,ACC00005708,Payment,1920.7,-225295.97,GBP,Walmart
TXN0000021749,2024-05-10T16:47:14,ACC00007260,ATM,1415.15,-226711.12,GBP,Walmart
TXN0000021750,2024-09-24T00:35:01,ACC00005831,ATM,1450.5,-228161.62,USD,Starbucks
TXN0000021751,2024-03-28T20:05:59,ACC00005300,ATM,1354.43,-229516.05,EUR,Grocery
TXN0000021752,2024-06-24T15:21:04,ACC00004717,Debit,962.72,-230478.77,JPY,Starbucks
TXN0000021753,2024-05-30T09:43:30,ACC00001896,Debit,263.86,-230742.63,EUR,Starbucks
TXN0000021754,2024-08-22T07:11:36,ACC00003826,Debit,597.57,-231340.2,JPY,Online Store
TXN0000021755,2024-01-17T12:46:01,ACC00000892,Credit,1364.7,-229975.5,JPY,Walmart
TXN0000021756,2024-06-09T09:55:52,ACC00007699,Credit,1548.09,-228427.41,USD,Target
TXN0000021757,2024-12-18T00:05:07,ACC00009489,Credit,300.29,-228127.12,JPY,Restaurant
TXN0000021758,2024-03-17T02:03:43,ACC00005602,Credit,795.35,-227331.77,USD,Walmart
TXN0000021759,2024-07-21T15:54:14,ACC00009926,Debit,1959.92,-229291.69,USD,Grocery
TXN0000021760,2024-02-15T14:30:17,ACC00003756,Debit,462.29,-229753.98,USD,Online Store
TXN0000021761,2024-06-21T12:50:33,ACC00005695,Transfer,1521.19,-228232.79,GBP,Target
TXN0000021762,2024-09-22T08:17:17,ACC00005301,Transfer,103.7,-228129.09,EUR,Walmart
TXN0000021763,2024-12-08T16:36:55,ACC00005739,Transfer,994.59,-227134.5,GBP,Starbucks
TXN0000021764,2024-06-05T03:26:01,ACC00004455,Transfer,848.57,-226285.93,GBP,Restaurant
TXN0000021765,2024-05-17T16:27:18,ACC00008093,Debit,809.14,-227095.07,JPY,Restaurant
TXN0000021766,2024-06-07T02:13:47,ACC00003371,Credit,1005.74,-226089.33,USD,Starbucks
TXN0000021767,2024-04-01T21:29:44,ACC00005009,Payment,85.72,-226175.05,USD,Amazon
TXN0000021768,2024-03-18T17:48:56,ACC00001002,Transfer,1389.91,-224785.14,JPY,Target
TXN0000021769,2024-09-23T11:29:37,ACC00008787,Transfer,1175.04,-223610.1,GBP,Shell
TXN0000021770,2024-05-06T02:59:13,ACC00004362,ATM,283.66,-223893.76,USD,Shell
TXN0000021771,2024-05-01T22:45:33,ACC00009743,Transfer,1109.82,-222783.94,GBP,Amazon
TXN0000021772,2024-07-03T20:54:33,ACC00006960,Credit,1067.41,-221716.53,USD,Walmart
TXN0000021773,2024-12-09T04:51:06,ACC00000302,Debit,1730.86,-223447.39,JPY,Restaurant
TXN0000021774,2024-08-14T10:46:08,ACC00000923,Transfer,631.45,-222815.94,USD,Target
TXN0000021775,2024-11-19T13:38:39,ACC00006234,Transfer,773.0,-222042.94,JPY,Amazon
TXN0000021776,2024-07-30T21:38:16,ACC00004370,ATM,992.55,-223035.49,USD,Grocery
TXN0000021777,2024-01-04T01:09:18,ACC00008574,Credit,1301.08,-221734.41,JPY,Walmart
TXN0000021778,2024-01-25T11:02:00,ACC00006492,Debit,995.42,-222729.83,JPY,Starbucks
TXN0000021779,2024-03-09T08:31:57,ACC00006339,ATM,1327.53,-224057.36,GBP,Shell
TXN0000021780,2024-12-12T20:23:43,ACC00004767,Debit,148.87,-224206.23,EUR,Amazon
TXN0000021781,2024-11-28T23:01:47,ACC00003430,Transfer,144.98,-224061.25,EUR,Starbucks
TXN0000021782,2024-07-15T10:07:04,ACC00005523,ATM,1369.7,-225430.95,USD,Shell
TXN0000021783,2024-12-21T15:11:31,ACC00003108,Credit,928.0,-224502.95,JPY,Grocery
TXN0000021784,2024-12-20T07:06:04,ACC00009966,Payment,1617.95,-226120.9,USD,Shell
TXN0000021785,2024-07-04T18:58:38,ACC00001307,Debit,1975.42,-228096.32,JPY,Walmart
TXN0000021786,2024-02-10T14:26:52,ACC00008886,ATM,653.89,-228750.21,USD,Grocery
TXN0000021787,2024-11-20T19:23:56,ACC00006702,Payment,755.21,-229505.42,USD,Grocery
TXN0000021788,2024-03-08T16:08:04,ACC00006831,Payment,783.78,-230289.2,GBP,Walmart
TXN0000021789,2024-02-09T23:30:40,ACC00005080,Credit,1874.49,-228414.71,JPY,Restaurant
TXN0000021790,2024-10-23T15:51:46,ACC00002962,Transfer,1751.78,-226662.93,JPY,Restaurant
TXN0000021791,2024-01-29T22:21:59,ACC00007067,ATM,1450.19,-228113.12,GBP,Walmart
TXN0000021792,2024-09-02T08:54:42,ACC00006598,Transfer,723.22,-227389.9,GBP,Starbucks
TXN0000021793,2024-08-30T08:20:04,ACC00005026,ATM,878.72,-228268.62,EUR,Amazon
TXN0000021794,2024-01-11T08:59:13,ACC00003895,ATM,654.27,-228922.89,EUR,Online Store
TXN0000021795,2024-06-30T00:29:32,ACC00003368,Credit,1547.08,-227375.81,GBP,Online Store
TXN0000021796,2024-06-14T14:55:20,ACC00000300,Transfer,426.12,-226949.69,JPY,Online Store
TXN0000021797,2024-10-04T05:07:05,ACC00000092,Credit,682.87,-226266.82,GBP,Amazon
TXN0000021798,2024-05-01T14:31:16,ACC00005785,ATM,406.61,-226673.43,GBP,Online Store
TXN0000021799,2024-04-30T02:56:16,ACC00006081,Transfer,269.19,-226404.24,GBP,Walmart
TXN0000021800,2024-07-07T22:59:09,ACC00005017,Debit,1434.67,-227838.91,USD,Online Store
TXN0000021801,2024-12-26T20:35:29,ACC00006984,ATM,320.75,-228159.66,GBP,Target
TXN0000021802,2024-03-16T08:52:10,ACC00007084,Payment,686.92,-228846.58,JPY,Shell
TXN0000021803,2024-08-11T16:52:10,ACC00000939,ATM,195.81,-229042.39,JPY,Online Store
TXN0000021804,2024-11-09T01:55:16,ACC00009686,Transfer,1444.1,-227598.29,EUR,Amazon
TXN0000021805,2024-08-14T11:18:59,ACC00000801,Transfer,1008.24,-226590.05,USD,Online Store
TXN0000021806,2024-11-07T20:32:19,ACC00000470,Transfer,1564.0,-225026.05,GBP,Shell
TXN0000021807,2024-03-03T00:55:07,ACC00003055,Debit,1839.49,-226865.54,USD,Target
TXN0000021808,2024-11-29T04:55:23,ACC00006705,Payment,715.42,-227580.96,USD,Grocery
TXN0000021809,2024-06-23T20:47:03,ACC00008904,ATM,915.16,-228496.12,USD,Amazon
TXN0000021810,2024-02-15T23:10:03,ACC00006814,Transfer,241.01,-228255.11,EUR,Walmart
TXN0000021811,2024-01-04T16:04:41,ACC00008286,ATM,171.05,-228426.16,USD,Walmart
TXN0000021812,2024-04-14T01:19:50,ACC00005367,Credit,1744.61,-226681.55,GBP,Shell
TXN0000021813,2024-12-30T23:30:18,ACC00007670,Credit,1045.89,-225635.66,EUR,Shell
TXN0000021814,2024-11-02T16:29:58,ACC00004224,Credit,1424.18,-224211.48,GBP,Online Store
TXN0000021815,2024-11-23T18:15:47,ACC00006344,Transfer,1014.63,-223196.85,USD,Starbucks
TXN0000021816,2024-02-02T09:58:22,ACC00004044,Transfer,785.16,-222411.69,GBP,Amazon
TXN0000021817,2024-04-15T17:40:31,ACC00005416,Transfer,1246.31,-221165.38,JPY,Grocery
TXN0000021818,2024-05-29T10:26:42,ACC00006912,Debit,78.3,-221243.68,USD,Amazon
TXN0000021819,2024-04-01T11:49:45,ACC00007269,ATM,1163.74,-222407.42,USD,Starbucks
TXN0000021820,2024-12-05T04:52:26,ACC00007514,Credit,122.33,-222285.09,EUR,Grocery
TXN0000021821,2024-12-05T01:04:31,ACC00009637,ATM,316.99,-222602.08,USD,Starbucks
TXN0000021822,2024-04-15T16:55:38,ACC00001544,Debit,771.1,-223373.18,USD,Grocery
TXN0000021823,2024-12-14T16:17:24,ACC00006926,Debit,189.2,-223562.38,USD,Restaurant
TXN0000021824,2024-02-27T03:37:46,ACC00007491,Transfer,1504.35,-222058.03,USD,Target
TXN0000021825,2024-12-26T12:32:32,ACC00002188,Payment,311.76,-222369.79,JPY,Grocery
TXN0000021826,2024-11-04T07:19:15,ACC00005106,Credit,729.36,-221640.43,EUR,Restaurant
TXN0000021827,2024-02-01T19:07:19,ACC00003354,Debit,524.42,-222164.85,GBP,Grocery
TXN0000021828,2024-04-28T04:40:02,ACC00008454,Transfer,266.65,-221898.2,USD,Starbucks
TXN0000021829,2024-05-04T09:22:29,ACC00003683,Payment,822.59,-222720.79,GBP,Restaurant
TXN0000021830,2024-03-23T19:44:01,ACC00006997,Transfer,1819.1,-220901.69,GBP,Starbucks
TXN0000021831,2024-04-13T06:13:22,ACC00004692,Transfer,790.44,-220111.25,GBP,Starbucks
TXN0000021832,2024-05-21T21:22:57,ACC00000945,Payment,1269.8,-221381.05,GBP,Walmart
TXN0000021833,2024-10-19T21:36:34,ACC00000082,ATM,1462.44,-222843.49,JPY,Starbucks
TXN0000021834,2024-01-16T05:02:09,ACC00002661,Debit,1390.79,-224234.28,EUR,Amazon
TXN0000021835,2024-09-14T06:12:32,ACC00003162,Transfer,354.14,-223880.14,USD,Amazon
TXN0000021836,2024-09-10T14:51:53,ACC00007262,Transfer,1738.83,-222141.31,GBP,Grocery
TXN0000021837,2024-04-20T03:40:00,ACC00002288,Credit,879.37,-221261.94,EUR,Grocery
TXN0000021838,2024-11-11T15:16:57,ACC00000645,ATM,1191.17,-222453.11,EUR,Amazon
TXN0000021839,2024-06-23T11:47:30,ACC00000521,Debit,1203.81,-223656.92,GBP,Target
TXN0000021840,2024-10-05T21:51:38,ACC00001075,Debit,197.21,-223854.13,EUR,Starbucks
TXN0000021841,2024-05-19T14:18:18,ACC00002255,ATM,349.31,-224203.44,EUR,Grocery
TXN0000021842,2024-05-10T01:53:37,ACC00008058,Debit,573.2,-224776.64,JPY,Restaurant
TXN0000021843,2024-07-18T23:32:57,ACC00000837,Payment,970.56,-225747.2,USD,Online Store
TXN0000021844,2024-01-23T13:27:09,ACC00003103,Payment,1428.35,-227175.55,GBP,Starbucks
TXN0000021845,2024-04-18T05:58:22,ACC00005654,Transfer,75.07,-227100.48,GBP,Amazon
TXN0000021846,2024-09-04T02:03:24,ACC00009921,Debit,516.2,-227616.68,JPY,Restaurant
TXN0000021847,2024-11-13T19:24:31,ACC00005672,Payment,1294.73,-228911.41,JPY,Online Store
TXN0000021848,2024-11-02T14:03:24,ACC00001710,Payment,140.45,-229051.86,GBP,Grocery
TXN0000021849,2024-05-21T12:56:50,ACC00000819,Credit,1612.02,-227439.84,JPY,Shell
TXN0000021850,2024-09-14T00:12:40,ACC00005156,Transfer,1711.92,-225727.92,GBP,Walmart
TXN0000021851,2024-07-01T09:50:52,ACC00000023,ATM,1074.26,-226802.18,USD,Target
TXN0000021852,2024-02-27T01:56:18,ACC00006293,Debit,1243.62,-228045.8,JPY,Online Store
TXN0000021853,2024-04-06T04:36:57,ACC00003058,Transfer,798.32,-227247.48,JPY,Online Store
TXN0000021854,2024-12-12T15:15:13,ACC00000150,Credit,1399.28,-225848.2,GBP,Online Store
TXN0000021855,2024-10-04T11:13:39,ACC00006351,Payment,109.7,-225957.9,JPY,Grocery
TXN0000021856,2024-09-06T00:54:34,ACC00004175,Credit,150.22,-225807.68,EUR,Starbucks
TXN0000021857,2024-10-06T03:50:18,ACC00007836,ATM,1344.36,-227152.04,GBP,Online Store
TXN0000021858,2024-01-22T14:57:16,ACC00008142,Payment,45.97,-227198.01,GBP,Walmart
TXN0000021859,2024-02-20T20:36:04,ACC00001507,Payment,1153.91,-228351.92,GBP,Shell
TXN0000021860,2024-02-15T04:25:07,ACC00008368,Transfer,60.85,-228291.07,USD,Restaurant
TXN0000021861,2024-07-25T16:47:42,ACC00004219,Transfer,1872.35,-226418.72,JPY,Grocery
TXN0000021862,2024-01-01T18:32:13,ACC00001608,Transfer,508.86,-225909.86,JPY,Target
TXN0000021863,2024-03-25T14:26:33,ACC00001047,Debit,1200.2,-227110.06,JPY,Shell
TXN0000021864,2024-03-29T06:59:09,ACC00008247,Debit,865.47,-227975.53,GBP,Starbucks
TXN0000021865,2024-06-16T21:08:50,ACC00009412,Payment,718.18,-228693.71,GBP,Online Store
TXN0000021866,2024-03-31T19:54:33,ACC00004834,Payment,1077.07,-229770.78,EUR,Target
TXN0000021867,2024-12-10T09:08:53,ACC00004141,ATM,1226.54,-230997.32,GBP,Target
TXN0000021868,2024-11-06T21:48:18,ACC00004114,Transfer,473.73,-230523.59,JPY,Walmart
TXN0000021869,2024-05-02T23:48:15,ACC00007279,ATM,531.39,-231054.98,GBP,Target
TXN0000021870,2024-06-07T22:51:32,ACC00009081,Transfer,1177.13,-229877.85,GBP,Online Store
TXN0000021871,2024-08-05T11:53:54,ACC00002157,ATM,893.51,-230771.36,JPY,Grocery
TXN0000021872,2024-12-28T07:35:47,ACC00004329,Credit,1239.21,-229532.15,GBP,Amazon
TXN0000021873,2024-08-17T19:21:32,ACC00000508,Debit,1273.88,-230806.03,USD,Walmart
TXN0000021874,2024-04-16T09:48:24,ACC00002262,ATM,446.28,-231252.31,JPY,Restaurant
TXN0000021875,2024-06-04T06:10:42,ACC00002447,Payment,596.24,-231848.55,GBP,Amazon
TXN0000021876,2024-02-09T08:26:08,ACC00004340,Payment,1307.06,-233155.61,JPY,Online Store
TXN0000021877,2024-05-06T21:33:47,ACC00006872,Credit,480.06,-232675.55,JPY,Amazon
TXN0000021878,2024-11-07T19:51:14,ACC00008937,ATM,456.86,-233132.41,GBP,Restaurant
TXN0000021879,2024-11-06T21:23:43,ACC00002536,Debit,85.06,-233217.47,USD,Restaurant
TXN0000021880,2024-09-05T17:15:23,ACC00007015,Transfer,1354.69,-231862.78,JPY,Restaurant
TXN0000021881,2024-09-25T00:21:47,ACC00009726,ATM,1765.44,-233628.22,GBP,Restaurant
TXN0000021882,2024-01-14T07:47:34,ACC00008307,Debit,946.68,-234574.9,USD,Target
TXN0000021883,2024-08-02T07:54:10,ACC00001986,Debit,790.84,-235365.74,USD,Online Store
TXN0000021884,2024-04-30T02:58:59,ACC00000579,ATM,1024.86,-236390.6,JPY,Restaurant
TXN0000021885,2024-09-01T02:15:56,ACC00000659,Debit,1166.08,-237556.68,JPY,Restaurant
TXN0000021886,2024-09-08T22:08:22,ACC00001048,Debit,802.14,-238358.82,USD,Grocery
TXN0000021887,2024-09-19T19:51:18,ACC00007510,Transfer,1598.04,-236760.78,JPY,Amazon
TXN0000021888,2024-09-04T23:32:50,ACC00007323,Debit,456.04,-237216.82,JPY,Walmart
TXN0000021889,2024-01-23T01:05:33,ACC00007742,Payment,33.21,-237250.03,JPY,Online Store
TXN0000021890,2024-04-06T20:56:06,ACC00009670,Transfer,565.73,-236684.3,EUR,Target
TXN0000021891,2024-12-04T19:52:33,ACC00004219,Credit,956.9,-235727.4,USD,Grocery
TXN0000021892,2024-11-12T01:53:56,ACC00002399,Payment,154.03,-235881.43,EUR,Online Store
TXN0000021893,2024-01-08T00:42:13,ACC00000307,Transfer,1922.04,-233959.39,JPY,Target
TXN0000021894,2024-06-21T05:25:24,ACC00004575,ATM,1001.98,-234961.37,USD,Target
TXN0000021895,2024-03-25T16:49:56,ACC00009344,Transfer,1955.81,-233005.56,JPY,Online Store
TXN0000021896,2024-03-18T18:56:07,ACC00008010,Payment,613.22,-233618.78,EUR,Target
TXN0000021897,2024-06-16T18:59:17,ACC00004177,Credit,1253.66,-232365.12,EUR,Restaurant
TXN0000021898,2024-02-02T21:54:08,ACC00004865,Debit,1633.02,-233998.14,USD,Target
TXN0000021899,2024-01-04T11:27:22,ACC00008535,Debit,977.37,-234975.51,GBP,Target
TXN0000021900,2024-12-04T07:07:00,ACC00007819,Transfer,468.46,-234507.05,JPY,Grocery
TXN0000021901,2024-10-11T05:27:35,ACC00003421,Transfer,1224.6,-233282.45,USD,Shell
TXN0000021902,2024-03-08T00:04:56,ACC00008755,Credit,1869.27,-231413.18,JPY,Restaurant
TXN0000021903,2024-04-20T02:57:20,ACC00000104,ATM,268.14,-231681.32,JPY,Online Store
TXN0000021904,2024-10-29T22:45:53,ACC00004605,ATM,92.01,-231773.33,GBP,Target
TXN0000021905,2024-09-04T16:11:22,ACC00002178,Credit,362.0,-231411.33,EUR,Starbucks
TXN0000021906,2024-11-19T10:51:45,ACC00001611,ATM,534.31,-231945.64,GBP,Online Store
TXN0000021907,2024-05-07T02:16:08,ACC00008472,Credit,1336.17,-230609.47,EUR,Target
TXN0000021908,2024-10-26T03:07:17,ACC00007227,Payment,152.43,-230761.9,GBP,Starbucks
TXN0000021909,2024-12-10T07:11:03,ACC00003498,Payment,899.17,-231661.07,USD,Shell
TXN0000021910,2024-07-28T20:01:28,ACC00001725,Payment,1480.41,-233141.48,GBP,Restaurant
TXN0000021911,2024-05-13T21:35:50,ACC00007722,Payment,201.04,-233342.52,EUR,Amazon
TXN0000021912,2024-10-03T04:57:37,ACC00006954,Debit,1273.79,-234616.31,USD,Amazon
TXN0000021913,2024-04-14T09:20:24,ACC00001483,Debit,648.97,-235265.28,EUR,Online Store
TXN0000021914,2024-10-25T21:05:42,ACC00000658,Transfer,1536.8,-233728.48,EUR,Amazon
TXN0000021915,2024-03-18T20:56:14,ACC00009008,Payment,886.96,-234615.44,EUR,Starbucks
TXN0000021916,2024-01-14T09:51:46,ACC00004990,ATM,373.41,-234988.85,USD,Amazon
TXN0000021917,2024-07-21T18:54:53,ACC00007936,Payment,528.33,-235517.18,EUR,Grocery
TXN0000021918,2024-07-21T04:38:13,ACC00004139,ATM,1164.42,-236681.6,GBP,Grocery
TXN0000021919,2024-10-04T16:26:37,ACC00000081,Transfer,92.81,-236588.79,USD,Grocery
TXN0000021920,2024-04-09T12:49:04,ACC00002233,Credit,727.52,-235861.27,JPY,Restaurant
TXN0000021921,2024-05-28T07:23:21,ACC00003433,Credit,1227.7,-234633.57,EUR,Grocery
TXN0000021922,2024-05-25T15:56:23,ACC00005639,Credit,1083.85,-233549.72,USD,Online Store
TXN0000021923,2024-11-06T07:47:50,ACC00008329,Credit,1417.62,-232132.1,JPY,Online Store
TXN0000021924,2024-02-23T04:39:51,ACC00004063,Credit,803.07,-231329.03,EUR,Online Store
TXN0000021925,2024-01-27T07:06:51,ACC00003918,Credit,561.28,-230767.75,GBP,Walmart
TXN0000021926,2024-02-12T06:04:29,ACC00002992,Transfer,1583.46,-229184.29,EUR,Shell
TXN0000021927,2024-10-28T01:39:55,ACC00005469,Payment,347.77,-229532.06,JPY,Shell
TXN0000021928,2024-05-20T19:03:19,ACC00001567,Debit,1524.58,-231056.64,EUR,Grocery
TXN0000021929,2024-03-24T03:04:07,ACC00005357,Debit,37.02,-231093.66,GBP,Shell
TXN0000021930,2024-02-10T16:23:51,ACC00004255,Transfer,665.23,-230428.43,JPY,Starbucks
TXN0000021931,2024-09-18T13:04:37,ACC00008536,Payment,201.97,-230630.4,GBP,Amazon
TXN0000021932,2024-06-08T18:58:46,ACC00006548,Credit,1460.58,-229169.82,USD,Restaurant
TXN0000021933,2024-04-09T20:27:12,ACC00000803,ATM,167.01,-229336.83,GBP,Online Store
TXN0000021934,2024-02-26T05:26:37,ACC00008476,Credit,405.28,-228931.55,GBP,Shell
TXN0000021935,2024-03-13T10:16:46,ACC00008984,Credit,1479.41,-227452.14,USD,Online Store
TXN0000021936,2024-05-07T08:18:35,ACC00001156,Payment,1104.31,-228556.45,GBP,Starbucks
TXN0000021937,2024-06-06T15:56:18,ACC00001207,Payment,413.21,-228969.66,GBP,Grocery
TXN0000021938,2024-06-12T14:01:45,ACC00009961,ATM,128.19,-229097.85,JPY,Shell
TXN0000021939,2024-01-16T07:04:12,ACC00003987,ATM,241.75,-229339.6,JPY,Shell
TXN0000021940,2024-01-29T09:51:10,ACC00000650,Payment,978.49,-230318.09,GBP,Grocery
TXN0000021941,2024-06-12T01:02:46,ACC00000537,Credit,1028.31,-229289.78,USD,Amazon
TXN0000021942,2024-12-18T20:20:40,ACC00007550,ATM,596.04,-229885.82,GBP,Shell
TXN0000021943,2024-08-21T15:44:29,ACC00005712,Transfer,589.88,-229295.94,JPY,Starbucks
TXN0000021944,2024-03-06T05:15:54,ACC00008111,ATM,1807.85,-231103.79,GBP,Shell
TXN0000021945,2024-02-23T00:10:03,ACC00009531,Payment,733.56,-231837.35,EUR,Grocery
TXN0000021946,2024-10-03T05:57:51,ACC00003221,Credit,1224.34,-230613.01,JPY,Shell
TXN0000021947,2024-07-18T01:43:34,ACC00005719,Credit,1887.69,-228725.32,JPY,Walmart
TXN0000021948,2024-08-18T04:44:33,ACC00008434,Credit,910.21,-227815.11,JPY,Grocery
TXN0000021949,2024-10-16T23:13:53,ACC00003129,Payment,162.82,-227977.93,GBP,Grocery
TXN0000021950,2024-06-22T12:22:03,ACC00008256,Debit,1979.22,-229957.15,JPY,Shell
TXN0000021951,2024-11-26T19:55:50,ACC00005886,ATM,1500.12,-231457.27,EUR,Shell
TXN0000021952,2024-09-10T02:10:33,ACC00008570,Debit,1763.76,-233221.03,JPY,Target
TXN0000021953,2024-07-09T17:52:44,ACC00001682,Payment,973.47,-234194.5,USD,Restaurant
TXN0000021954,2024-03-14T09:14:05,ACC00000024,Transfer,514.65,-233679.85,EUR,Target
TXN0000021955,2024-08-09T12:38:27,ACC00007203,ATM,470.51,-234150.36,JPY,Grocery
TXN0000021956,2024-01-10T14:47:22,ACC00009285,Credit,1098.31,-233052.05,USD,Amazon
TXN0000021957,2024-01-31T08:26:08,ACC00005487,Credit,1810.44,-231241.61,EUR,Walmart
TXN0000021958,2024-01-29T04:25:16,ACC00001754,ATM,838.16,-232079.77,EUR,Starbucks
TXN0000021959,2024-12-05T13:14:12,ACC00008638,Debit,522.65,-232602.42,JPY,Online Store
TXN0000021960,2024-07-16T14:41:07,ACC00003470,ATM,1865.03,-234467.45,EUR,Online Store
TXN0000021961,2024-10-22T08:44:50,ACC00005834,ATM,1079.69,-235547.14,EUR,Amazon
TXN0000021962,2024-07-09T23:52:04,ACC00002034,ATM,1163.98,-236711.12,USD,Restaurant
TXN0000021963,2024-07-27T08:05:06,ACC00006421,Transfer,1290.87,-235420.25,USD,Starbucks
TXN0000021964,2024-03-27T04:58:54,ACC00000724,Debit,1533.35,-236953.6,EUR,Walmart
TXN0000021965,2024-01-26T00:09:39,ACC00003056,Debit,843.91,-237797.51,EUR,Online Store
TXN0000021966,2024-09-28T18:51:33,ACC00001584,Payment,1695.54,-239493.05,USD,Grocery
TXN0000021967,2024-09-05T01:39:58,ACC00002994,Transfer,545.43,-238947.62,JPY,Target
TXN0000021968,2024-08-11T20:16:29,ACC00001753,Debit,222.93,-239170.55,USD,Walmart
TXN0000021969,2024-03-20T03:32:42,ACC00007803,Debit,1721.12,-240891.67,GBP,Amazon
TXN0000021970,2024-07-09T18:54:29,ACC00002606,Transfer,1929.99,-238961.68,USD,Grocery
TXN0000021971,2024-09-12T00:50:36,ACC00002368,Transfer,1419.8,-237541.88,GBP,Starbucks
TXN0000021972,2024-08-18T15:18:32,ACC00006353,Payment,845.9,-238387.78,JPY,Restaurant
TXN0000021973,2024-07-21T13:01:51,ACC00005448,ATM,1534.55,-239922.33,EUR,Grocery
TXN0000021974,2024-07-03T16:55:20,ACC00006869,ATM,1008.28,-240930.61,GBP,Target
TXN0000021975,2024-06-14T10:10:22,ACC00000634,Transfer,1013.89,-239916.72,JPY,Grocery
TXN0000021976,2024-10-27T20:26:53,ACC00008245,Debit,1185.41,-241102.13,EUR,Restaurant
TXN0000021977,2024-09-07T16:15:09,ACC00007098,Payment,1453.12,-242555.25,EUR,Shell
TXN0000021978,2024-01-04T04:54:39,ACC00009889,ATM,898.52,-243453.77,JPY,Walmart
TXN0000021979,2024-05-18T07:43:57,ACC00005406,Transfer,237.49,-243216.28,EUR,Amazon
TXN0000021980,2024-03-28T00:07:28,ACC00005298,Payment,861.96,-244078.24,EUR,Shell
TXN0000021981,2024-12-25T12:48:14,ACC00004054,Debit,596.92,-244675.16,EUR,Target
TXN0000021982,2024-09-11T17:49:05,ACC00000207,Transfer,611.38,-244063.78,JPY,Amazon
TXN0000021983,2024-02-13T18:32:18,ACC00006409,Transfer,522.63,-243541.15,EUR,Starbucks
TXN0000021984,2024-04-02T19:31:10,ACC00006411,Payment,974.4,-244515.55,GBP,Shell
TXN0000021985,2024-09-07T15:41:51,ACC00002428,Transfer,496.23,-244019.32,JPY,Starbucks
TXN0000021986,2024-05-02T02:32:55,ACC00000591,ATM,1230.71,-245250.03,USD,Starbucks
TXN0000021987,2024-09-24T04:44:49,ACC00001408,Transfer,875.91,-244374.12,JPY,Target
TXN0000021988,2024-04-20T05:24:01,ACC00009656,Transfer,405.13,-243968.99,USD,Online Store
TXN0000021989,2024-12-10T12:28:46,ACC00003877,Debit,1354.38,-245323.37,EUR,Target
TXN0000021990,2024-09-11T00:40:26,ACC00001119,Debit,968.05,-246291.42,EUR,Restaurant
TXN0000021991,2024-06-19T22:19:30,ACC00003817,Credit,36.58,-246254.84,GBP,Restaurant
TXN0000021992,2024-05-24T02:44:48,ACC00005178,Debit,99.13,-246353.97,USD,Restaurant
TXN0000021993,2024-11-08T06:04:18,ACC00002243,Debit,1267.91,-247621.88,EUR,Grocery
TXN0000021994,2024-05-16T04:46:57,ACC00003621,Payment,57.05,-247678.93,JPY,Online Store
TXN0000021995,2024-03-22T13:41:58,ACC00001937,Transfer,728.32,-246950.61,EUR,Starbucks
TXN0000021996,2024-04-24T17:34:31,ACC00009778,Payment,1244.64,-248195.25,EUR,Grocery
TXN0000021997,2024-06-16T06:19:36,ACC00003415,Credit,1799.64,-246395.61,JPY,Target
TXN0000021998,2024-08-21T01:22:16,ACC00008585,Transfer,350.6,-246045.01,USD,Target
TXN0000021999,2024-01-30T15:31:07,ACC00006921,Transfer,363.94,-245681.07,EUR,Amazon
TXN0000022000,2024-02-14T09:58:39,ACC00000660,ATM,1291.5,-246972.57,USD,Target
TXN0000022001,2024-08-21T02:01:32,ACC00008618,Debit,1894.6,-248867.17,JPY,Starbucks
TXN0000022002,2024-10-06T12:58:38,ACC00003146,Credit,810.3,-248056.87,EUR,Walmart
TXN0000022003,2024-10-10T14:01:33,ACC00004994,Transfer,512.21,-247544.66,EUR,Grocery
TXN0000022004,2024-05-21T01:28:09,ACC00006539,Debit,980.17,-248524.83,EUR,Online Store
TXN0000022005,2024-05-11T21:38:57,ACC00006917,Debit,323.32,-248848.15,USD,Starbucks
TXN0000022006,2024-09-04T21:19:28,ACC00004028,Credit,1530.48,-247317.67,GBP,Restaurant
TXN0000022007,2024-10-28T21:48:08,ACC00008467,ATM,913.53,-248231.2,JPY,Target
TXN0000022008,2024-01-02T12:06:50,ACC00005647,Credit,1288.37,-246942.83,GBP,Shell
TXN0000022009,2024-12-12T09:31:52,ACC00007430,Payment,1153.06,-248095.89,JPY,Target
TXN0000022010,2024-05-01T20:16:05,ACC00006196,Transfer,1682.14,-246413.75,USD,Target
TXN0000022011,2024-06-28T22:52:17,ACC00009679,Credit,656.03,-245757.72,EUR,Starbucks
TXN0000022012,2024-01-11T12:18:09,ACC00007057,ATM,1229.81,-246987.53,GBP,Starbucks
TXN0000022013,2024-07-22T15:05:57,ACC00005685,Debit,1250.86,-248238.39,JPY,Amazon
TXN0000022014,2024-05-18T23:49:09,ACC00003522,Debit,840.23,-249078.62,USD,Grocery
TXN0000022015,2024-04-15T10:09:39,ACC00006811,ATM,1701.62,-250780.24,EUR,Amazon
TXN0000022016,2024-02-15T22:01:59,ACC00000849,Transfer,1486.67,-249293.57,EUR,Starbucks
TXN0000022017,2024-11-01T12:21:46,ACC00008817,Credit,808.09,-248485.48,JPY,Online Store
TXN0000022018,2024-06-08T20:45:38,ACC00005733,Transfer,1339.24,-247146.24,GBP,Shell
TXN0000022019,2024-12-13T11:59:43,ACC00002523,Payment,1303.63,-248449.87,EUR,Online Store
TXN0000022020,2024-05-02T03:46:07,ACC00009118,Debit,1174.84,-249624.71,EUR,Walmart
TXN0000022021,2024-12-27T11:10:53,ACC00001108,Payment,1312.32,-250937.03,JPY,Target
TXN0000022022,2024-09-03T06:56:31,ACC00006238,Payment,745.54,-251682.57,GBP,Amazon
TXN0000022023,2024-12-21T06:43:17,ACC00002792,Debit,1433.74,-253116.31,EUR,Amazon
TXN0000022024,2024-06-09T16:10:09,ACC00001069,Transfer,438.02,-252678.29,GBP,Target
TXN0000022025,2024-06-14T15:40:53,ACC00001076,ATM,1936.97,-254615.26,USD,Starbucks
TXN0000022026,2024-08-15T03:46:40,ACC00006971,Credit,73.66,-254541.6,GBP,Grocery
TXN0000022027,2024-03-28T06:54:07,ACC00003427,Transfer,1748.12,-252793.48,GBP,Online Store
TXN0000022028,2024-05-21T08:10:33,ACC00006380,ATM,1488.18,-254281.66,GBP,Target
TXN0000022029,2024-05-26T23:49:57,ACC00009374,Debit,1058.86,-255340.52,JPY,Amazon
TXN0000022030,2024-10-29T12:48:49,ACC00003939,Credit,732.52,-254608.0,JPY,Starbucks
TXN0000022031,2024-02-03T09:05:53,ACC00001475,Transfer,1042.62,-253565.38,EUR,Online Store
TXN0000022032,2024-04-11T14:46:06,ACC00003491,Transfer,228.21,-253337.17,GBP,Walmart
TXN0000022033,2024-01-22T13:58:42,ACC00006261,Debit,1640.84,-254978.01,EUR,Walmart
TXN0000022034,2024-01-02T08:16:51,ACC00005983,Payment,62.03,-255040.04,GBP,Restaurant
TXN0000022035,2024-08-06T06:15:03,ACC00007778,Credit,1623.03,-253417.01,GBP,Grocery
TXN0000022036,2024-07-20T11:17:54,ACC00007300,Payment,621.48,-254038.49,USD,Online Store
TXN0000022037,2024-02-03T06:46:40,ACC00008474,Debit,1107.69,-255146.18,GBP,Online Store
TXN0000022038,2024-05-31T01:20:58,ACC00001014,Debit,134.69,-255280.87,JPY,Walmart
TXN0000022039,2024-08-28T09:23:51,ACC00007387,ATM,1903.95,-257184.82,GBP,Starbucks
TXN0000022040,2024-06-27T10:05:47,ACC00004754,ATM,1381.74,-258566.56,EUR,Starbucks
TXN0000022041,2024-10-06T11:01:55,ACC00008828,Debit,131.72,-258698.28,JPY,Walmart
TXN0000022042,2024-12-07T05:45:38,ACC00001502,ATM,432.94,-259131.22,GBP,Restaurant
TXN0000022043,2024-07-17T05:10:45,ACC00009041,Payment,1145.23,-260276.45,EUR,Amazon
TXN0000022044,2024-03-11T21:30:58,ACC00000608,Payment,1780.84,-262057.29,GBP,Online Store
TXN0000022045,2024-09-14T08:05:46,ACC00007744,ATM,1593.33,-263650.62,GBP,Shell
TXN0000022046,2024-08-27T01:35:41,ACC00004465,Credit,1825.07,-261825.55,GBP,Restaurant
TXN0000022047,2024-02-05T00:03:22,ACC00006361,Debit,124.95,-261950.5,EUR,Target
TXN0000022048,2024-11-05T00:49:58,ACC00001653,ATM,1254.63,-263205.13,EUR,Amazon
TXN0000022049,2024-12-24T07:56:05,ACC00004432,Credit,875.08,-262330.05,GBP,Amazon
TXN0000022050,2024-03-08T08:21:04,ACC00006242,Credit,1845.55,-260484.5,JPY,Restaurant
TXN0000022051,2024-05-08T16:46:14,ACC00007177,Credit,818.17,-259666.33,JPY,Online Store
TXN0000022052,2024-10-31T19:12:55,ACC00004198,Debit,676.63,-260342.96,GBP,Restaurant
TXN0000022053,2024-12-11T20:10:58,ACC00003311,Debit,1635.44,-261978.4,JPY,Online Store
TXN0000022054,2024-08-31T18:35:36,ACC00001621,Transfer,1607.51,-260370.89,GBP,Target
TXN0000022055,2024-07-02T14:16:01,ACC00007442,Payment,1257.56,-261628.45,GBP,Starbucks
TXN0000022056,2024-06-24T10:21:16,ACC00002410,Debit,1556.32,-263184.77,JPY,Restaurant
TXN0000022057,2024-07-20T15:25:12,ACC00002481,Credit,916.72,-262268.05,JPY,Target
TXN0000022058,2024-11-23T16:57:01,ACC00007348,Debit,1681.95,-263950.0,GBP,Shell
TXN0000022059,2024-01-27T22:58:04,ACC00008927,Credit,1637.24,-262312.76,USD,Restaurant
TXN0000022060,2024-02-24T04:51:27,ACC00007913,ATM,1922.92,-264235.68,USD,Shell
TXN0000022061,2024-04-21T03:19:42,ACC00006540,Transfer,344.94,-263890.74,USD,Online Store
TXN0000022062,2024-07-10T14:07:29,ACC00007533,Payment,290.75,-264181.49,EUR,Amazon
TXN0000022063,2024-06-15T00:45:52,ACC00002809,Debit,429.97,-264611.46,GBP,Restaurant
TXN0000022064,2024-03-29T00:56:21,ACC00004003,Transfer,579.94,-264031.52,EUR,Shell
TXN0000022065,2024-02-01T15:12:45,ACC00007128,Credit,745.32,-263286.2,JPY,Online Store
TXN0000022066,2024-06-29T02:33:25,ACC00007008,Payment,1498.63,-264784.83,JPY,Online Store
TXN0000022067,2024-08-24T11:49:03,ACC00004334,Credit,1941.28,-262843.55,JPY,Restaurant
TXN0000022068,2024-08-23T18:48:55,ACC00007934,Credit,897.05,-261946.5,JPY,Restaurant
TXN0000022069,2024-04-23T19:11:01,ACC00004448,Credit,1834.15,-260112.35,GBP,Starbucks
TXN0000022070,2024-08-25T09:06:10,ACC00006201,Payment,1508.22,-261620.57,JPY,Online Store
TXN0000022071,2024-03-09T22:36:13,ACC00006493,Transfer,1326.75,-260293.82,JPY,Walmart
TXN0000022072,2024-04-26T10:48:48,ACC00002927,Transfer,513.94,-259779.88,GBP,Amazon
TXN0000022073,2024-02-06T13:02:36,ACC00005147,Payment,1192.49,-260972.37,EUR,Shell
TXN0000022074,2024-10-29T17:18:24,ACC00000196,Payment,1047.82,-262020.19,JPY,Restaurant
TXN0000022075,2024-08-26T10:23:18,ACC00006579,ATM,1563.51,-263583.7,JPY,Target
TXN0000022076,2024-05-25T01:28:24,ACC00009104,Transfer,1427.74,-262155.96,USD,Online Store
TXN0000022077,2024-12-20T21:56:22,ACC00004351,Credit,838.66,-261317.3,GBP,Walmart
TXN0000022078,2024-11-26T09:38:36,ACC00009772,Credit,104.98,-261212.32,USD,Shell
TXN0000022079,2024-03-19T01:08:48,ACC00003174,Debit,1050.6,-262262.92,JPY,Starbucks
TXN0000022080,2024-10-31T22:03:03,ACC00005873,Credit,11.56,-262251.36,JPY,Starbucks
TXN0000022081,2024-02-09T00:50:15,ACC00002083,ATM,275.16,-262526.52,USD,Walmart
TXN0000022082,2024-11-17T06:50:53,ACC00008617,Payment,664.66,-263191.18,GBP,Target
TXN0000022083,2024-08-20T18:49:31,ACC00002209,Credit,1958.88,-261232.3,GBP,Starbucks
TXN0000022084,2024-08-15T01:38:29,ACC00006032,Debit,105.59,-261337.89,EUR,Restaurant
TXN0000022085,2024-03-13T06:27:04,ACC00000102,Debit,189.84,-261527.73,EUR,Walmart
TXN0000022086,2024-03-12T11:38:48,ACC00007296,ATM,1765.78,-263293.51,JPY,Starbucks
TXN0000022087,2024-08-24T11:28:08,ACC00005531,ATM,1716.49,-265010.0,USD,Shell
TXN0000022088,2024-06-15T03:25:38,ACC00000818,Payment,1572.38,-266582.38,EUR,Shell
TXN0000022089,2024-01-16T15:36:13,ACC00009565,Debit,956.15,-267538.53,USD,Restaurant
TXN0000022090,2024-09-11T01:52:54,ACC00005856,Credit,47.43,-267491.1,USD,Online Store
TXN0000022091,2024-06-30T10:38:55,ACC00004306,Debit,25.71,-267516.81,GBP,Amazon
TXN0000022092,2024-06-21T14:14:57,ACC00003519,Credit,1729.02,-265787.79,EUR,Restaurant
TXN0000022093,2024-07-06T00:17:22,ACC00004467,Credit,601.26,-265186.53,GBP,Shell
TXN0000022094,2024-10-23T10:20:17,ACC00007571,Credit,392.67,-264793.86,USD,Grocery
TXN0000022095,2024-10-06T08:04:09,ACC00003518,Payment,1082.06,-265875.92,EUR,Amazon
TXN0000022096,2024-05-23T03:42:29,ACC00005589,Debit,151.16,-266027.08,USD,Online Store
TXN0000022097,2024-06-09T05:59:49,ACC00000588,Transfer,209.42,-265817.66,EUR,Walmart
TXN0000022098,2024-01-17T12:30:05,ACC00003461,ATM,1653.7,-267471.36,EUR,Target
TXN0000022099,2024-02-12T07:21:23,ACC00003545,Debit,1441.35,-268912.71,GBP,Grocery
TXN0000022100,2024-03-09T12:06:15,ACC00000598,Transfer,143.27,-268769.44,JPY,Online Store
TXN0000022101,2024-08-26T10:05:29,ACC00006773,ATM,540.02,-269309.46,USD,Walmart
TXN0000022102,2024-01-05T05:22:26,ACC00000864,Transfer,286.49,-269022.97,JPY,Amazon
TXN0000022103,2024-02-15T08:41:36,ACC00003280,Transfer,1646.88,-267376.09,GBP,Target
TXN0000022104,2024-06-14T18:46:44,ACC00006743,Transfer,1103.56,-266272.53,GBP,Starbucks
TXN0000022105,2024-04-07T02:37:31,ACC00005076,ATM,83.49,-266356.02,USD,Shell
TXN0000022106,2024-06-20T16:24:02,ACC00003962,ATM,191.49,-266547.51,EUR,Amazon
TXN0000022107,2024-07-01T08:15:10,ACC00006759,Transfer,188.2,-266359.31,EUR,Target
TXN0000022108,2024-01-13T06:17:33,ACC00001727,Transfer,1736.43,-264622.88,EUR,Walmart
TXN0000022109,2024-04-24T12:08:19,ACC00004921,Credit,1230.83,-263392.05,JPY,Restaurant
TXN0000022110,2024-07-16T14:25:34,ACC00006408,Debit,1954.76,-265346.81,JPY,Online Store
TXN0000022111,2024-04-29T14:33:19,ACC00005726,Debit,1669.82,-267016.63,EUR,Walmart
TXN0000022112,2024-08-11T19:33:52,ACC00001061,Transfer,1311.61,-265705.02,USD,Walmart
TXN0000022113,2024-11-29T00:17:51,ACC00005967,Transfer,417.06,-265287.96,GBP,Online Store
TXN0000022114,2024-04-21T16:39:20,ACC00005220,Payment,1828.53,-267116.49,GBP,Target
TXN0000022115,2024-12-05T23:03:12,ACC00008240,ATM,497.77,-267614.26,EUR,Online Store
TXN0000022116,2024-02-05T23:47:09,ACC00003817,Credit,1080.68,-266533.58,GBP,Target
TXN0000022117,2024-04-24T21:10:06,ACC00008873,Transfer,1130.9,-265402.68,JPY,Starbucks
TXN0000022118,2024-10-15T23:30:16,ACC00002649,Credit,935.84,-264466.84,GBP,Target
TXN0000022119,2024-01-07T09:28:25,ACC00008934,ATM,1991.8,-266458.64,USD,Shell
TXN0000022120,2024-12-24T06:59:06,ACC00006213,Credit,1228.09,-265230.55,EUR,Restaurant
TXN0000022121,2024-11-29T13:42:50,ACC00005596,ATM,305.68,-265536.23,GBP,Restaurant
TXN0000022122,2024-10-27T17:06:06,ACC00004594,Transfer,638.29,-264897.94,EUR,Restaurant
TXN0000022123,2024-05-10T20:53:58,ACC00008376,Transfer,543.86,-264354.08,USD,Walmart
TXN0000022124,2024-09-03T02:09:34,ACC00006380,Payment,890.78,-265244.86,GBP,Amazon
TXN0000022125,2024-05-19T15:34:13,ACC00009119,ATM,1872.97,-267117.83,GBP,Target
TXN0000022126,2024-03-24T02:21:27,ACC00009221,Payment,694.29,-267812.12,GBP,Grocery
TXN0000022127,2024-11-20T15:35:55,ACC00007269,Credit,1597.55,-266214.57,EUR,Starbucks
TXN0000022128,2024-04-24T00:13:26,ACC00000414,Debit,1807.65,-268022.22,USD,Grocery
TXN0000022129,2024-09-09T04:45:29,ACC00001438,Payment,1344.55,-269366.77,JPY,Restaurant
TXN0000022130,2024-05-08T10:42:08,ACC00000354,Transfer,660.16,-268706.61,EUR,Target
TXN0000022131,2024-01-17T23:02:25,ACC00007642,Credit,467.57,-268239.04,EUR,Walmart
TXN0000022132,2024-11-06T20:15:18,ACC00001296,Debit,520.51,-268759.55,JPY,Shell
TXN0000022133,2024-11-26T20:53:09,ACC00001125,Payment,632.08,-269391.63,JPY,Target
TXN0000022134,2024-08-31T06:25:40,ACC00005778,Transfer,257.82,-269133.81,USD,Starbucks
TXN0000022135,2024-06-26T03:50:32,ACC00007194,Payment,1471.68,-270605.49,JPY,Restaurant
TXN0000022136,2024-11-05T08:03:16,ACC00001862,Payment,1689.04,-272294.53,EUR,Walmart
TXN0000022137,2024-09-22T04:13:48,ACC00006302,ATM,769.19,-273063.72,EUR,Restaurant
TXN0000022138,2024-03-23T07:32:31,ACC00004118,Payment,1890.29,-274954.01,USD,Shell
TXN0000022139,2024-02-15T09:37:25,ACC00006844,Payment,239.18,-275193.19,GBP,Online Store
TXN0000022140,2024-06-14T09:31:45,ACC00002517,Payment,1629.7,-276822.89,USD,Online Store
TXN0000022141,2024-02-06T08:23:11,ACC00000147,Payment,640.53,-277463.42,JPY,Amazon
TXN0000022142,2024-09-18T23:12:38,ACC00009282,ATM,1935.77,-279399.19,EUR,Starbucks
TXN0000022143,2024-01-02T00:18:13,ACC00003673,Transfer,1047.63,-278351.56,USD,Starbucks
TXN0000022144,2024-11-04T09:13:46,ACC00009296,Payment,548.31,-278899.87,GBP,Shell
TXN0000022145,2024-10-18T07:23:01,ACC00002373,Transfer,1155.73,-277744.14,JPY,Restaurant
TXN0000022146,2024-01-06T17:25:40,ACC00005061,Payment,1573.54,-279317.68,USD,Starbucks
TXN0000022147,2024-08-19T18:20:13,ACC00004839,ATM,322.72,-279640.4,GBP,Target
TXN0000022148,2024-08-01T04:21:38,ACC00001007,Credit,644.02,-278996.38,EUR,Starbucks
TXN0000022149,2024-07-01T00:31:14,ACC00000805,Debit,812.19,-279808.57,EUR,Grocery
TXN0000022150,2024-08-24T17:48:00,ACC00007251,Transfer,1614.61,-278193.96,GBP,Restaurant
TXN0000022151,2024-06-06T23:00:51,ACC00009598,Transfer,588.84,-277605.12,USD,Grocery
TXN0000022152,2024-01-30T13:33:40,ACC00001080,ATM,1917.62,-279522.74,JPY,Grocery
TXN0000022153,2024-05-29T23:56:53,ACC00007664,Credit,781.17,-278741.57,GBP,Shell
TXN0000022154,2024-02-16T23:07:05,ACC00008269,Payment,1918.23,-280659.8,USD,Target
TXN0000022155,2024-02-27T20:12:47,ACC00008218,Transfer,1288.56,-279371.24,JPY,Walmart
TXN0000022156,2024-12-12T10:51:49,ACC00006443,Debit,1213.04,-280584.28,EUR,Target
TXN0000022157,2024-06-05T20:08:16,ACC00002717,Transfer,72.0,-280512.28,GBP,Restaurant
TXN0000022158,2024-12-21T19:57:29,ACC00005810,Credit,157.23,-280355.05,JPY,Amazon
TXN0000022159,2024-11-17T06:27:14,ACC00008565,Credit,1394.37,-278960.68,JPY,Walmart
TXN0000022160,2024-08-02T04:02:52,ACC00003041,Debit,474.01,-279434.69,EUR,Starbucks
TXN0000022161,2024-03-08T08:38:19,ACC00002457,Debit,827.47,-280262.16,USD,Online Store
TXN0000022162,2024-06-20T18:51:12,ACC00004285,Credit,866.57,-279395.59,EUR,Restaurant
TXN0000022163,2024-03-08T10:23:45,ACC00001880,Transfer,1400.92,-277994.67,GBP,Shell
TXN0000022164,2024-06-12T16:23:30,ACC00007976,ATM,1654.47,-279649.14,GBP,Target
TXN0000022165,2024-08-19T17:51:57,ACC00005243,Credit,701.14,-278948.0,GBP,Starbucks
TXN0000022166,2024-10-31T15:21:34,ACC00000995,ATM,1430.71,-280378.71,USD,Amazon
TXN0000022167,2024-11-26T11:10:55,ACC00006571,Credit,393.59,-279985.12,EUR,Starbucks
TXN0000022168,2024-11-04T23:01:16,ACC00009744,Debit,741.33,-280726.45,USD,Starbucks
TXN0000022169,2024-06-19T02:06:32,ACC00009661,Payment,1537.89,-282264.34,GBP,Restaurant
TXN0000022170,2024-02-23T13:17:58,ACC00009379,ATM,92.92,-282357.26,USD,Restaurant
TXN0000022171,2024-09-02T14:02:09,ACC00001907,ATM,336.32,-282693.58,EUR,Restaurant
TXN0000022172,2024-08-01T11:34:07,ACC00000747,Transfer,1212.28,-281481.3,EUR,Walmart
TXN0000022173,2024-01-21T17:46:34,ACC00004180,Payment,130.22,-281611.52,USD,Grocery
TXN0000022174,2024-09-05T17:22:24,ACC00004987,Debit,1577.22,-283188.74,EUR,Online Store
TXN0000022175,2024-01-05T23:12:02,ACC00006385,Debit,418.35,-283607.09,GBP,Online Store
TXN0000022176,2024-07-23T00:41:27,ACC00004236,Credit,1431.55,-282175.54,USD,Online Store
TXN0000022177,2024-08-22T02:29:40,ACC00002431,Payment,1635.0,-283810.54,USD,Target
TXN0000022178,2024-01-25T10:30:01,ACC00004041,Credit,532.13,-283278.41,GBP,Amazon
TXN0000022179,2024-01-21T08:33:59,ACC00009814,Credit,110.94,-283167.47,GBP,Starbucks
TXN0000022180,2024-08-30T21:32:42,ACC00000819,Credit,1576.52,-281590.95,GBP,Walmart
TXN0000022181,2024-01-17T13:51:11,ACC00007409,Transfer,19.5,-281571.45,EUR,Amazon
TXN0000022182,2024-10-27T13:32:17,ACC00007975,Transfer,214.65,-281356.8,USD,Online Store
TXN0000022183,2024-12-12T00:54:00,ACC00002782,ATM,980.72,-282337.52,JPY,Walmart
TXN0000022184,2024-03-06T12:18:24,ACC00003020,Credit,1355.61,-280981.91,GBP,Restaurant
TXN0000022185,2024-09-03T06:23:39,ACC00004614,Payment,1504.62,-282486.53,EUR,Online Store
TXN0000022186,2024-10-14T13:48:26,ACC00003302,ATM,412.28,-282898.81,USD,Target
TXN0000022187,2024-10-27T16:46:06,ACC00001968,Payment,427.03,-283325.84,USD,Walmart
TXN0000022188,2024-04-30T05:22:37,ACC00002982,ATM,664.65,-283990.49,EUR,Target
TXN0000022189,2024-05-04T00:03:06,ACC00009381,Transfer,1506.39,-282484.1,EUR,Restaurant
TXN0000022190,2024-08-04T00:23:24,ACC00006320,Credit,165.17,-282318.93,GBP,Grocery
TXN0000022191,2024-12-22T12:12:33,ACC00000907,Payment,1178.2,-283497.13,USD,Grocery
TXN0000022192,2024-04-24T23:13:20,ACC00007967,ATM,1019.15,-284516.28,EUR,Restaurant
TXN0000022193,2024-01-13T03:07:09,ACC00003488,Debit,1897.83,-286414.11,USD,Grocery
TXN0000022194,2024-11-02T15:56:29,ACC00009849,Debit,1885.5,-288299.61,USD,Grocery
TXN0000022195,2024-07-05T18:09:25,ACC00003320,Credit,1583.48,-286716.13,JPY,Restaurant
TXN0000022196,2024-11-03T14:56:58,ACC00005955,Debit,174.17,-286890.3,EUR,Starbucks
TXN0000022197,2024-11-08T07:14:42,ACC00007619,ATM,801.56,-287691.86,JPY,Shell
TXN0000022198,2024-12-06T02:46:22,ACC00005648,Payment,842.78,-288534.64,JPY,Starbucks
TXN0000022199,2024-10-03T17:10:20,ACC00001166,Payment,494.97,-289029.61,USD,Amazon
TXN0000022200,2024-05-27T22:54:21,ACC00008740,Credit,1577.3,-287452.31,JPY,Target
TXN0000022201,2024-09-23T22:35:48,ACC00004488,Transfer,784.78,-286667.53,EUR,Starbucks
TXN0000022202,2024-06-17T00:17:45,ACC00003466,Transfer,1921.79,-284745.74,USD,Online Store
TXN0000022203,2024-07-12T10:30:12,ACC00001782,Credit,1872.79,-282872.95,EUR,Shell
TXN0000022204,2024-03-19T17:55:10,ACC00001417,Credit,300.35,-282572.6,JPY,Online Store
TXN0000022205,2024-12-16T11:50:29,ACC00005203,Credit,365.06,-282207.54,GBP,Online Store
TXN0000022206,2024-01-29T20:01:52,ACC00002716,ATM,926.31,-283133.85,GBP,Amazon
TXN0000022207,2024-08-13T17:45:50,ACC00007462,Debit,579.68,-283713.53,GBP,Starbucks
TXN0000022208,2024-04-02T08:31:08,ACC00007940,Payment,483.41,-284196.94,EUR,Grocery
TXN0000022209,2024-01-24T14:21:08,ACC00002185,Debit,1368.05,-285564.99,GBP,Amazon
TXN0000022210,2024-03-27T02:27:34,ACC00001290,ATM,1619.93,-287184.92,USD,Restaurant
TXN0000022211,2024-05-01T09:03:02,ACC00009456,Payment,390.6,-287575.52,GBP,Starbucks
TXN0000022212,2024-09-11T06:05:55,ACC00007166,ATM,731.36,-288306.88,USD,Online Store
TXN0000022213,2024-10-31T10:13:22,ACC00008729,Transfer,1073.24,-287233.64,USD,Walmart
TXN0000022214,2024-03-29T15:25:34,ACC00005766,Payment,1456.53,-288690.17,JPY,Online Store
TXN0000022215,2024-12-18T10:59:55,ACC00005662,Payment,236.27,-288926.44,GBP,Walmart
TXN0000022216,2024-04-17T23:45:38,ACC00002773,Credit,1576.15,-287350.29,USD,Starbucks
TXN0000022217,2024-04-26T16:56:00,ACC00008498,Debit,1877.34,-289227.63,EUR,Amazon
TXN0000022218,2024-05-22T11:27:05,ACC00005797,ATM,1075.06,-290302.69,USD,Shell
TXN0000022219,2024-10-02T10:58:27,ACC00000786,Payment,207.6,-290510.29,USD,Amazon
TXN0000022220,2024-11-14T06:51:55,ACC00002266,Payment,199.83,-290710.12,USD,Restaurant
TXN0000022221,2024-07-24T07:18:48,ACC00002629,Credit,858.81,-289851.31,JPY,Target
TXN0000022222,2024-06-08T19:42:59,ACC00005558,Credit,1190.69,-288660.62,EUR,Starbucks
TXN0000022223,2024-12-07T14:53:40,ACC00009397,Credit,946.87,-287713.75,JPY,Amazon
TXN0000022224,2024-03-22T19:21:39,ACC00009596,ATM,559.32,-288273.07,EUR,Starbucks
TXN0000022225,2024-07-30T23:59:50,ACC00007890,ATM,1031.25,-289304.32,GBP,Walmart
TXN0000022226,2024-02-08T10:50:24,ACC00006772,Credit,500.24,-288804.08,USD,Starbucks
TXN0000022227,2024-10-25T22:08:01,ACC00000534,Credit,454.69,-288349.39,JPY,Shell
TXN0000022228,2024-07-18T04:12:45,ACC00009204,ATM,1209.15,-289558.54,EUR,Shell
TXN0000022229,2024-06-28T20:25:26,ACC00007520,Transfer,664.23,-288894.31,JPY,Target
TXN0000022230,2024-10-18T14:33:37,ACC00004996,Credit,1266.0,-287628.31,EUR,Shell
TXN0000022231,2024-05-02T11:44:58,ACC00006968,Payment,1538.33,-289166.64,EUR,Restaurant
TXN0000022232,2024-12-17T09:26:02,ACC00000871,Payment,195.49,-289362.13,GBP,Grocery
TXN0000022233,2024-07-18T23:22:39,ACC00004219,ATM,1081.13,-290443.26,EUR,Starbucks
TXN0000022234,2024-02-27T05:46:39,ACC00001019,Transfer,1362.63,-289080.63,JPY,Target
TXN0000022235,2024-06-19T23:31:09,ACC00004884,ATM,1444.38,-290525.01,JPY,Online Store
TXN0000022236,2024-08-19T02:37:27,ACC00003079,ATM,478.54,-291003.55,EUR,Amazon
TXN0000022237,2024-03-12T10:04:16,ACC00006489,Payment,227.16,-291230.71,JPY,Starbucks
TXN0000022238,2024-04-27T07:35:43,ACC00006012,Credit,272.85,-290957.86,JPY,Starbucks
TXN0000022239,2024-06-30T19:41:57,ACC00009465,ATM,1219.77,-292177.63,JPY,Target
TXN0000022240,2024-08-30T18:38:07,ACC00002091,Transfer,1609.48,-290568.15,EUR,Online Store
TXN0000022241,2024-05-30T06:24:47,ACC00006507,Credit,1908.72,-288659.43,USD,Target
TXN0000022242,2024-04-16T15:02:06,ACC00004964,Credit,294.31,-288365.12,JPY,Shell
TXN0000022243,2024-02-22T23:39:10,ACC00002199,Transfer,1333.8,-287031.32,GBP,Shell
TXN0000022244,2024-01-31T03:22:42,ACC00004050,Transfer,1145.36,-285885.96,JPY,Starbucks
TXN0000022245,2024-09-18T08:38:02,ACC00009944,Transfer,200.2,-285685.76,USD,Online Store
TXN0000022246,2024-05-30T09:34:37,ACC00002943,Transfer,1250.53,-284435.23,EUR,Online Store
TXN0000022247,2024-05-19T18:56:43,ACC00002144,Credit,340.66,-284094.57,EUR,Shell
TXN0000022248,2024-01-15T01:30:47,ACC00007387,ATM,1739.09,-285833.66,JPY,Grocery
TXN0000022249,2024-11-06T04:51:13,ACC00006764,Debit,1594.15,-287427.81,EUR,Target
TXN0000022250,2024-11-13T23:36:33,ACC00003454,Credit,1866.21,-285561.6,USD,Target
TXN0000022251,2024-09-07T15:45:38,ACC00008034,ATM,505.52,-286067.12,USD,Walmart
TXN0000022252,2024-06-08T17:07:47,ACC00007948,Debit,1920.94,-287988.06,GBP,Restaurant
TXN0000022253,2024-11-14T07:58:46,ACC00003522,Payment,333.06,-288321.12,EUR,Shell
TXN0000022254,2024-03-03T05:49:40,ACC00005924,Debit,765.55,-289086.67,JPY,Grocery
TXN0000022255,2024-10-12T12:24:50,ACC00003754,ATM,1575.59,-290662.26,EUR,Grocery
TXN0000022256,2024-12-25T04:35:59,ACC00009185,Credit,1207.51,-289454.75,USD,Online Store
TXN0000022257,2024-08-25T02:54:20,ACC00002577,Credit,828.25,-288626.5,USD,Online Store
TXN0000022258,2024-04-14T02:37:35,ACC00002967,ATM,1800.17,-290426.67,GBP,Target
TXN0000022259,2024-05-24T13:33:56,ACC00002627,Payment,675.73,-291102.4,GBP,Grocery
TXN0000022260,2024-12-21T15:53:41,ACC00006265,Credit,1439.3,-289663.1,USD,Grocery
TXN0000022261,2024-01-29T23:37:52,ACC00009763,ATM,141.5,-289804.6,USD,Amazon
TXN0000022262,2024-09-05T04:55:38,ACC00006906,Transfer,616.83,-289187.77,USD,Shell
TXN0000022263,2024-07-22T10:35:58,ACC00007911,Payment,1594.97,-290782.74,USD,Grocery
TXN0000022264,2024-10-28T13:36:13,ACC00007979,Credit,234.56,-290548.18,USD,Grocery
TXN0000022265,2024-11-25T10:55:44,ACC00006476,ATM,1562.41,-292110.59,GBP,Restaurant
TXN0000022266,2024-11-24T16:44:11,ACC00004401,Debit,1586.31,-293696.9,USD,Grocery
TXN0000022267,2024-12-02T14:03:19,ACC00007901,ATM,1960.37,-295657.27,USD,Shell
TXN0000022268,2024-01-01T17:52:13,ACC00001800,Debit,643.96,-296301.23,JPY,Amazon
TXN0000022269,2024-05-12T19:57:34,ACC00004906,Credit,1107.98,-295193.25,GBP,Amazon
TXN0000022270,2024-05-02T14:19:27,ACC00000521,Transfer,1877.99,-293315.26,USD,Grocery
TXN0000022271,2024-10-10T18:41:00,ACC00007592,Credit,397.35,-292917.91,GBP,Grocery
TXN0000022272,2024-12-12T12:51:49,ACC00002372,Credit,1928.53,-290989.38,EUR,Grocery
TXN0000022273,2024-10-28T12:47:09,ACC00001355,ATM,1608.9,-292598.28,GBP,Shell
TXN0000022274,2024-10-24T21:07:21,ACC00003591,Transfer,1626.96,-290971.32,JPY,Target
TXN0000022275,2024-11-28T23:07:34,ACC00008513,ATM,564.17,-291535.49,EUR,Grocery
TXN0000022276,2024-01-27T13:41:08,ACC00003129,Payment,1563.17,-293098.66,EUR,Amazon
TXN0000022277,2024-05-11T07:27:23,ACC00001358,Payment,1853.53,-294952.19,GBP,Online Store
TXN0000022278,2024-06-23T20:49:36,ACC00004864,ATM,1405.26,-296357.45,EUR,Target
TXN0000022279,2024-03-16T01:42:51,ACC00006515,ATM,1932.49,-298289.94,GBP,Grocery
TXN0000022280,2024-02-22T07:01:09,ACC00008757,ATM,1645.35,-299935.29,EUR,Shell
TXN0000022281,2024-05-15T17:51:20,ACC00009865,Debit,1418.54,-301353.83,USD,Shell
TXN0000022282,2024-01-31T04:43:50,ACC00005588,Credit,1256.19,-300097.64,JPY,Target
TXN0000022283,2024-05-17T11:45:10,ACC00004306,Transfer,1205.42,-298892.22,GBP,Amazon
TXN0000022284,2024-11-22T13:01:45,ACC00007709,Debit,356.78,-299249.0,EUR,Restaurant
TXN0000022285,2024-08-01T11:09:19,ACC00000075,ATM,1810.25,-301059.25,JPY,Amazon
TXN0000022286,2024-08-04T01:21:04,ACC00008558,ATM,175.24,-301234.49,GBP,Shell
TXN0000022287,2024-08-18T22:15:10,ACC00007317,Transfer,170.48,-301064.01,JPY,Grocery
TXN0000022288,2024-01-19T16:03:15,ACC00005192,Payment,1290.99,-302355.0,GBP,Starbucks
TXN0000022289,2024-06-22T21:32:27,ACC00008104,Credit,1612.48,-300742.52,JPY,Grocery
TXN0000022290,2024-06-12T03:24:25,ACC00003197,Payment,861.59,-301604.11,JPY,Walmart
TXN0000022291,2024-12-16T18:54:38,ACC00005772,ATM,660.52,-302264.63,EUR,Shell
TXN0000022292,2024-01-29T00:48:22,ACC00008350,Debit,706.14,-302970.77,USD,Shell
TXN0000022293,2024-07-13T16:55:31,ACC00000411,Payment,1740.12,-304710.89,EUR,Grocery
TXN0000022294,2024-10-11T23:53:57,ACC00009563,Transfer,1651.36,-303059.53,GBP,Shell
TXN0000022295,2024-11-01T16:55:34,ACC00009599,Transfer,1291.09,-301768.44,GBP,Restaurant
TXN0000022296,2024-04-03T17:44:58,ACC00004125,Credit,1262.83,-300505.61,USD,Walmart
TXN0000022297,2024-05-05T10:19:13,ACC00000544,Credit,30.57,-300475.04,USD,Grocery
TXN0000022298,2024-01-18T03:53:26,ACC00001738,ATM,1557.46,-302032.5,EUR,Restaurant
TXN0000022299,2024-01-22T20:28:16,ACC00006141,Credit,1458.72,-300573.78,JPY,Online Store
TXN0000022300,2024-12-19T17:49:16,ACC00004625,ATM,104.13,-300677.91,EUR,Online Store
TXN0000022301,2024-01-11T20:50:44,ACC00003818,ATM,1438.01,-302115.92,EUR,Starbucks
TXN0000022302,2024-12-17T18:35:03,ACC00007274,Payment,1273.64,-303389.56,GBP,Shell
TXN0000022303,2024-04-28T11:50:12,ACC00000172,Credit,187.02,-303202.54,JPY,Starbucks
TXN0000022304,2024-12-14T21:22:11,ACC00007158,Payment,1540.91,-304743.45,JPY,Amazon
TXN0000022305,2024-09-05T21:57:22,ACC00004946,ATM,1235.42,-305978.87,JPY,Starbucks
TXN0000022306,2024-07-16T21:20:43,ACC00000527,Credit,1164.69,-304814.18,EUR,Amazon
TXN0000022307,2024-05-21T15:23:26,ACC00006618,Debit,245.19,-305059.37,JPY,Amazon
TXN0000022308,2024-02-18T21:31:13,ACC00008839,ATM,723.53,-305782.9,USD,Amazon
TXN0000022309,2024-06-01T09:31:54,ACC00006906,Transfer,1846.6,-303936.3,JPY,Restaurant
TXN0000022310,2024-10-22T10:01:24,ACC00008175,Credit,1594.4,-302341.9,EUR,Restaurant
TXN0000022311,2024-07-12T15:06:11,ACC00006016,Transfer,1092.41,-301249.49,EUR,Online Store
TXN0000022312,2024-09-01T18:48:34,ACC00003534,Transfer,21.62,-301227.87,JPY,Shell
TXN0000022313,2024-07-15T09:02:49,ACC00002494,Transfer,1274.02,-299953.85,EUR,Shell
TXN0000022314,2024-10-21T17:19:55,ACC00004938,Payment,764.16,-300718.01,EUR,Walmart
TXN0000022315,2024-08-30T00:08:46,ACC00000946,Credit,1106.56,-299611.45,USD,Amazon
TXN0000022316,2024-02-14T04:08:13,ACC00005046,Debit,1564.6,-301176.05,USD,Amazon
TXN0000022317,2024-11-18T04:46:34,ACC00007859,Payment,929.78,-302105.83,JPY,Online Store
TXN0000022318,2024-03-12T19:48:45,ACC00001696,Credit,1663.28,-300442.55,JPY,Target
TXN0000022319,2024-03-15T20:11:23,ACC00001816,Payment,1178.41,-301620.96,JPY,Starbucks
TXN0000022320,2024-12-24T09:55:08,ACC00001871,Payment,1858.78,-303479.74,EUR,Shell
TXN0000022321,2024-09-15T16:12:57,ACC00003378,Transfer,1675.02,-301804.72,USD,Grocery
TXN0000022322,2024-03-24T03:35:40,ACC00008131,Transfer,739.95,-301064.77,GBP,Walmart
TXN0000022323,2024-06-23T06:25:38,ACC00004468,Credit,1403.51,-299661.26,EUR,Walmart
TXN0000022324,2024-03-24T05:11:15,ACC00009518,Transfer,479.66,-299181.6,EUR,Restaurant
TXN0000022325,2024-04-30T18:06:46,ACC00006591,Transfer,1443.46,-297738.14,JPY,Online Store
TXN0000022326,2024-07-13T06:15:02,ACC00007707,Transfer,717.58,-297020.56,JPY,Amazon
TXN0000022327,2024-04-07T09:36:54,ACC00008850,ATM,1360.83,-298381.39,GBP,Online Store
TXN0000022328,2024-06-20T00:03:38,ACC00004418,ATM,1408.05,-299789.44,GBP,Grocery
TXN0000022329,2024-05-21T03:33:32,ACC00002946,Transfer,120.85,-299668.59,JPY,Online Store
TXN0000022330,2024-09-07T19:46:54,ACC00000021,ATM,1932.96,-301601.55,USD,Starbucks
TXN0000022331,2024-09-22T08:56:46,ACC00008047,Credit,904.33,-300697.22,EUR,Restaurant
TXN0000022332,2024-11-03T07:07:55,ACC00008850,ATM,815.12,-301512.34,JPY,Grocery
TXN0000022333,2024-04-17T23:07:57,ACC00005149,Transfer,816.73,-300695.61,USD,Online Store
TXN0000022334,2024-12-28T22:39:06,ACC00005900,Debit,293.21,-300988.82,GBP,Amazon
TXN0000022335,2024-04-29T15:27:02,ACC00005661,Credit,883.99,-300104.83,GBP,Amazon
TXN0000022336,2024-05-15T11:22:18,ACC00002412,Debit,1843.5,-301948.33,GBP,Restaurant
TXN0000022337,2024-04-04T13:08:56,ACC00007582,Transfer,1149.55,-300798.78,GBP,Online Store
TXN0000022338,2024-04-08T05:32:30,ACC00004267,Debit,1470.71,-302269.49,JPY,Target
TXN0000022339,2024-08-24T16:58:37,ACC00008343,Payment,1868.82,-304138.31,GBP,Online Store
TXN0000022340,2024-06-12T15:31:37,ACC00008266,Payment,138.63,-304276.94,USD,Target
TXN0000022341,2024-02-17T17:35:54,ACC00004653,Transfer,1070.72,-303206.22,USD,Online Store
TXN0000022342,2024-11-04T14:17:42,ACC00005256,Transfer,1859.48,-301346.74,JPY,Walmart
TXN0000022343,2024-04-17T10:52:57,ACC00005262,Debit,841.49,-302188.23,JPY,Target
TXN0000022344,2024-10-03T11:38:24,ACC00002796,Credit,1915.07,-300273.16,JPY,Target
TXN0000022345,2024-11-28T00:23:15,ACC00002139,Debit,1909.96,-302183.12,GBP,Online Store
TXN0000022346,2024-07-25T15:35:13,ACC00000826,Payment,622.67,-302805.79,USD,Amazon
TXN0000022347,2024-02-09T04:00:39,ACC00003727,Debit,1694.34,-304500.13,JPY,Shell
TXN0000022348,2024-07-05T00:42:19,ACC00003182,Transfer,721.04,-303779.09,JPY,Walmart
TXN0000022349,2024-01-29T02:41:38,ACC00005898,Transfer,1803.67,-301975.42,JPY,Walmart
TXN0000022350,2024-10-21T06:41:02,ACC00002962,Payment,408.99,-302384.41,EUR,Shell
TXN0000022351,2024-06-27T11:05:54,ACC00009352,ATM,461.38,-302845.79,JPY,Restaurant
TXN0000022352,2024-10-02T17:20:31,ACC00004711,Credit,1856.48,-300989.31,EUR,Target
TXN0000022353,2024-03-09T08:10:57,ACC00004873,Debit,1104.97,-302094.28,EUR,Online Store
TXN0000022354,2024-07-23T20:03:34,ACC00002654,Credit,934.42,-301159.86,USD,Online Store
TXN0000022355,2024-04-13T10:50:33,ACC00003819,Credit,1826.44,-299333.42,USD,Online Store
TXN0000022356,2024-10-01T14:42:41,ACC00009858,ATM,489.39,-299822.81,EUR,Starbucks
TXN0000022357,2024-11-07T11:12:27,ACC00006067,Transfer,1645.24,-298177.57,GBP,Target
TXN0000022358,2024-09-09T15:49:00,ACC00002748,Transfer,948.17,-297229.4,EUR,Starbucks
TXN0000022359,2024-10-01T15:37:14,ACC00007397,ATM,758.93,-297988.33,JPY,Restaurant
TXN0000022360,2024-01-27T22:51:22,ACC00007903,ATM,1199.65,-299187.98,GBP,Shell
TXN0000022361,2024-10-17T18:32:00,ACC00002525,Debit,426.46,-299614.44,GBP,Walmart
TXN0000022362,2024-03-05T05:15:26,ACC00005845,ATM,1238.42,-300852.86,EUR,Grocery
TXN0000022363,2024-08-08T18:17:22,ACC00001962,Payment,1746.8,-302599.66,USD,Grocery
TXN0000022364,2024-02-22T20:09:57,ACC00005612,ATM,1192.42,-303792.08,EUR,Walmart
TXN0000022365,2024-02-09T06:49:42,ACC00003551,Credit,662.72,-303129.36,GBP,Restaurant
TXN0000022366,2024-02-15T06:43:13,ACC00007141,Debit,1925.69,-305055.05,USD,Amazon
TXN0000022367,2024-10-26T05:29:23,ACC00006084,Transfer,1345.23,-303709.82,EUR,Target
TXN0000022368,2024-08-16T08:57:37,ACC00006434,Transfer,67.62,-303642.2,JPY,Amazon
TXN0000022369,2024-04-17T13:41:33,ACC00006548,ATM,1811.89,-305454.09,USD,Grocery
TXN0000022370,2024-06-08T03:47:45,ACC00002976,Debit,1666.24,-307120.33,JPY,Online Store
TXN0000022371,2024-06-25T15:27:37,ACC00008202,Credit,306.75,-306813.58,GBP,Restaurant
TXN0000022372,2024-06-22T18:36:11,ACC00004815,ATM,1385.12,-308198.7,JPY,Amazon
TXN0000022373,2024-01-30T06:04:08,ACC00000948,Debit,140.53,-308339.23,JPY,Grocery
TXN0000022374,2024-10-14T21:57:43,ACC00005387,Credit,404.46,-307934.77,GBP,Grocery
TXN0000022375,2024-10-03T00:12:42,ACC00005973,Payment,1242.43,-309177.2,USD,Restaurant
TXN0000022376,2024-02-28T13:02:57,ACC00003476,Transfer,1576.2,-307601.0,GBP,Grocery
TXN0000022377,2024-04-17T08:10:16,ACC00006894,Debit,633.79,-308234.79,EUR,Restaurant
TXN0000022378,2024-05-11T13:53:15,ACC00006767,Transfer,579.96,-307654.83,GBP,Starbucks
TXN0000022379,2024-08-26T16:59:21,ACC00001224,Debit,72.86,-307727.69,USD,Grocery
TXN0000022380,2024-05-31T20:08:00,ACC00008019,Credit,1129.83,-306597.86,USD,Restaurant
TXN0000022381,2024-02-20T08:29:53,ACC00004653,Payment,152.69,-306750.55,JPY,Starbucks
TXN0000022382,2024-03-21T18:34:07,ACC00003795,Payment,1898.37,-308648.92,JPY,Amazon
TXN0000022383,2024-03-29T17:08:38,ACC00005957,Payment,1577.54,-310226.46,GBP,Shell
TXN0000022384,2024-07-27T10:38:03,ACC00004882,ATM,683.63,-310910.09,USD,Grocery
TXN0000022385,2024-04-17T23:47:31,ACC00002014,Payment,549.14,-311459.23,JPY,Grocery
TXN0000022386,2024-05-18T08:38:35,ACC00008425,Credit,954.17,-310505.06,JPY,Amazon
TXN0000022387,2024-06-24T04:22:54,ACC00002143,ATM,1701.4,-312206.46,USD,Restaurant
TXN0000022388,2024-02-18T20:41:38,ACC00007393,Transfer,123.06,-312083.4,GBP,Amazon
TXN0000022389,2024-10-15T15:55:45,ACC00006236,Debit,1311.22,-313394.62,JPY,Walmart
TXN0000022390,2024-04-01T02:42:12,ACC00003830,Debit,346.35,-313740.97,EUR,Restaurant
TXN0000022391,2024-06-08T17:49:37,ACC00005655,Transfer,1699.32,-312041.65,JPY,Grocery
TXN0000022392,2024-07-19T22:32:57,ACC00004683,Payment,541.64,-312583.29,USD,Starbucks
TXN0000022393,2024-05-21T10:56:15,ACC00003090,Credit,741.1,-311842.19,JPY,Target
TXN0000022394,2024-03-18T08:28:42,ACC00008465,Payment,1216.42,-313058.61,USD,Target
TXN0000022395,2024-04-23T03:15:08,ACC00004528,Payment,1066.0,-314124.61,GBP,Restaurant
TXN0000022396,2024-03-16T13:47:31,ACC00002039,Debit,17.38,-314141.99,GBP,Grocery
TXN0000022397,2024-04-03T09:51:53,ACC00001669,Credit,507.96,-313634.03,EUR,Walmart
TXN0000022398,2024-12-06T19:03:27,ACC00006325,ATM,388.59,-314022.62,JPY,Grocery
TXN0000022399,2024-05-09T19:16:52,ACC00006219,Debit,1548.7,-315571.32,EUR,Grocery
TXN0000022400,2024-06-22T17:27:05,ACC00004478,ATM,525.25,-316096.57,GBP,Starbucks
TXN0000022401,2024-02-06T12:16:45,ACC00009426,ATM,395.2,-316491.77,USD,Target
TXN0000022402,2024-05-23T14:59:13,ACC00003073,Payment,1396.41,-317888.18,EUR,Grocery
TXN0000022403,2024-01-15T21:12:42,ACC00002153,Debit,434.53,-318322.71,USD,Target
TXN0000022404,2024-06-01T20:25:39,ACC00001951,ATM,1908.07,-320230.78,GBP,Shell
TXN0000022405,2024-05-07T16:20:11,ACC00005417,Transfer,460.71,-319770.07,USD,Online Store
TXN0000022406,2024-03-26T17:51:32,ACC00001604,Transfer,1971.49,-317798.58,EUR,Target
TXN0000022407,2024-05-21T20:52:31,ACC00005973,Credit,1232.08,-316566.5,EUR,Restaurant
TXN0000022408,2024-10-21T07:21:01,ACC00005847,Payment,1038.29,-317604.79,JPY,Grocery
TXN0000022409,2024-02-12T22:23:46,ACC00001053,Payment,1420.3,-319025.09,EUR,Grocery
TXN0000022410,2024-09-21T06:28:25,ACC00001496,Credit,877.77,-318147.32,GBP,Walmart
TXN0000022411,2024-08-30T20:58:07,ACC00003803,ATM,1153.69,-319301.01,USD,Starbucks
TXN0000022412,2024-12-18T04:10:28,ACC00006544,Transfer,1763.9,-317537.11,USD,Online Store
TXN0000022413,2024-06-20T03:42:46,ACC00003409,Credit,241.14,-317295.97,GBP,Amazon
TXN0000022414,2024-07-30T13:31:58,ACC00004691,ATM,993.43,-318289.4,EUR,Walmart
TXN0000022415,2024-06-11T22:50:45,ACC00008844,Payment,1129.06,-319418.46,EUR,Starbucks
TXN0000022416,2024-07-28T05:31:30,ACC00007353,ATM,1753.66,-321172.12,USD,Restaurant
TXN0000022417,2024-03-31T15:16:06,ACC00008805,Debit,1022.99,-322195.11,GBP,Walmart
TXN0000022418,2024-08-22T23:26:49,ACC00009930,ATM,1206.29,-323401.4,USD,Grocery
TXN0000022419,2024-12-25T15:42:19,ACC00004582,Credit,1696.77,-321704.63,USD,Starbucks
TXN0000022420,2024-06-23T22:37:47,ACC00002658,Transfer,1361.12,-320343.51,USD,Restaurant
TXN0000022421,2024-12-17T16:30:03,ACC00006539,Transfer,656.88,-319686.63,EUR,Target
TXN0000022422,2024-05-03T23:00:21,ACC00004399,Debit,1318.87,-321005.5,GBP,Restaurant
TXN0000022423,2024-09-05T08:46:44,ACC00009325,Transfer,1473.18,-319532.32,JPY,Amazon
TXN0000022424,2024-05-20T13:23:56,ACC00005389,ATM,781.61,-320313.93,JPY,Walmart
TXN0000022425,2024-01-04T22:31:05,ACC00009019,Transfer,880.22,-319433.71,EUR,Walmart
TXN0000022426,2024-10-26T07:13:13,ACC00002311,Debit,145.76,-319579.47,USD,Grocery
TXN0000022427,2024-06-03T00:27:00,ACC00007109,Credit,796.57,-318782.9,EUR,Grocery
TXN0000022428,2024-07-04T18:03:38,ACC00007889,Credit,671.25,-318111.65,GBP,Starbucks
TXN0000022429,2024-04-22T21:07:23,ACC00009547,Debit,834.68,-318946.33,JPY,Grocery
TXN0000022430,2024-07-07T13:16:34,ACC00003509,Credit,1471.42,-317474.91,USD,Walmart
TXN0000022431,2024-04-22T10:48:53,ACC00009290,Debit,455.34,-317930.25,USD,Target
TXN0000022432,2024-08-13T16:58:02,ACC00009283,Debit,516.16,-318446.41,JPY,Online Store
TXN0000022433,2024-10-09T10:12:47,ACC00003910,Debit,1082.46,-319528.87,GBP,Grocery
TXN0000022434,2024-04-30T19:41:30,ACC00009732,Credit,62.76,-319466.11,EUR,Amazon
TXN0000022435,2024-03-03T11:04:36,ACC00002935,Credit,259.25,-319206.86,EUR,Walmart
TXN0000022436,2024-09-18T09:40:30,ACC00008576,Debit,1133.05,-320339.91,GBP,Shell
TXN0000022437,2024-08-01T10:15:38,ACC00000485,Credit,868.45,-319471.46,EUR,Amazon
TXN0000022438,2024-09-11T07:48:49,ACC00006336,Debit,1600.72,-321072.18,JPY,Online Store
TXN0000022439,2024-04-28T23:30:46,ACC00008335,Payment,954.6,-322026.78,USD,Grocery
TXN0000022440,2024-06-04T08:58:26,ACC00001653,Payment,1474.83,-323501.61,EUR,Walmart
TXN0000022441,2024-06-12T21:11:07,ACC00002228,Payment,159.88,-323661.49,EUR,Target
TXN0000022442,2024-12-03T21:26:15,ACC00008986,Credit,1066.71,-322594.78,USD,Walmart
TXN0000022443,2024-09-13T02:44:53,ACC00008903,ATM,1846.46,-324441.24,EUR,Restaurant
TXN0000022444,2024-08-21T01:43:22,ACC00004382,ATM,1869.42,-326310.66,EUR,Online Store
TXN0000022445,2024-02-22T01:33:43,ACC00000402,ATM,1996.85,-328307.51,EUR,Grocery
TXN0000022446,2024-01-01T06:37:32,ACC00003461,Transfer,1138.94,-327168.57,GBP,Amazon
TXN0000022447,2024-09-18T07:59:08,ACC00002773,Payment,773.56,-327942.13,USD,Target
TXN0000022448,2024-04-29T10:19:52,ACC00008107,Credit,1841.64,-326100.49,JPY,Starbucks
TXN0000022449,2024-09-21T12:41:12,ACC00006634,ATM,222.12,-326322.61,USD,Target
TXN0000022450,2024-10-06T15:36:36,ACC00007563,Payment,1313.82,-327636.43,EUR,Online Store
TXN0000022451,2024-03-08T11:09:00,ACC00008700,Transfer,1141.04,-326495.39,USD,Online Store
TXN0000022452,2024-10-25T05:05:17,ACC00002684,ATM,191.03,-326686.42,GBP,Online Store
TXN0000022453,2024-06-05T18:15:42,ACC00006803,Credit,280.66,-326405.76,EUR,Grocery
TXN0000022454,2024-12-14T00:09:05,ACC00004038,Debit,466.42,-326872.18,USD,Grocery
TXN0000022455,2024-02-09T12:20:28,ACC00009982,Payment,351.38,-327223.56,JPY,Target
TXN0000022456,2024-09-18T14:26:10,ACC00007084,Debit,581.18,-327804.74,EUR,Amazon
TXN0000022457,2024-02-28T15:15:13,ACC00004012,Transfer,1139.09,-326665.65,EUR,Target
TXN0000022458,2024-02-24T19:25:34,ACC00002856,ATM,452.78,-327118.43,GBP,Amazon
TXN0000022459,2024-06-17T04:49:57,ACC00003579,Transfer,97.98,-327020.45,JPY,Target
TXN0000022460,2024-05-01T03:32:17,ACC00004778,Transfer,1352.74,-325667.71,JPY,Shell
TXN0000022461,2024-05-09T16:16:39,ACC00008428,Transfer,311.49,-325356.22,EUR,Online Store
TXN0000022462,2024-04-21T14:39:02,ACC00003752,Credit,1612.17,-323744.05,JPY,Shell
TXN0000022463,2024-04-07T17:44:53,ACC00009087,ATM,1399.66,-325143.71,EUR,Starbucks
TXN0000022464,2024-12-30T18:42:33,ACC00009347,Credit,705.9,-324437.81,JPY,Restaurant
TXN0000022465,2024-01-04T10:18:20,ACC00007242,Transfer,422.92,-324014.89,USD,Restaurant
TXN0000022466,2024-09-20T23:23:26,ACC00003643,ATM,1038.45,-325053.34,GBP,Online Store
TXN0000022467,2024-05-03T16:42:49,ACC00009159,Debit,597.51,-325650.85,JPY,Grocery
TXN0000022468,2024-08-07T01:20:59,ACC00000614,Transfer,1268.97,-324381.88,USD,Walmart
TXN0000022469,2024-09-18T06:38:27,ACC00005748,Credit,1718.18,-322663.7,GBP,Restaurant
TXN0000022470,2024-03-13T02:54:11,ACC00004811,Transfer,1957.59,-320706.11,GBP,Starbucks
TXN0000022471,2024-09-28T20:13:01,ACC00003931,ATM,926.03,-321632.14,EUR,Shell
TXN0000022472,2024-03-05T21:01:54,ACC00000770,Credit,210.11,-321422.03,EUR,Amazon
TXN0000022473,2024-08-17T01:48:00,ACC00001601,Credit,208.48,-321213.55,GBP,Starbucks
TXN0000022474,2024-02-19T09:00:56,ACC00003767,Debit,1412.36,-322625.91,GBP,Restaurant
TXN0000022475,2024-09-10T09:47:48,ACC00004445,Transfer,1218.19,-321407.72,GBP,Amazon
TXN0000022476,2024-02-28T14:38:17,ACC00006825,Transfer,1432.85,-319974.87,GBP,Restaurant
TXN0000022477,2024-12-16T05:47:19,ACC00000134,Payment,1109.05,-321083.92,JPY,Restaurant
TXN0000022478,2024-03-27T18:12:09,ACC00001950,Debit,80.25,-321164.17,USD,Grocery
TXN0000022479,2024-11-19T05:38:02,ACC00009268,ATM,1797.51,-322961.68,EUR,Online Store
TXN0000022480,2024-06-19T15:48:11,ACC00007691,Credit,1655.31,-321306.37,GBP,Starbucks
TXN0000022481,2024-06-30T13:59:39,ACC00007079,Transfer,1828.58,-319477.79,USD,Online Store
TXN0000022482,2024-05-13T14:56:36,ACC00005341,Credit,579.59,-318898.2,GBP,Target
TXN0000022483,2024-04-03T23:54:39,ACC00005259,Transfer,987.21,-317910.99,GBP,Grocery
TXN0000022484,2024-05-17T00:48:28,ACC00000769,Debit,1166.9,-319077.89,USD,Target
TXN0000022485,2024-09-11T22:18:11,ACC00005641,ATM,10.91,-319088.8,EUR,Restaurant
TXN0000022486,2024-03-20T01:19:19,ACC00006434,Credit,541.69,-318547.11,EUR,Amazon
TXN0000022487,2024-07-28T12:21:14,ACC00004203,Credit,1671.99,-316875.12,USD,Grocery
TXN0000022488,2024-03-13T15:56:37,ACC00007679,Payment,301.29,-317176.41,EUR,Amazon
TXN0000022489,2024-08-22T17:35:07,ACC00006857,Credit,1829.0,-315347.41,EUR,Online Store
TXN0000022490,2024-02-16T10:31:35,ACC00000687,Credit,756.23,-314591.18,EUR,Restaurant
TXN0000022491,2024-02-13T22:44:04,ACC00008060,ATM,612.94,-315204.12,EUR,Grocery
TXN0000022492,2024-02-26T16:50:39,ACC00006699,Transfer,1914.08,-313290.04,USD,Target
TXN0000022493,2024-03-18T04:32:57,ACC00004590,Debit,198.76,-313488.8,JPY,Grocery
TXN0000022494,2024-07-02T08:39:23,ACC00004798,Payment,1811.26,-315300.06,EUR,Starbucks
TXN0000022495,2024-12-08T23:44:06,ACC00007838,Credit,797.29,-314502.77,EUR,Shell
TXN0000022496,2024-09-28T18:11:05,ACC00008841,Transfer,1973.08,-312529.69,USD,Amazon
TXN0000022497,2024-05-29T17:00:40,ACC00000579,ATM,710.07,-313239.76,GBP,Restaurant
TXN0000022498,2024-10-08T09:34:51,ACC00002594,Debit,247.66,-313487.42,GBP,Shell
TXN0000022499,2024-06-02T12:58:14,ACC00006764,ATM,1633.45,-315120.87,USD,Starbucks
TXN0000022500,2024-11-13T00:45:41,ACC00005867,Debit,1986.18,-317107.05,JPY,Restaurant
TXN0000022501,2024-06-20T15:35:49,ACC00000767,Transfer,943.74,-316163.31,EUR,Amazon
TXN0000022502,2024-08-08T17:03:53,ACC00009862,Transfer,600.76,-315562.55,JPY,Online Store
TXN0000022503,2024-03-18T08:12:16,ACC00009128,ATM,821.73,-316384.28,USD,Restaurant
TXN0000022504,2024-08-25T21:46:12,ACC00001891,Credit,1615.15,-314769.13,USD,Shell
TXN0000022505,2024-01-08T03:05:55,ACC00009319,Payment,592.24,-315361.37,GBP,Target
TXN0000022506,2024-03-18T01:00:09,ACC00007999,Transfer,1955.76,-313405.61,JPY,Online Store
TXN0000022507,2024-05-10T17:08:01,ACC00000811,Payment,259.88,-313665.49,JPY,Starbucks
TXN0000022508,2024-12-18T04:39:10,ACC00007795,Payment,1726.62,-315392.11,GBP,Target
TXN0000022509,2024-07-10T01:23:19,ACC00005119,ATM,1891.82,-317283.93,GBP,Walmart
TXN0000022510,2024-12-10T22:06:35,ACC00001020,Payment,313.8,-317597.73,USD,Walmart
TXN0000022511,2024-10-17T15:50:19,ACC00005020,Debit,948.37,-318546.1,USD,Shell
TXN0000022512,2024-09-26T17:06:29,ACC00008065,Transfer,1403.6,-317142.5,EUR,Walmart
TXN0000022513,2024-09-16T07:18:21,ACC00006745,Transfer,1310.11,-315832.39,EUR,Grocery
TXN0000022514,2024-11-02T15:41:30,ACC00000509,Payment,381.26,-316213.65,EUR,Amazon
TXN0000022515,2024-04-05T12:37:04,ACC00007496,Debit,903.93,-317117.58,EUR,Target
TXN0000022516,2024-07-13T17:13:30,ACC00005294,Payment,567.62,-317685.2,GBP,Amazon
TXN0000022517,2024-01-17T02:29:22,ACC00000818,Transfer,964.88,-316720.32,GBP,Walmart
TXN0000022518,2024-07-26T08:43:09,ACC00009001,Credit,1422.8,-315297.52,USD,Online Store
TXN0000022519,2024-07-01T11:04:10,ACC00005881,Payment,1918.23,-317215.75,GBP,Grocery
TXN0000022520,2024-01-06T10:23:35,ACC00005344,Debit,1303.17,-318518.92,GBP,Amazon
TXN0000022521,2024-11-15T20:39:06,ACC00004580,Payment,890.05,-319408.97,USD,Starbucks
TXN0000022522,2024-03-31T02:19:35,ACC00006623,ATM,1478.65,-320887.62,EUR,Grocery
TXN0000022523,2024-08-25T19:45:38,ACC00007901,Payment,1278.97,-322166.59,JPY,Target
TXN0000022524,2024-08-22T22:40:38,ACC00001137,Transfer,1980.1,-320186.49,EUR,Shell
TXN0000022525,2024-11-24T14:43:43,ACC00009788,Debit,1580.72,-321767.21,EUR,Walmart
TXN0000022526,2024-07-18T00:44:57,ACC00005350,Debit,68.44,-321835.65,JPY,Shell
TXN0000022527,2024-09-22T07:30:56,ACC00009177,Payment,676.49,-322512.14,JPY,Amazon
TXN0000022528,2024-08-13T17:34:53,ACC00005163,Transfer,308.25,-322203.89,JPY,Shell
TXN0000022529,2024-03-31T00:03:50,ACC00008970,Payment,1962.43,-324166.32,USD,Amazon
TXN0000022530,2024-03-05T12:01:37,ACC00000903,ATM,481.41,-324647.73,EUR,Starbucks
TXN0000022531,2024-04-01T23:21:19,ACC00000377,Payment,1079.98,-325727.71,EUR,Shell
TXN0000022532,2024-08-08T05:13:05,ACC00002360,Debit,740.25,-326467.96,USD,Shell
TXN0000022533,2024-02-29T00:27:46,ACC00003055,Debit,1153.1,-327621.06,USD,Online Store
TXN0000022534,2024-09-17T22:10:50,ACC00009852,Payment,823.53,-328444.59,USD,Shell
TXN0000022535,2024-11-12T21:04:28,ACC00009905,ATM,1108.06,-329552.65,USD,Shell
TXN0000022536,2024-01-03T07:56:51,ACC00008392,Debit,434.16,-329986.81,USD,Walmart
TXN0000022537,2024-01-09T16:45:26,ACC00007236,Credit,1542.62,-328444.19,USD,Grocery
TXN0000022538,2024-05-03T22:21:02,ACC00007388,ATM,1515.47,-329959.66,JPY,Amazon
TXN0000022539,2024-10-26T03:08:09,ACC00008158,Transfer,670.22,-329289.44,USD,Grocery
TXN0000022540,2024-04-24T23:27:26,ACC00004656,Transfer,341.66,-328947.78,USD,Restaurant
TXN0000022541,2024-08-18T03:45:10,ACC00002579,Payment,1867.94,-330815.72,USD,Starbucks
TXN0000022542,2024-10-05T12:15:28,ACC00000640,ATM,233.74,-331049.46,EUR,Restaurant
TXN0000022543,2024-08-16T06:15:24,ACC00000859,Debit,1827.68,-332877.14,EUR,Online Store
TXN0000022544,2024-02-20T02:13:15,ACC00003787,ATM,1114.9,-333992.04,EUR,Shell
TXN0000022545,2024-04-14T20:36:11,ACC00009008,Transfer,1237.39,-332754.65,USD,Shell
TXN0000022546,2024-02-26T06:18:56,ACC00001118,Debit,1067.68,-333822.33,EUR,Online Store
TXN0000022547,2024-10-19T20:19:41,ACC00009511,Credit,363.77,-333458.56,USD,Starbucks
TXN0000022548,2024-10-06T14:32:45,ACC00008247,Credit,788.11,-332670.45,GBP,Walmart
TXN0000022549,2024-05-27T00:58:29,ACC00002986,Payment,113.44,-332783.89,GBP,Shell
TXN0000022550,2024-12-03T06:55:43,ACC00004960,Credit,1934.3,-330849.59,USD,Starbucks
TXN0000022551,2024-04-29T18:06:17,ACC00000420,Debit,972.26,-331821.85,JPY,Amazon
TXN0000022552,2024-07-30T09:30:09,ACC00001879,Payment,1798.95,-333620.8,GBP,Starbucks
TXN0000022553,2024-01-20T21:09:25,ACC00008437,Transfer,1757.45,-331863.35,USD,Target
TXN0000022554,2024-11-07T11:47:54,ACC00005360,Credit,634.7,-331228.65,JPY,Restaurant
TXN0000022555,2024-05-12T01:36:47,ACC00008243,Transfer,1147.7,-330080.95,JPY,Online Store
TXN0000022556,2024-08-16T08:49:37,ACC00009122,Debit,1062.55,-331143.5,JPY,Online Store
TXN0000022557,2024-06-30T14:30:06,ACC00006059,ATM,1543.24,-332686.74,GBP,Grocery
TXN0000022558,2024-04-08T16:46:08,ACC00009815,Transfer,831.02,-331855.72,JPY,Target
TXN0000022559,2024-02-05T11:18:47,ACC00003970,Payment,222.84,-332078.56,JPY,Grocery
TXN0000022560,2024-10-04T10:22:42,ACC00005912,Debit,602.56,-332681.12,JPY,Restaurant
TXN0000022561,2024-09-01T12:08:20,ACC00004520,Credit,507.26,-332173.86,JPY,Shell
TXN0000022562,2024-01-07T11:24:48,ACC00004583,Credit,1756.34,-330417.52,GBP,Restaurant
TXN0000022563,2024-10-11T14:30:46,ACC00005225,Debit,649.01,-331066.53,USD,Online Store
TXN0000022564,2024-10-11T14:18:00,ACC00007795,Credit,20.23,-331046.3,GBP,Amazon
TXN0000022565,2024-07-09T01:12:29,ACC00001692,Credit,1423.32,-329622.98,USD,Online Store
TXN0000022566,2024-08-15T17:42:48,ACC00000161,Transfer,555.09,-329067.89,USD,Online Store
TXN0000022567,2024-07-11T18:00:32,ACC00006365,Credit,420.26,-328647.63,GBP,Target
TXN0000022568,2024-01-10T18:39:02,ACC00009531,Transfer,1667.67,-326979.96,EUR,Target
TXN0000022569,2024-04-15T04:58:51,ACC00004182,Debit,445.46,-327425.42,EUR,Shell
TXN0000022570,2024-02-17T03:24:05,ACC00006254,Debit,1800.91,-329226.33,GBP,Amazon
TXN0000022571,2024-08-02T16:50:40,ACC00008673,Payment,41.27,-329267.6,USD,Target
TXN0000022572,2024-10-28T05:28:42,ACC00008941,Payment,699.53,-329967.13,GBP,Restaurant
TXN0000022573,2024-03-10T07:06:12,ACC00006453,Debit,972.3,-330939.43,GBP,Shell
TXN0000022574,2024-03-16T03:03:44,ACC00007628,ATM,1163.93,-332103.36,EUR,Target
TXN0000022575,2024-06-20T02:14:04,ACC00000150,Transfer,871.09,-331232.27,EUR,Starbucks
TXN0000022576,2024-02-18T06:11:38,ACC00006995,Debit,1842.44,-333074.71,EUR,Starbucks
TXN0000022577,2024-09-10T06:37:36,ACC00003072,Debit,292.46,-333367.17,GBP,Starbucks
TXN0000022578,2024-04-15T10:18:22,ACC00006719,Debit,1535.12,-334902.29,USD,Starbucks
TXN0000022579,2024-09-01T14:22:27,ACC00002117,Debit,1481.5,-336383.79,JPY,Walmart
TXN0000022580,2024-02-04T05:51:10,ACC00003847,Transfer,1170.02,-335213.77,EUR,Target
TXN0000022581,2024-04-13T21:26:28,ACC00000212,Debit,967.52,-336181.29,USD,Amazon
TXN0000022582,2024-10-21T04:16:07,ACC00003093,Payment,92.97,-336274.26,JPY,Restaurant
TXN0000022583,2024-08-25T22:56:40,ACC00006846,Credit,887.84,-335386.42,JPY,Grocery
TXN0000022584,2024-08-08T02:01:53,ACC00005381,Credit,254.39,-335132.03,EUR,Grocery
TXN0000022585,2024-01-13T03:22:32,ACC00007055,Transfer,130.38,-335001.65,USD,Target
TXN0000022586,2024-01-26T10:51:28,ACC00006953,Debit,1270.0,-336271.65,EUR,Starbucks
TXN0000022587,2024-04-27T01:11:39,ACC00002204,ATM,1211.06,-337482.71,USD,Target
TXN0000022588,2024-03-17T07:59:25,ACC00001796,Debit,832.0,-338314.71,JPY,Walmart
TXN0000022589,2024-12-22T20:03:08,ACC00004951,Debit,1024.26,-339338.97,GBP,Grocery
TXN0000022590,2024-02-18T10:59:02,ACC00000954,ATM,1168.06,-340507.03,USD,Walmart
TXN0000022591,2024-04-22T12:44:23,ACC00007703,Credit,493.87,-340013.16,EUR,Shell
TXN0000022592,2024-09-24T12:08:03,ACC00005059,ATM,903.4,-340916.56,EUR,Grocery
TXN0000022593,2024-06-02T22:32:32,ACC00007879,Credit,1527.18,-339389.38,JPY,Amazon
TXN0000022594,2024-12-24T22:05:17,ACC00007844,ATM,348.31,-339737.69,GBP,Shell
TXN0000022595,2024-08-10T21:31:49,ACC00009797,Transfer,35.01,-339702.68,JPY,Starbucks
TXN0000022596,2024-11-21T23:50:42,ACC00003025,Credit,1370.31,-338332.37,GBP,Grocery
TXN0000022597,2024-10-03T07:02:50,ACC00009379,ATM,700.1,-339032.47,EUR,Starbucks
TXN0000022598,2024-04-10T20:37:24,ACC00004834,Credit,1596.23,-337436.24,EUR,Walmart
TXN0000022599,2024-02-27T13:54:04,ACC00007097,Debit,853.13,-338289.37,EUR,Starbucks
TXN0000022600,2024-10-09T03:58:35,ACC00007164,Payment,223.47,-338512.84,EUR,Grocery
TXN0000022601,2024-11-26T15:16:45,ACC00005440,ATM,710.75,-339223.59,EUR,Walmart
TXN0000022602,2024-09-21T12:56:10,ACC00007346,Payment,1543.21,-340766.8,EUR,Target
TXN0000022603,2024-03-19T17:08:06,ACC00005935,ATM,1434.29,-342201.09,USD,Target
TXN0000022604,2024-07-27T06:58:23,ACC00009854,Transfer,353.96,-341847.13,USD,Grocery
TXN0000022605,2024-02-10T08:29:38,ACC00006638,Credit,1984.08,-339863.05,JPY,Starbucks
TXN0000022606,2024-09-15T18:16:45,ACC00003575,Credit,1746.69,-338116.36,EUR,Walmart
TXN0000022607,2024-08-07T14:25:36,ACC00009036,Transfer,994.35,-337122.01,EUR,Grocery
TXN0000022608,2024-05-13T08:50:46,ACC00002557,ATM,820.02,-337942.03,GBP,Walmart
TXN0000022609,2024-08-27T02:27:52,ACC00003776,Debit,1526.36,-339468.39,USD,Online Store
TXN0000022610,2024-01-04T17:12:20,ACC00002425,Transfer,1009.74,-338458.65,GBP,Grocery
TXN0000022611,2024-02-26T06:40:24,ACC00002166,Transfer,1421.37,-337037.28,USD,Walmart
TXN0000022612,2024-03-11T11:28:05,ACC00006005,Payment,808.82,-337846.1,GBP,Online Store
TXN0000022613,2024-08-08T09:48:06,ACC00000830,Payment,1388.47,-339234.57,EUR,Online Store
TXN0000022614,2024-07-11T00:02:08,ACC00006215,ATM,662.94,-339897.51,USD,Amazon
TXN0000022615,2024-06-17T21:09:17,ACC00005057,Debit,434.91,-340332.42,GBP,Starbucks
TXN0000022616,2024-07-24T09:11:45,ACC00003978,Transfer,29.98,-340302.44,GBP,Starbucks
TXN0000022617,2024-02-01T14:18:57,ACC00008113,Credit,823.25,-339479.19,USD,Restaurant
TXN0000022618,2024-07-15T19:09:00,ACC00005445,Debit,1811.56,-341290.75,USD,Walmart
TXN0000022619,2024-10-21T10:17:29,ACC00004184,Payment,510.92,-341801.67,JPY,Amazon
TXN0000022620,2024-11-08T01:48:02,ACC00007038,Payment,820.69,-342622.36,GBP,Target
TXN0000022621,2024-07-04T00:21:14,ACC00000408,Transfer,1985.98,-340636.38,JPY,Amazon
TXN0000022622,2024-06-20T09:24:37,ACC00004460,Credit,1969.4,-338666.98,EUR,Target
TXN0000022623,2024-04-17T05:32:54,ACC00007431,ATM,1674.24,-340341.22,EUR,Amazon
TXN0000022624,2024-01-30T08:49:37,ACC00009089,ATM,30.39,-340371.61,EUR,Shell
TXN0000022625,2024-02-10T00:33:28,ACC00007638,Credit,40.03,-340331.58,USD,Shell
TXN0000022626,2024-01-04T20:21:08,ACC00003521,ATM,990.33,-341321.91,EUR,Starbucks
TXN0000022627,2024-03-23T06:59:21,ACC00000144,Credit,1644.21,-339677.7,EUR,Shell
TXN0000022628,2024-09-17T15:18:17,ACC00003677,Credit,1328.75,-338348.95,EUR,Amazon
TXN0000022629,2024-05-16T23:35:52,ACC00009120,Payment,718.85,-339067.8,USD,Target
TXN0000022630,2024-10-21T18:30:13,ACC00009128,ATM,1101.99,-340169.79,EUR,Online Store
TXN0000022631,2024-04-28T22:39:35,ACC00007078,Debit,106.7,-340276.49,EUR,Walmart
TXN0000022632,2024-10-20T18:18:08,ACC00000968,Transfer,1133.26,-339143.23,JPY,Online Store
TXN0000022633,2024-01-15T02:00:58,ACC00006593,ATM,918.89,-340062.12,JPY,Shell
TXN0000022634,2024-03-14T06:33:09,ACC00005442,Debit,404.44,-340466.56,GBP,Walmart
TXN0000022635,2024-08-03T19:40:38,ACC00000190,Credit,1896.53,-338570.03,JPY,Shell
TXN0000022636,2024-05-27T17:22:28,ACC00003054,Payment,1015.65,-339585.68,JPY,Target
TXN0000022637,2024-09-01T21:21:05,ACC00009862,Payment,1350.28,-340935.96,EUR,Shell
TXN0000022638,2024-06-20T00:40:00,ACC00005275,Payment,1740.5,-342676.46,EUR,Walmart
TXN0000022639,2024-01-30T14:14:40,ACC00008543,Payment,1145.61,-343822.07,GBP,Grocery
TXN0000022640,2024-08-30T14:46:42,ACC00006430,Transfer,1728.27,-342093.8,JPY,Amazon
TXN0000022641,2024-02-17T08:54:46,ACC00004937,Credit,1932.1,-340161.7,EUR,Grocery
TXN0000022642,2024-02-02T15:07:38,ACC00009371,ATM,163.57,-340325.27,JPY,Amazon
TXN0000022643,2024-05-28T22:12:10,ACC00000650,Transfer,1087.54,-339237.73,GBP,Target
TXN0000022644,2024-05-23T18:43:13,ACC00006062,Payment,789.53,-340027.26,GBP,Shell
TXN0000022645,2024-11-04T06:24:14,ACC00005580,ATM,187.64,-340214.9,USD,Online Store
TXN0000022646,2024-10-02T18:41:18,ACC00006352,ATM,1817.99,-342032.89,GBP,Starbucks
TXN0000022647,2024-12-08T09:23:33,ACC00000183,Transfer,47.47,-341985.42,JPY,Grocery
TXN0000022648,2024-03-12T01:46:59,ACC00002778,Credit,438.73,-341546.69,USD,Target
TXN0000022649,2024-06-16T17:17:47,ACC00009727,Transfer,1643.8,-339902.89,JPY,Restaurant
TXN0000022650,2024-04-28T21:02:12,ACC00003111,Payment,404.29,-340307.18,USD,Target
TXN0000022651,2024-07-09T13:23:13,ACC00004452,ATM,1601.34,-341908.52,USD,Shell
TXN0000022652,2024-06-06T10:42:24,ACC00004942,ATM,1725.29,-343633.81,GBP,Shell
TXN0000022653,2024-07-09T15:58:05,ACC00006046,Credit,751.59,-342882.22,EUR,Grocery
TXN0000022654,2024-05-13T13:31:57,ACC00007148,Transfer,1152.63,-341729.59,JPY,Restaurant
TXN0000022655,2024-01-05T17:05:55,ACC00004311,Transfer,309.41,-341420.18,USD,Amazon
TXN0000022656,2024-12-28T19:25:28,ACC00002290,Credit,1071.94,-340348.24,JPY,Amazon
TXN0000022657,2024-11-08T20:04:47,ACC00001034,ATM,1749.83,-342098.07,EUR,Shell
TXN0000022658,2024-01-06T10:48:51,ACC00009125,Payment,1145.43,-343243.5,JPY,Starbucks
TXN0000022659,2024-07-30T02:24:14,ACC00009452,Credit,639.76,-342603.74,USD,Restaurant
TXN0000022660,2024-05-27T13:42:33,ACC00006260,Credit,433.21,-342170.53,USD,Shell
TXN0000022661,2024-10-21T16:05:08,ACC00005346,ATM,1525.36,-343695.89,EUR,Online Store
TXN0000022662,2024-04-30T05:28:49,ACC00000643,Debit,1323.98,-345019.87,EUR,Target
TXN0000022663,2024-06-25T10:32:07,ACC00007410,Credit,827.77,-344192.1,USD,Walmart
TXN0000022664,2024-07-16T12:51:07,ACC00009622,Credit,1020.41,-343171.69,JPY,Restaurant
TXN0000022665,2024-01-23T06:48:11,ACC00009195,Transfer,785.26,-342386.43,EUR,Shell
TXN0000022666,2024-11-17T05:22:46,ACC00009173,Credit,1545.59,-340840.84,EUR,Restaurant
TXN0000022667,2024-06-12T05:24:30,ACC00007009,Transfer,1397.83,-339443.01,GBP,Shell
TXN0000022668,2024-06-20T16:04:01,ACC00007782,Transfer,1972.78,-337470.23,USD,Shell
TXN0000022669,2024-03-12T14:20:32,ACC00009513,ATM,58.04,-337528.27,JPY,Starbucks
TXN0000022670,2024-10-25T22:39:52,ACC00008564,Payment,181.25,-337709.52,EUR,Restaurant
TXN0000022671,2024-08-13T21:12:43,ACC00007296,Credit,123.76,-337585.76,JPY,Online Store
TXN0000022672,2024-08-08T10:32:29,ACC00001696,ATM,697.07,-338282.83,JPY,Amazon
TXN0000022673,2024-01-30T02:40:16,ACC00001845,Debit,52.32,-338335.15,GBP,Walmart
TXN0000022674,2024-09-11T03:44:22,ACC00004993,Credit,872.25,-337462.9,JPY,Walmart
TXN0000022675,2024-09-04T17:55:11,ACC00008492,Transfer,1212.71,-336250.19,GBP,Online Store
TXN0000022676,2024-07-14T18:03:14,ACC00005985,Transfer,1536.17,-334714.02,USD,Shell
TXN0000022677,2024-12-26T15:00:03,ACC00002358,Credit,1900.0,-332814.02,JPY,Amazon
TXN0000022678,2024-12-22T03:22:58,ACC00007163,Debit,1503.42,-334317.44,USD,Online Store
TXN0000022679,2024-12-28T04:12:47,ACC00003935,Transfer,1270.42,-333047.02,EUR,Amazon
TXN0000022680,2024-04-15T08:21:53,ACC00004151,Debit,295.16,-333342.18,USD,Amazon
TXN0000022681,2024-01-10T07:30:22,ACC00000396,Credit,1077.93,-332264.25,JPY,Amazon
TXN0000022682,2024-01-06T22:56:53,ACC00006175,Credit,99.16,-332165.09,EUR,Starbucks
TXN0000022683,2024-05-10T07:35:47,ACC00001776,Payment,612.45,-332777.54,EUR,Shell
TXN0000022684,2024-07-07T13:01:21,ACC00005992,ATM,1966.74,-334744.28,GBP,Online Store
TXN0000022685,2024-12-12T14:32:04,ACC00000220,Payment,1273.67,-336017.95,GBP,Shell
TXN0000022686,2024-07-07T05:26:06,ACC00008123,Transfer,973.16,-335044.79,USD,Grocery
TXN0000022687,2024-06-01T20:47:26,ACC00004005,Payment,369.03,-335413.82,JPY,Grocery
TXN0000022688,2024-09-08T03:29:00,ACC00003319,ATM,1241.55,-336655.37,EUR,Amazon
TXN0000022689,2024-06-06T07:37:53,ACC00000331,Debit,1423.97,-338079.34,EUR,Shell
TXN0000022690,2024-04-19T13:59:20,ACC00008458,Debit,1267.72,-339347.06,USD,Amazon
TXN0000022691,2024-12-13T00:33:21,ACC00006183,Transfer,447.75,-338899.31,USD,Starbucks
TXN0000022692,2024-03-17T06:25:20,ACC00008428,Debit,711.45,-339610.76,EUR,Amazon
TXN0000022693,2024-06-15T01:28:29,ACC00000399,Debit,501.89,-340112.65,JPY,Restaurant
TXN0000022694,2024-04-13T10:44:21,ACC00007169,Transfer,72.04,-340040.61,GBP,Restaurant
TXN0000022695,2024-12-23T20:07:12,ACC00001916,ATM,381.09,-340421.7,GBP,Grocery
TXN0000022696,2024-12-07T12:51:35,ACC00005447,ATM,356.85,-340778.55,GBP,Target
TXN0000022697,2024-01-04T19:50:24,ACC00000892,Debit,1077.3,-341855.85,EUR,Target
TXN0000022698,2024-07-13T08:06:35,ACC00002977,Debit,1955.99,-343811.84,GBP,Walmart
TXN0000022699,2024-01-06T17:50:12,ACC00003779,Transfer,529.47,-343282.37,JPY,Starbucks
TXN0000022700,2024-04-13T03:32:41,ACC00008813,Debit,1912.9,-345195.27,GBP,Restaurant
TXN0000022701,2024-08-02T06:37:39,ACC00001272,Payment,85.5,-345280.77,JPY,Amazon
TXN0000022702,2024-11-28T05:20:19,ACC00002822,ATM,1203.96,-346484.73,EUR,Restaurant
TXN0000022703,2024-10-04T23:18:13,ACC00000950,Debit,1669.51,-348154.24,USD,Shell
TXN0000022704,2024-08-07T22:53:01,ACC00001623,Credit,127.4,-348026.84,USD,Restaurant
TXN0000022705,2024-08-01T03:27:31,ACC00004864,Payment,448.62,-348475.46,USD,Restaurant
TXN0000022706,2024-03-21T03:33:26,ACC00009249,Debit,870.24,-349345.7,EUR,Online Store
TXN0000022707,2024-02-26T21:19:15,ACC00003303,Debit,1805.09,-351150.79,USD,Amazon
TXN0000022708,2024-09-09T01:42:53,ACC00003764,Debit,834.7,-351985.49,JPY,Shell
TXN0000022709,2024-03-15T04:38:19,ACC00007445,Transfer,207.53,-351777.96,USD,Starbucks
TXN0000022710,2024-09-16T15:57:38,ACC00002591,Credit,1245.81,-350532.15,GBP,Amazon
TXN0000022711,2024-03-20T05:33:17,ACC00002793,Payment,101.52,-350633.67,EUR,Target
TXN0000022712,2024-01-17T01:11:48,ACC00004087,Payment,210.15,-350843.82,USD,Target
TXN0000022713,2024-01-14T22:37:55,ACC00000769,Debit,1071.83,-351915.65,GBP,Shell
TXN0000022714,2024-07-21T19:36:00,ACC00004144,ATM,707.46,-352623.11,GBP,Starbucks
TXN0000022715,2024-08-31T18:30:25,ACC00000828,Debit,1908.12,-354531.23,JPY,Amazon
TXN0000022716,2024-09-22T00:22:17,ACC00006684,Credit,1044.89,-353486.34,GBP,Grocery
TXN0000022717,2024-10-03T22:14:53,ACC00005294,ATM,603.84,-354090.18,JPY,Online Store
TXN0000022718,2024-12-24T20:07:24,ACC00005982,Transfer,1860.05,-352230.13,EUR,Shell
TXN0000022719,2024-03-24T02:06:31,ACC00000591,Payment,1092.01,-353322.14,USD,Online Store
TXN0000022720,2024-01-06T20:08:39,ACC00006295,ATM,1978.36,-355300.5,USD,Walmart
TXN0000022721,2024-04-14T03:32:57,ACC00000209,Transfer,1910.33,-353390.17,GBP,Starbucks
TXN0000022722,2024-05-22T07:57:20,ACC00000812,ATM,1801.82,-355191.99,JPY,Shell
TXN0000022723,2024-12-13T16:05:38,ACC00009720,Debit,418.79,-355610.78,GBP,Online Store
TXN0000022724,2024-12-14T12:40:42,ACC00003195,ATM,1294.29,-356905.07,JPY,Walmart
TXN0000022725,2024-09-08T21:14:13,ACC00006876,Debit,610.7,-357515.77,EUR,Grocery
TXN0000022726,2024-01-16T00:59:03,ACC00002401,Credit,1971.35,-355544.42,GBP,Target
TXN0000022727,2024-05-16T03:53:10,ACC00005545,Debit,254.13,-355798.55,GBP,Grocery
TXN0000022728,2024-05-03T00:39:13,ACC00008982,Payment,204.02,-356002.57,JPY,Amazon
TXN0000022729,2024-02-13T21:52:12,ACC00001218,Credit,101.34,-355901.23,GBP,Starbucks
TXN0000022730,2024-03-26T07:52:32,ACC00009847,Credit,1374.94,-354526.29,JPY,Restaurant
TXN0000022731,2024-07-16T02:56:59,ACC00009215,Credit,1792.76,-352733.53,JPY,Starbucks
TXN0000022732,2024-05-26T00:16:35,ACC00001365,ATM,1687.03,-354420.56,EUR,Amazon
TXN0000022733,2024-04-09T23:44:28,ACC00005012,Payment,562.25,-354982.81,JPY,Walmart
TXN0000022734,2024-10-10T20:01:52,ACC00007568,ATM,670.0,-355652.81,GBP,Amazon
TXN0000022735,2024-06-06T20:38:12,ACC00003397,Payment,1882.29,-357535.1,EUR,Grocery
TXN0000022736,2024-01-23T14:00:46,ACC00002579,Transfer,712.29,-356822.81,JPY,Online Store
TXN0000022737,2024-01-11T03:40:33,ACC00008057,ATM,181.33,-357004.14,JPY,Walmart
TXN0000022738,2024-11-01T00:34:00,ACC00001652,Transfer,847.16,-356156.98,JPY,Target
TXN0000022739,2024-11-07T13:22:47,ACC00009717,ATM,1038.64,-357195.62,USD,Shell
TXN0000022740,2024-02-04T23:52:15,ACC00008883,Payment,840.55,-358036.17,USD,Walmart
TXN0000022741,2024-05-15T00:12:30,ACC00004533,Transfer,1460.16,-356576.01,JPY,Restaurant
TXN0000022742,2024-01-05T03:57:57,ACC00005365,ATM,948.74,-357524.75,USD,Restaurant
TXN0000022743,2024-09-28T10:16:45,ACC00002649,ATM,918.1,-358442.85,EUR,Grocery
TXN0000022744,2024-03-29T05:51:53,ACC00000209,ATM,1950.05,-360392.9,JPY,Starbucks
TXN0000022745,2024-09-15T17:35:21,ACC00007533,Credit,480.29,-359912.61,GBP,Target
TXN0000022746,2024-09-20T20:09:05,ACC00008850,Credit,1668.94,-358243.67,EUR,Shell
TXN0000022747,2024-06-24T22:27:47,ACC00006364,ATM,988.12,-359231.79,JPY,Online Store
TXN0000022748,2024-12-18T16:30:31,ACC00007256,ATM,466.94,-359698.73,GBP,Grocery
TXN0000022749,2024-10-04T06:32:05,ACC00002047,ATM,667.04,-360365.77,EUR,Target
TXN0000022750,2024-07-10T16:56:00,ACC00003093,Credit,1969.8,-358395.97,USD,Walmart
TXN0000022751,2024-01-22T21:33:19,ACC00006049,Credit,1388.52,-357007.45,USD,Online Store
TXN0000022752,2024-07-18T11:43:16,ACC00006673,Transfer,1605.53,-355401.92,GBP,Starbucks
TXN0000022753,2024-01-15T13:54:47,ACC00002528,Debit,1438.08,-356840.0,EUR,Walmart
TXN0000022754,2024-02-29T12:05:11,ACC00001209,Credit,1031.29,-355808.71,EUR,Amazon
TXN0000022755,2024-01-25T19:14:44,ACC00007647,Transfer,371.43,-355437.28,GBP,Amazon
TXN0000022756,2024-01-02T04:24:22,ACC00004782,Debit,1057.6,-356494.88,GBP,Restaurant
TXN0000022757,2024-06-26T17:45:27,ACC00003148,Payment,1730.52,-358225.4,GBP,Restaurant
TXN0000022758,2024-12-21T19:28:21,ACC00009339,Debit,1750.54,-359975.94,EUR,Amazon
TXN0000022759,2024-10-31T09:14:58,ACC00006586,Debit,1388.32,-361364.26,USD,Shell
TXN0000022760,2024-04-17T04:25:07,ACC00009059,ATM,1817.82,-363182.08,JPY,Amazon
TXN0000022761,2024-01-17T17:59:57,ACC00002909,Payment,1727.12,-364909.2,EUR,Online Store
TXN0000022762,2024-10-08T07:39:07,ACC00005188,Payment,408.09,-365317.29,JPY,Amazon
TXN0000022763,2024-06-02T08:45:30,ACC00002221,Credit,1168.96,-364148.33,USD,Starbucks
TXN0000022764,2024-04-05T16:23:17,ACC00001406,Payment,1808.58,-365956.91,EUR,Grocery
TXN0000022765,2024-11-08T12:20:06,ACC00008659,Transfer,1095.05,-364861.86,JPY,Restaurant
TXN0000022766,2024-03-18T20:33:22,ACC00009044,ATM,1332.52,-366194.38,GBP,Grocery
TXN0000022767,2024-03-12T01:42:19,ACC00004712,Credit,1833.24,-364361.14,GBP,Target
TXN0000022768,2024-09-16T16:23:28,ACC00007790,ATM,696.14,-365057.28,GBP,Shell
TXN0000022769,2024-05-23T08:12:58,ACC00008592,Transfer,1324.85,-363732.43,EUR,Amazon
TXN0000022770,2024-01-07T13:27:41,ACC00009196,Debit,316.45,-364048.88,EUR,Walmart
TXN0000022771,2024-03-13T20:24:13,ACC00005978,Credit,1915.69,-362133.19,GBP,Shell
TXN0000022772,2024-09-05T20:05:51,ACC00002354,Debit,1193.25,-363326.44,GBP,Online Store
TXN0000022773,2024-12-28T08:57:36,ACC00007744,ATM,626.25,-363952.69,USD,Online Store
TXN0000022774,2024-02-19T16:31:59,ACC00003190,ATM,394.86,-364347.55,JPY,Online Store
TXN0000022775,2024-09-24T13:28:09,ACC00004286,ATM,674.97,-365022.52,EUR,Starbucks
TXN0000022776,2024-02-19T09:39:03,ACC00000648,Payment,888.47,-365910.99,EUR,Amazon
TXN0000022777,2024-04-01T10:22:47,ACC00006949,ATM,1343.38,-367254.37,USD,Starbucks
TXN0000022778,2024-11-18T22:29:35,ACC00000511,Transfer,1182.74,-366071.63,GBP,Target
TXN0000022779,2024-07-24T06:00:35,ACC00004201,Credit,577.99,-365493.64,JPY,Grocery
TXN0000022780,2024-08-19T13:46:39,ACC00004599,ATM,1683.4,-367177.04,JPY,Grocery
TXN0000022781,2024-04-01T07:00:57,ACC00005348,Transfer,130.17,-367046.87,EUR,Shell
TXN0000022782,2024-02-05T04:18:37,ACC00008587,Debit,1314.46,-368361.33,JPY,Walmart
TXN0000022783,2024-07-24T00:15:32,ACC00000687,Credit,1065.88,-367295.45,GBP,Starbucks
TXN0000022784,2024-09-03T13:06:36,ACC00002366,Payment,1563.31,-368858.76,JPY,Amazon
TXN0000022785,2024-07-18T11:33:37,ACC00004009,Transfer,987.81,-367870.95,USD,Walmart
TXN0000022786,2024-11-13T08:44:12,ACC00001808,Payment,479.8,-368350.75,USD,Online Store
TXN0000022787,2024-05-19T07:42:24,ACC00004960,ATM,1705.06,-370055.81,EUR,Online Store
TXN0000022788,2024-01-13T21:41:11,ACC00003605,Credit,401.08,-369654.73,GBP,Online Store
TXN0000022789,2024-04-14T12:59:47,ACC00006646,ATM,269.14,-369923.87,EUR,Grocery
TXN0000022790,2024-07-25T17:44:44,ACC00003818,Transfer,545.42,-369378.45,USD,Grocery
TXN0000022791,2024-06-10T08:31:21,ACC00007608,ATM,823.07,-370201.52,EUR,Shell
TXN0000022792,2024-02-13T19:25:35,ACC00001018,Payment,215.2,-370416.72,USD,Amazon
TXN0000022793,2024-06-05T12:01:02,ACC00009267,Debit,59.0,-370475.72,EUR,Shell
TXN0000022794,2024-01-11T04:08:45,ACC00004365,Credit,1001.14,-369474.58,EUR,Online Store
TXN0000022795,2024-04-26T04:06:22,ACC00007950,Transfer,1437.87,-368036.71,JPY,Online Store
TXN0000022796,2024-11-01T22:11:26,ACC00009649,Payment,1460.73,-369497.44,GBP,Walmart
TXN0000022797,2024-05-01T11:00:43,ACC00005319,Credit,222.64,-369274.8,JPY,Target
TXN0000022798,2024-01-29T07:13:30,ACC00005700,Credit,814.65,-368460.15,EUR,Grocery
TXN0000022799,2024-06-27T20:06:48,ACC00007783,ATM,394.46,-368854.61,USD,Grocery
TXN0000022800,2024-10-13T16:45:38,ACC00006094,Transfer,445.64,-368408.97,JPY,Walmart
TXN0000022801,2024-03-25T23:47:49,ACC00003742,Credit,1286.31,-367122.66,EUR,Grocery
TXN0000022802,2024-06-01T21:49:36,ACC00004494,Payment,1290.42,-368413.08,USD,Target
TXN0000022803,2024-01-25T03:17:33,ACC00009662,Transfer,46.5,-368366.58,GBP,Restaurant
TXN0000022804,2024-09-30T21:01:49,ACC00006331,Transfer,1688.25,-366678.33,USD,Restaurant
TXN0000022805,2024-07-01T13:24:14,ACC00005381,Debit,1289.4,-367967.73,EUR,Shell
TXN0000022806,2024-11-15T19:36:49,ACC00005828,ATM,859.1,-368826.83,EUR,Online Store
TXN0000022807,2024-10-29T16:33:35,ACC00000837,Credit,938.98,-367887.85,USD,Restaurant
TXN0000022808,2024-02-27T08:35:00,ACC00007834,Payment,1883.09,-369770.94,GBP,Grocery
TXN0000022809,2024-12-27T10:57:24,ACC00009471,Credit,1400.38,-368370.56,EUR,Starbucks
TXN0000022810,2024-04-01T10:34:01,ACC00008137,Credit,403.99,-367966.57,EUR,Target
TXN0000022811,2024-08-01T16:18:10,ACC00008122,Transfer,1783.78,-366182.79,EUR,Shell
TXN0000022812,2024-04-26T03:56:19,ACC00007870,Credit,394.76,-365788.03,GBP,Walmart
TXN0000022813,2024-06-13T15:04:04,ACC00009994,Transfer,945.9,-364842.13,JPY,Amazon
TXN0000022814,2024-02-22T23:00:30,ACC00004643,Payment,802.58,-365644.71,USD,Amazon
TXN0000022815,2024-10-02T15:19:12,ACC00006881,Transfer,710.21,-364934.5,JPY,Grocery
TXN0000022816,2024-08-01T13:59:51,ACC00007130,Payment,1231.36,-366165.86,JPY,Walmart
TXN0000022817,2024-02-08T19:57:51,ACC00008093,ATM,876.68,-367042.54,USD,Starbucks
TXN0000022818,2024-11-05T03:10:44,ACC00002994,Transfer,983.87,-366058.67,EUR,Target
TXN0000022819,2024-02-10T22:55:12,ACC00000929,Payment,1128.83,-367187.5,EUR,Shell
TXN0000022820,2024-08-28T09:31:03,ACC00004618,Payment,1151.4,-368338.9,JPY,Amazon
TXN0000022821,2024-11-16T21:01:09,ACC00001574,Debit,857.42,-369196.32,EUR,Amazon
TXN0000022822,2024-01-25T01:26:56,ACC00004407,Debit,1809.08,-371005.4,JPY,Online Store
TXN0000022823,2024-11-05T22:27:43,ACC00009693,Credit,1814.72,-369190.68,EUR,Starbucks
TXN0000022824,2024-11-11T09:51:33,ACC00005717,Transfer,776.11,-368414.57,USD,Amazon
TXN0000022825,2024-07-27T20:47:20,ACC00006149,Payment,241.47,-368656.04,JPY,Target
TXN0000022826,2024-03-03T05:42:45,ACC00001275,Transfer,856.76,-367799.28,USD,Grocery
TXN0000022827,2024-12-07T08:27:32,ACC00002026,Transfer,561.36,-367237.92,EUR,Grocery
TXN0000022828,2024-09-23T13:09:31,ACC00001788,Credit,741.76,-366496.16,JPY,Shell
TXN0000022829,2024-09-17T21:25:38,ACC00004538,Debit,1141.81,-367637.97,EUR,Shell
TXN0000022830,2024-08-28T04:07:12,ACC00007127,Payment,152.77,-367790.74,EUR,Grocery
TXN0000022831,2024-10-07T15:53:41,ACC00008857,Debit,1407.27,-369198.01,GBP,Grocery
TXN0000022832,2024-10-17T14:06:39,ACC00007518,ATM,448.56,-369646.57,GBP,Restaurant
TXN0000022833,2024-11-25T11:35:01,ACC00003688,Debit,381.21,-370027.78,JPY,Shell
TXN0000022834,2024-11-27T01:21:01,ACC00009966,ATM,232.04,-370259.82,GBP,Amazon
TXN0000022835,2024-02-26T07:14:06,ACC00001931,Credit,56.25,-370203.57,USD,Grocery
TXN0000022836,2024-11-04T10:05:25,ACC00007111,ATM,374.62,-370578.19,EUR,Online Store
TXN0000022837,2024-03-02T14:46:59,ACC00004448,Debit,1692.85,-372271.04,JPY,Shell
TXN0000022838,2024-02-03T22:19:29,ACC00000043,ATM,1995.78,-374266.82,JPY,Restaurant
TXN0000022839,2024-11-24T03:45:00,ACC00005956,Payment,1878.35,-376145.17,EUR,Online Store
TXN0000022840,2024-02-23T01:58:04,ACC00008813,Transfer,1307.06,-374838.11,EUR,Starbucks
TXN0000022841,2024-12-17T15:09:33,ACC00008365,Transfer,802.58,-374035.53,EUR,Restaurant
TXN0000022842,2024-07-10T13:16:14,ACC00001732,Payment,233.44,-374268.97,EUR,Amazon
TXN0000022843,2024-12-27T12:59:07,ACC00001130,Credit,1967.96,-372301.01,EUR,Online Store
TXN0000022844,2024-11-21T05:11:10,ACC00005382,Payment,891.26,-373192.27,USD,Amazon
TXN0000022845,2024-12-29T07:58:08,ACC00000002,Credit,346.52,-372845.75,EUR,Amazon
TXN0000022846,2024-04-02T11:35:21,ACC00008729,Debit,1849.55,-374695.3,JPY,Amazon
TXN0000022847,2024-03-04T18:45:23,ACC00007209,Transfer,1836.58,-372858.72,GBP,Online Store
TXN0000022848,2024-07-11T14:08:14,ACC00006526,Transfer,1639.07,-371219.65,USD,Walmart
TXN0000022849,2024-12-06T19:44:04,ACC00008201,Payment,1846.62,-373066.27,GBP,Walmart
TXN0000022850,2024-01-09T04:08:56,ACC00008841,Credit,1825.61,-371240.66,EUR,Amazon
TXN0000022851,2024-06-27T00:55:35,ACC00008020,Debit,1214.45,-372455.11,JPY,Amazon
TXN0000022852,2024-03-16T20:18:31,ACC00009780,Transfer,1668.98,-370786.13,GBP,Grocery
TXN0000022853,2024-07-18T02:30:47,ACC00002857,Credit,1312.16,-369473.97,GBP,Shell
TXN0000022854,2024-09-24T01:03:57,ACC00005855,Credit,1214.99,-368258.98,EUR,Shell
TXN0000022855,2024-09-30T02:50:33,ACC00005468,Transfer,913.99,-367344.99,USD,Starbucks
TXN0000022856,2024-04-16T07:50:45,ACC00007978,Payment,820.5,-368165.49,EUR,Shell
TXN0000022857,2024-07-01T15:38:24,ACC00009575,Debit,1294.58,-369460.07,GBP,Walmart
TXN0000022858,2024-05-02T12:42:46,ACC00007560,ATM,1583.52,-371043.59,USD,Amazon
TXN0000022859,2024-09-16T18:32:42,ACC00002999,Debit,1456.31,-372499.9,EUR,Starbucks
TXN0000022860,2024-04-20T07:02:28,ACC00005816,Payment,1656.33,-374156.23,JPY,Shell
TXN0000022861,2024-03-11T13:16:47,ACC00007506,Credit,1841.3,-372314.93,GBP,Walmart
TXN0000022862,2024-04-15T13:48:37,ACC00001896,ATM,557.44,-372872.37,GBP,Shell
TXN0000022863,2024-10-25T04:59:14,ACC00000605,ATM,374.17,-373246.54,EUR,Starbucks
TXN0000022864,2024-08-20T22:29:54,ACC00002705,ATM,342.18,-373588.72,USD,Restaurant
TXN0000022865,2024-04-21T10:31:35,ACC00000949,Debit,1931.27,-375519.99,EUR,Starbucks
TXN0000022866,2024-12-19T23:00:22,ACC00000674,Transfer,563.53,-374956.46,USD,Walmart
TXN0000022867,2024-11-08T19:20:47,ACC00003294,Transfer,952.02,-374004.44,EUR,Online Store
TXN0000022868,2024-01-13T20:14:38,ACC00007138,Payment,1097.06,-375101.5,EUR,Starbucks
TXN0000022869,2024-04-29T02:59:37,ACC00004571,Transfer,890.05,-374211.45,USD,Shell
TXN0000022870,2024-01-22T05:05:37,ACC00005927,Transfer,538.22,-373673.23,GBP,Target
TXN0000022871,2024-09-18T12:30:57,ACC00009815,ATM,1500.71,-375173.94,JPY,Target
TXN0000022872,2024-02-02T20:13:43,ACC00006216,ATM,77.43,-375251.37,USD,Grocery
TXN0000022873,2024-03-15T00:03:48,ACC00007328,Transfer,1094.33,-374157.04,EUR,Amazon
TXN0000022874,2024-08-16T03:21:23,ACC00007806,Debit,290.97,-374448.01,USD,Shell
TXN0000022875,2024-03-29T23:28:52,ACC00003081,Credit,64.68,-374383.33,JPY,Walmart
TXN0000022876,2024-10-12T20:07:22,ACC00004784,Debit,1704.6,-376087.93,EUR,Grocery
TXN0000022877,2024-12-05T01:35:38,ACC00004093,ATM,925.46,-377013.39,EUR,Walmart
TXN0000022878,2024-04-07T01:14:24,ACC00002506,Debit,1472.4,-378485.79,JPY,Target
TXN0000022879,2024-05-19T12:52:02,ACC00007606,Credit,1817.05,-376668.74,USD,Starbucks
TXN0000022880,2024-07-25T02:22:52,ACC00006705,ATM,640.56,-377309.3,EUR,Grocery
TXN0000022881,2024-10-14T00:08:33,ACC00005967,Debit,327.23,-377636.53,EUR,Shell
TXN0000022882,2024-05-18T09:36:10,ACC00007352,Transfer,1743.25,-375893.28,EUR,Walmart
TXN0000022883,2024-09-01T13:24:52,ACC00003940,Payment,1076.58,-376969.86,GBP,Walmart
TXN0000022884,2024-10-10T00:51:07,ACC00004761,ATM,659.49,-377629.35,USD,Online Store
TXN0000022885,2024-04-04T21:25:01,ACC00005851,ATM,903.97,-378533.32,USD,Walmart
TXN0000022886,2024-10-26T18:33:18,ACC00003528,Payment,1870.06,-380403.38,GBP,Online Store
TXN0000022887,2024-02-26T16:18:02,ACC00006486,Credit,1091.66,-379311.72,USD,Target
TXN0000022888,2024-08-28T19:47:26,ACC00006974,Debit,1955.18,-381266.9,USD,Amazon
TXN0000022889,2024-04-19T01:46:09,ACC00000415,Debit,414.94,-381681.84,JPY,Walmart
TXN0000022890,2024-07-10T21:04:47,ACC00009934,Transfer,906.62,-380775.22,USD,Shell
TXN0000022891,2024-05-03T11:43:34,ACC00000637,Transfer,1360.47,-379414.75,GBP,Grocery
TXN0000022892,2024-07-08T22:27:12,ACC00004682,Payment,381.99,-379796.74,GBP,Online Store
TXN0000022893,2024-12-09T09:20:43,ACC00006291,Debit,880.02,-380676.76,GBP,Online Store
TXN0000022894,2024-03-04T17:38:06,ACC00006620,Payment,952.79,-381629.55,USD,Online Store
TXN0000022895,2024-08-30T06:17:40,ACC00000439,Credit,449.61,-381179.94,JPY,Shell
TXN0000022896,2024-05-31T10:15:31,ACC00006248,Payment,1345.76,-382525.7,EUR,Online Store
TXN0000022897,2024-12-05T03:20:06,ACC00004573,ATM,1099.49,-383625.19,USD,Shell
TXN0000022898,2024-08-30T09:46:45,ACC00002603,Debit,1889.12,-385514.31,GBP,Grocery
TXN0000022899,2024-09-27T05:21:34,ACC00009429,Debit,1947.25,-387461.56,GBP,Shell
TXN0000022900,2024-11-02T04:28:41,ACC00004158,Payment,114.81,-387576.37,JPY,Amazon
TXN0000022901,2024-07-08T07:26:00,ACC00006671,Debit,1525.58,-389101.95,EUR,Restaurant
TXN0000022902,2024-01-12T21:20:32,ACC00003423,Credit,1532.41,-387569.54,USD,Walmart
TXN0000022903,2024-09-17T10:23:05,ACC00005616,Transfer,230.99,-387338.55,EUR,Amazon
TXN0000022904,2024-04-19T14:10:59,ACC00002561,ATM,1071.45,-388410.0,USD,Walmart
TXN0000022905,2024-01-24T21:48:43,ACC00001959,Payment,410.83,-388820.83,USD,Target
TXN0000022906,2024-09-06T17:40:42,ACC00009434,Debit,977.14,-389797.97,USD,Amazon
TXN0000022907,2024-12-01T00:24:52,ACC00003160,Transfer,1746.55,-388051.42,USD,Starbucks
TXN0000022908,2024-03-28T02:30:11,ACC00003007,Credit,1780.22,-386271.2,JPY,Restaurant
TXN0000022909,2024-03-26T16:22:47,ACC00002478,Payment,1092.33,-387363.53,USD,Target
TXN0000022910,2024-05-03T18:46:05,ACC00007839,Credit,1996.43,-385367.1,EUR,Grocery
TXN0000022911,2024-04-27T11:44:14,ACC00006774,Debit,529.12,-385896.22,GBP,Amazon
TXN0000022912,2024-04-17T10:47:38,ACC00008049,Transfer,46.37,-385849.85,GBP,Amazon
TXN0000022913,2024-04-19T00:47:56,ACC00007358,Payment,1751.2,-387601.05,JPY,Walmart
TXN0000022914,2024-09-01T08:18:08,ACC00005894,Credit,288.74,-387312.31,USD,Restaurant
TXN0000022915,2024-04-08T04:01:02,ACC00004300,Payment,1798.76,-389111.07,GBP,Amazon
TXN0000022916,2024-09-01T04:00:21,ACC00006984,Transfer,512.72,-388598.35,USD,Restaurant
TXN0000022917,2024-01-02T23:28:35,ACC00004442,Debit,1134.96,-389733.31,USD,Grocery
TXN0000022918,2024-11-08T16:29:39,ACC00009240,Transfer,1491.33,-388241.98,USD,Grocery
TXN0000022919,2024-06-09T10:05:53,ACC00009403,Credit,1357.49,-386884.49,USD,Starbucks
TXN0000022920,2024-05-12T01:25:28,ACC00006861,ATM,919.67,-387804.16,JPY,Starbucks
TXN0000022921,2024-02-21T15:21:17,ACC00000696,ATM,821.18,-388625.34,GBP,Online Store
TXN0000022922,2024-12-14T06:51:06,ACC00006523,Debit,1002.37,-389627.71,GBP,Starbucks
TXN0000022923,2024-05-21T04:42:50,ACC00004217,Credit,1622.82,-388004.89,EUR,Target
TXN0000022924,2024-09-07T03:46:51,ACC00007905,Transfer,451.0,-387553.89,EUR,Restaurant
TXN0000022925,2024-07-23T01:17:18,ACC00002805,ATM,429.47,-387983.36,GBP,Restaurant
TXN0000022926,2024-12-24T11:30:12,ACC00000198,Debit,313.24,-388296.6,USD,Online Store
TXN0000022927,2024-08-10T15:46:01,ACC00006728,Transfer,1168.45,-387128.15,JPY,Target
TXN0000022928,2024-07-15T19:13:10,ACC00007327,Payment,1976.8,-389104.95,GBP,Shell
TXN0000022929,2024-04-03T23:14:29,ACC00003572,Transfer,1150.64,-387954.31,JPY,Shell
TXN0000022930,2024-07-31T14:15:20,ACC00006677,Debit,1790.6,-389744.91,JPY,Target
TXN0000022931,2024-09-09T06:11:32,ACC00003777,Debit,1867.31,-391612.22,JPY,Restaurant
TXN0000022932,2024-07-23T23:50:20,ACC00001209,ATM,741.52,-392353.74,USD,Online Store
TXN0000022933,2024-03-12T00:07:21,ACC00008014,Payment,1877.45,-394231.19,GBP,Starbucks
TXN0000022934,2024-03-13T22:25:43,ACC00001122,ATM,1993.29,-396224.48,EUR,Grocery
TXN0000022935,2024-10-21T20:47:51,ACC00002747,ATM,1639.7,-397864.18,GBP,Target
TXN0000022936,2024-12-29T00:34:33,ACC00007014,Transfer,985.29,-396878.89,GBP,Amazon
TXN0000022937,2024-06-04T22:27:47,ACC00004516,ATM,1874.85,-398753.74,USD,Grocery
TXN0000022938,2024-10-12T01:15:12,ACC00003272,Debit,1654.31,-400408.05,JPY,Starbucks
TXN0000022939,2024-05-11T21:03:15,ACC00002747,ATM,706.81,-401114.86,JPY,Restaurant
TXN0000022940,2024-08-20T01:00:16,ACC00004769,Credit,682.48,-400432.38,EUR,Walmart
TXN0000022941,2024-05-28T16:17:42,ACC00006598,Credit,1983.66,-398448.72,JPY,Grocery
TXN0000022942,2024-01-14T18:50:30,ACC00003180,ATM,1079.51,-399528.23,JPY,Walmart
TXN0000022943,2024-10-19T11:56:06,ACC00006002,ATM,118.3,-399646.53,JPY,Amazon
TXN0000022944,2024-02-28T17:26:44,ACC00007736,Transfer,1672.77,-397973.76,JPY,Amazon
TXN0000022945,2024-07-06T00:20:14,ACC00001026,Payment,1228.51,-399202.27,USD,Walmart
TXN0000022946,2024-02-06T19:56:21,ACC00007566,Transfer,1770.72,-397431.55,GBP,Online Store
TXN0000022947,2024-12-11T14:56:48,ACC00003266,Payment,837.92,-398269.47,USD,Restaurant
TXN0000022948,2024-05-02T15:58:57,ACC00002322,Credit,963.5,-397305.97,JPY,Walmart
TXN0000022949,2024-04-30T22:16:34,ACC00001104,Payment,757.85,-398063.82,EUR,Shell
TXN0000022950,2024-12-12T22:59:01,ACC00000013,Transfer,834.62,-397229.2,GBP,Walmart
TXN0000022951,2024-07-07T11:58:36,ACC00002163,ATM,393.81,-397623.01,GBP,Target
TXN0000022952,2024-08-12T13:20:43,ACC00001594,Payment,1281.92,-398904.93,GBP,Grocery
TXN0000022953,2024-01-23T10:40:55,ACC00009224,Debit,1646.39,-400551.32,GBP,Grocery
TXN0000022954,2024-04-07T23:01:47,ACC00009888,Payment,1590.02,-402141.34,USD,Starbucks
TXN0000022955,2024-12-10T22:02:23,ACC00002098,Transfer,648.86,-401492.48,USD,Starbucks
TXN0000022956,2024-01-13T15:57:30,ACC00006589,Payment,137.36,-401629.84,EUR,Starbucks
TXN0000022957,2024-07-03T08:06:07,ACC00007939,Credit,517.68,-401112.16,GBP,Restaurant
TXN0000022958,2024-06-23T15:18:49,ACC00005530,Transfer,1084.14,-400028.02,JPY,Shell
TXN0000022959,2024-05-04T17:10:24,ACC00003202,Transfer,1655.81,-398372.21,JPY,Restaurant
TXN0000022960,2024-09-11T06:27:12,ACC00004082,Transfer,692.99,-397679.22,JPY,Walmart
TXN0000022961,2024-11-07T06:33:58,ACC00006005,Transfer,1011.53,-396667.69,GBP,Shell
TXN0000022962,2024-11-15T04:52:14,ACC00009620,Payment,1291.71,-397959.4,USD,Restaurant
TXN0000022963,2024-11-17T01:51:48,ACC00007738,Credit,816.27,-397143.13,USD,Online Store
TXN0000022964,2024-10-09T23:57:14,ACC00003869,Payment,697.38,-397840.51,JPY,Walmart
TXN0000022965,2024-12-03T02:07:51,ACC00004417,ATM,64.56,-397905.07,GBP,Amazon
TXN0000022966,2024-10-15T12:21:53,ACC00007371,Debit,580.76,-398485.83,JPY,Walmart
TXN0000022967,2024-03-28T17:18:05,ACC00008556,Debit,1558.34,-400044.17,JPY,Starbucks
TXN0000022968,2024-09-22T04:04:40,ACC00003193,Debit,1505.46,-401549.63,JPY,Shell
TXN0000022969,2024-07-07T08:06:30,ACC00005775,Debit,767.53,-402317.16,GBP,Starbucks
TXN0000022970,2024-07-06T05:31:31,ACC00003899,Debit,351.05,-402668.21,EUR,Online Store
TXN0000022971,2024-11-26T11:06:18,ACC00005215,ATM,61.1,-402729.31,GBP,Online Store
TXN0000022972,2024-04-13T06:09:31,ACC00005567,Payment,931.15,-403660.46,JPY,Walmart
TXN0000022973,2024-08-25T04:29:31,ACC00004340,Debit,660.04,-404320.5,JPY,Online Store
TXN0000022974,2024-07-09T15:54:02,ACC00001218,Credit,668.96,-403651.54,USD,Walmart
TXN0000022975,2024-11-05T18:53:44,ACC00003175,Payment,1927.1,-405578.64,USD,Restaurant
TXN0000022976,2024-05-15T10:47:06,ACC00001477,Debit,1342.51,-406921.15,GBP,Online Store
TXN0000022977,2024-01-28T14:24:40,ACC00006358,Transfer,1799.56,-405121.59,JPY,Shell
TXN0000022978,2024-06-09T12:15:18,ACC00009099,Debit,417.39,-405538.98,GBP,Walmart
TXN0000022979,2024-05-19T21:14:04,ACC00000247,Payment,1935.54,-407474.52,GBP,Grocery
TXN0000022980,2024-05-18T03:05:36,ACC00007935,ATM,104.38,-407578.9,USD,Online Store
TXN0000022981,2024-05-04T18:25:30,ACC00009110,Credit,707.8,-406871.1,JPY,Target
TXN0000022982,2024-10-13T09:25:36,ACC00000094,Debit,226.75,-407097.85,JPY,Starbucks
TXN0000022983,2024-03-17T14:27:19,ACC00007730,Transfer,682.34,-406415.51,EUR,Online Store
TXN0000022984,2024-04-07T21:57:20,ACC00000527,ATM,970.0,-407385.51,USD,Restaurant
TXN0000022985,2024-05-18T10:48:00,ACC00003954,Debit,534.65,-407920.16,JPY,Target
TXN0000022986,2024-10-11T02:12:10,ACC00008808,Debit,1193.89,-409114.05,USD,Shell
TXN0000022987,2024-02-17T18:09:30,ACC00007900,Debit,1361.11,-410475.16,EUR,Grocery
TXN0000022988,2024-04-07T15:02:43,ACC00002739,Credit,663.22,-409811.94,GBP,Walmart
TXN0000022989,2024-01-23T15:47:31,ACC00006470,Credit,1948.65,-407863.29,GBP,Starbucks
TXN0000022990,2024-01-07T07:33:17,ACC00008985,ATM,1884.77,-409748.06,EUR,Amazon
TXN0000022991,2024-05-20T06:22:42,ACC00008449,Transfer,1151.44,-408596.62,GBP,Amazon
TXN0000022992,2024-10-14T11:47:01,ACC00007201,Payment,1006.78,-409603.4,EUR,Grocery
TXN0000022993,2024-01-10T00:46:34,ACC00000179,Transfer,881.56,-408721.84,EUR,Restaurant
TXN0000022994,2024-04-01T20:22:36,ACC00009258,Debit,1716.55,-410438.39,GBP,Shell
TXN0000022995,2024-06-19T16:40:19,ACC00006115,Transfer,32.47,-410405.92,USD,Shell
TXN0000022996,2024-08-20T14:47:19,ACC00000551,Transfer,1604.65,-408801.27,USD,Online Store
TXN0000022997,2024-07-09T15:18:13,ACC00006846,Debit,1980.14,-410781.41,EUR,Target
TXN0000022998,2024-12-01T07:31:23,ACC00007271,Debit,1201.91,-411983.32,JPY,Shell
TXN0000022999,2024-06-22T06:37:28,ACC00008959,Debit,447.31,-412430.63,USD,Target
TXN0000023000,2024-11-10T21:00:55,ACC00004791,ATM,1326.92,-413757.55,GBP,Restaurant
TXN0000023001,2024-03-11T05:34:35,ACC00001869,Payment,881.75,-414639.3,EUR,Restaurant
TXN0000023002,2024-11-29T05:56:58,ACC00001070,ATM,767.03,-415406.33,USD,Shell
TXN0000023003,2024-03-13T00:41:47,ACC00006752,Credit,1712.79,-413693.54,USD,Target
TXN0000023004,2024-06-14T01:49:10,ACC00008247,Credit,1101.13,-412592.41,USD,Target
TXN0000023005,2024-06-02T09:17:05,ACC00007535,Transfer,834.91,-411757.5,GBP,Amazon
TXN0000023006,2024-01-31T02:34:15,ACC00004288,Debit,12.11,-411769.61,EUR,Target
TXN0000023007,2024-08-16T10:05:57,ACC00003323,Payment,1300.17,-413069.78,EUR,Grocery
TXN0000023008,2024-07-23T06:01:36,ACC00008129,ATM,1072.19,-414141.97,USD,Starbucks
TXN0000023009,2024-01-19T04:56:59,ACC00006005,Transfer,1000.95,-413141.02,GBP,Shell
TXN0000023010,2024-02-15T15:37:19,ACC00001668,Credit,315.95,-412825.07,USD,Starbucks
TXN0000023011,2024-12-06T16:35:56,ACC00007878,Debit,1075.61,-413900.68,GBP,Online Store
TXN0000023012,2024-01-01T13:05:43,ACC00003304,ATM,165.04,-414065.72,JPY,Shell
TXN0000023013,2024-04-18T00:43:25,ACC00008264,ATM,1974.64,-416040.36,JPY,Shell
TXN0000023014,2024-10-25T05:49:39,ACC00000800,Payment,763.54,-416803.9,EUR,Restaurant
TXN0000023015,2024-11-03T05:47:45,ACC00000918,Debit,1478.53,-418282.43,USD,Starbucks
TXN0000023016,2024-07-17T04:53:06,ACC00002392,Credit,182.38,-418100.05,EUR,Walmart
TXN0000023017,2024-05-25T16:56:26,ACC00006468,ATM,148.19,-418248.24,USD,Restaurant
TXN0000023018,2024-12-08T05:02:27,ACC00004846,ATM,782.06,-419030.3,JPY,Starbucks
TXN0000023019,2024-05-07T20:27:51,ACC00001204,Credit,349.99,-418680.31,GBP,Grocery
TXN0000023020,2024-04-16T18:50:50,ACC00000085,Transfer,1455.88,-417224.43,JPY,Online Store
TXN0000023021,2024-12-21T19:09:50,ACC00004036,Transfer,1791.98,-415432.45,USD,Shell
TXN0000023022,2024-09-07T19:45:08,ACC00002580,Credit,239.58,-415192.87,GBP,Shell
TXN0000023023,2024-08-19T14:15:06,ACC00001643,Debit,1951.58,-417144.45,JPY,Online Store
TXN0000023024,2024-04-20T04:31:52,ACC00006972,Debit,1697.67,-418842.12,JPY,Starbucks
TXN0000023025,2024-02-12T15:51:05,ACC00000313,Transfer,995.94,-417846.18,USD,Restaurant
TXN0000023026,2024-08-27T17:12:13,ACC00003419,Credit,1776.6,-416069.58,EUR,Online Store
TXN0000023027,2024-06-11T10:13:13,ACC00000595,Debit,1809.26,-417878.84,GBP,Target
TXN0000023028,2024-01-09T13:05:48,ACC00002215,Payment,1124.95,-419003.79,USD,Starbucks
TXN0000023029,2024-08-26T07:55:36,ACC00004604,Debit,1545.67,-420549.46,EUR,Restaurant
TXN0000023030,2024-08-24T16:40:13,ACC00005898,Transfer,1672.75,-418876.71,USD,Walmart
TXN0000023031,2024-01-26T19:36:25,ACC00001552,Credit,202.25,-418674.46,JPY,Shell
TXN0000023032,2024-05-05T04:22:15,ACC00006615,ATM,149.29,-418823.75,USD,Walmart
TXN0000023033,2024-02-04T21:32:32,ACC00002399,Credit,285.33,-418538.42,GBP,Online Store
TXN0000023034,2024-06-12T19:09:39,ACC00003266,Payment,684.06,-419222.48,JPY,Starbucks
TXN0000023035,2024-04-27T21:46:27,ACC00006006,Debit,1791.65,-421014.13,EUR,Grocery
TXN0000023036,2024-04-20T00:37:41,ACC00001591,Debit,1295.31,-422309.44,GBP,Grocery
TXN0000023037,2024-09-19T20:05:03,ACC00000403,Debit,1959.03,-424268.47,USD,Online Store
TXN0000023038,2024-10-18T04:43:17,ACC00000144,Transfer,1593.13,-422675.34,JPY,Grocery
TXN0000023039,2024-02-28T19:27:05,ACC00000897,Payment,1696.68,-424372.02,EUR,Walmart
TXN0000023040,2024-01-22T06:10:12,ACC00009867,Transfer,1857.4,-422514.62,EUR,Online Store
TXN0000023041,2024-05-16T16:35:37,ACC00008815,ATM,1977.29,-424491.91,EUR,Restaurant
TXN0000023042,2024-09-14T16:46:52,ACC00007717,ATM,977.49,-425469.4,JPY,Target
TXN0000023043,2024-05-10T09:05:27,ACC00009003,Transfer,597.91,-424871.49,USD,Shell
TXN0000023044,2024-09-13T03:01:22,ACC00004377,ATM,1670.08,-426541.57,GBP,Walmart
TXN0000023045,2024-05-24T18:44:09,ACC00007983,Credit,1701.25,-424840.32,EUR,Amazon
TXN0000023046,2024-01-29T08:42:12,ACC00004440,Transfer,92.07,-424748.25,JPY,Online Store
TXN0000023047,2024-11-11T06:02:57,ACC00005150,Transfer,786.21,-423962.04,GBP,Walmart
TXN0000023048,2024-12-30T19:37:04,ACC00008478,Transfer,1187.36,-422774.68,USD,Grocery
TXN0000023049,2024-07-04T12:22:28,ACC00006164,ATM,695.1,-423469.78,GBP,Walmart
TXN0000023050,2024-02-08T15:53:24,ACC00006033,Payment,647.38,-424117.16,EUR,Walmart
TXN0000023051,2024-05-27T03:20:27,ACC00001466,Payment,321.17,-424438.33,GBP,Online Store
TXN0000023052,2024-02-02T10:12:54,ACC00002162,Debit,1501.83,-425940.16,JPY,Online Store
TXN0000023053,2024-02-22T05:02:23,ACC00000176,Transfer,828.22,-425111.94,JPY,Restaurant
TXN0000023054,2024-11-07T12:36:38,ACC00007109,Transfer,1163.14,-423948.8,GBP,Amazon
TXN0000023055,2024-03-25T19:37:53,ACC00009406,Debit,1593.21,-425542.01,JPY,Target
TXN0000023056,2024-04-05T15:04:03,ACC00005959,Payment,1751.71,-427293.72,GBP,Restaurant
TXN0000023057,2024-04-14T20:07:48,ACC00007284,Transfer,1180.02,-426113.7,GBP,Walmart
TXN0000023058,2024-10-15T10:36:39,ACC00000007,ATM,1310.04,-427423.74,GBP,Grocery
TXN0000023059,2024-11-16T11:42:30,ACC00002199,Payment,733.51,-428157.25,EUR,Amazon
TXN0000023060,2024-06-02T00:43:42,ACC00002558,Transfer,1291.29,-426865.96,USD,Grocery
TXN0000023061,2024-08-14T22:02:39,ACC00005056,Debit,923.7,-427789.66,EUR,Grocery
TXN0000023062,2024-03-17T16:54:37,ACC00000758,Payment,613.46,-428403.12,USD,Online Store
TXN0000023063,2024-07-13T23:23:04,ACC00000669,Transfer,1061.09,-427342.03,JPY,Online Store
TXN0000023064,2024-10-15T20:56:57,ACC00006896,Transfer,350.43,-426991.6,USD,Online Store
TXN0000023065,2024-07-05T04:17:07,ACC00005155,Transfer,812.92,-426178.68,JPY,Shell
TXN0000023066,2024-07-28T19:03:26,ACC00007038,Transfer,44.37,-426134.31,USD,Restaurant
TXN0000023067,2024-03-21T22:01:35,ACC00007132,ATM,1864.41,-427998.72,EUR,Online Store
TXN0000023068,2024-11-24T19:20:14,ACC00008282,Payment,1862.73,-429861.45,JPY,Grocery
TXN0000023069,2024-01-18T13:10:45,ACC00009845,Debit,611.04,-430472.49,EUR,Walmart
TXN0000023070,2024-01-30T09:19:46,ACC00008764,ATM,945.78,-431418.27,JPY,Restaurant
TXN0000023071,2024-06-22T10:59:37,ACC00000112,Debit,946.35,-432364.62,GBP,Online Store
TXN0000023072,2024-10-14T06:21:01,ACC00009500,Transfer,1082.46,-431282.16,GBP,Restaurant
TXN0000023073,2024-02-13T21:25:48,ACC00004358,Payment,51.6,-431333.76,USD,Online Store
TXN0000023074,2024-07-02T12:28:11,ACC00006635,Credit,950.64,-430383.12,JPY,Grocery
TXN0000023075,2024-06-06T08:50:10,ACC00005266,Transfer,216.76,-430166.36,USD,Grocery
TXN0000023076,2024-04-08T04:26:59,ACC00005186,Debit,1102.47,-431268.83,GBP,Grocery
TXN0000023077,2024-03-26T05:11:10,ACC00005219,Payment,1759.51,-433028.34,USD,Grocery
TXN0000023078,2024-11-06T02:00:21,ACC00009873,ATM,1679.61,-434707.95,GBP,Shell
TXN0000023079,2024-01-23T14:07:32,ACC00009526,Payment,361.28,-435069.23,EUR,Online Store
TXN0000023080,2024-03-13T22:32:10,ACC00001160,Credit,127.53,-434941.7,EUR,Shell
TXN0000023081,2024-12-24T16:39:13,ACC00000278,Payment,1843.49,-436785.19,EUR,Grocery
TXN0000023082,2024-06-07T10:14:11,ACC00005034,Debit,16.57,-436801.76,GBP,Restaurant
TXN0000023083,2024-12-23T17:19:54,ACC00001828,Debit,1688.71,-438490.47,JPY,Restaurant
TXN0000023084,2024-03-13T09:50:39,ACC00000065,Transfer,83.36,-438407.11,GBP,Restaurant
TXN0000023085,2024-10-16T14:55:20,ACC00004527,ATM,607.31,-439014.42,EUR,Starbucks
TXN0000023086,2024-05-13T18:21:18,ACC00009331,Payment,1249.43,-440263.85,GBP,Restaurant
TXN0000023087,2024-07-27T09:01:04,ACC00007952,Transfer,1391.85,-438872.0,GBP,Starbucks
TXN0000023088,2024-10-31T01:12:49,ACC00009391,Payment,1541.97,-440413.97,EUR,Grocery
TXN0000023089,2024-05-13T07:05:56,ACC00005544,Debit,1928.82,-442342.79,GBP,Shell
TXN0000023090,2024-11-12T03:36:30,ACC00007225,ATM,680.84,-443023.63,JPY,Grocery
TXN0000023091,2024-01-08T04:17:49,ACC00002545,Transfer,1595.75,-441427.88,GBP,Shell
TXN0000023092,2024-04-07T12:07:57,ACC00006963,Credit,501.84,-440926.04,EUR,Target
TXN0000023093,2024-03-11T11:46:33,ACC00002711,Debit,812.03,-441738.07,JPY,Grocery
TXN0000023094,2024-01-06T05:08:32,ACC00000861,ATM,1070.93,-442809.0,JPY,Starbucks
TXN0000023095,2024-01-04T21:35:36,ACC00004402,Payment,853.64,-443662.64,USD,Online Store
TXN0000023096,2024-07-11T12:36:10,ACC00006174,Credit,1674.56,-441988.08,USD,Target
TXN0000023097,2024-02-21T00:32:08,ACC00008535,Credit,1436.09,-440551.99,GBP,Online Store
TXN0000023098,2024-01-15T21:50:37,ACC00000984,Transfer,1212.69,-439339.3,GBP,Target
TXN0000023099,2024-03-14T02:31:59,ACC00007768,Payment,1547.04,-440886.34,GBP,Target
TXN0000023100,2024-05-22T21:47:33,ACC00007094,ATM,750.22,-441636.56,JPY,Target
TXN0000023101,2024-09-14T21:37:25,ACC00004008,Credit,1599.59,-440036.97,EUR,Starbucks
TXN0000023102,2024-02-12T23:06:12,ACC00000095,Transfer,1242.93,-438794.04,USD,Restaurant
TXN0000023103,2024-02-09T19:20:54,ACC00004412,Credit,156.07,-438637.97,EUR,Target
TXN0000023104,2024-04-13T11:42:14,ACC00007772,Transfer,1921.81,-436716.16,USD,Starbucks
TXN0000023105,2024-02-11T11:53:52,ACC00005174,Transfer,647.66,-436068.5,USD,Online Store
TXN0000023106,2024-02-20T19:18:14,ACC00008078,Credit,1408.45,-434660.05,EUR,Amazon
TXN0000023107,2024-05-02T00:38:06,ACC00003733,Credit,223.67,-434436.38,GBP,Amazon
TXN0000023108,2024-06-06T17:51:47,ACC00006714,Payment,1460.26,-435896.64,EUR,Shell
TXN0000023109,2024-08-31T17:29:08,ACC00008311,Credit,387.94,-435508.7,EUR,Amazon
TXN0000023110,2024-03-12T10:38:57,ACC00008541,ATM,1222.33,-436731.03,USD,Walmart
TXN0000023111,2024-08-11T00:01:16,ACC00009698,ATM,1609.11,-438340.14,USD,Amazon
TXN0000023112,2024-03-11T23:39:37,ACC00009420,Transfer,976.84,-437363.3,GBP,Grocery
TXN0000023113,2024-08-18T18:15:45,ACC00003280,ATM,963.67,-438326.97,JPY,Amazon
TXN0000023114,2024-11-13T01:39:51,ACC00003234,Transfer,347.81,-437979.16,JPY,Grocery
TXN0000023115,2024-09-20T03:27:50,ACC00004500,Transfer,1521.29,-436457.87,JPY,Grocery
TXN0000023116,2024-08-08T14:40:25,ACC00006600,Transfer,698.26,-435759.61,GBP,Grocery
TXN0000023117,2024-12-27T13:19:10,ACC00005633,Payment,1579.99,-437339.6,USD,Target
TXN0000023118,2024-07-08T05:26:35,ACC00001124,Transfer,1669.43,-435670.17,EUR,Shell
TXN0000023119,2024-07-14T01:19:24,ACC00008563,Transfer,1366.81,-434303.36,USD,Restaurant
TXN0000023120,2024-01-14T16:36:29,ACC00008906,ATM,378.18,-434681.54,JPY,Starbucks
TXN0000023121,2024-05-22T21:07:34,ACC00005845,Credit,1895.21,-432786.33,JPY,Walmart
TXN0000023122,2024-03-16T12:32:20,ACC00007606,Credit,702.07,-432084.26,USD,Grocery
TXN0000023123,2024-08-29T22:06:45,ACC00007474,Transfer,1987.96,-430096.3,JPY,Walmart
TXN0000023124,2024-11-22T16:05:48,ACC00004306,Transfer,861.57,-429234.73,GBP,Target
TXN0000023125,2024-08-23T18:36:26,ACC00003116,Transfer,1065.44,-428169.29,JPY,Online Store
TXN0000023126,2024-06-20T13:22:32,ACC00000334,Debit,1055.91,-429225.2,EUR,Walmart
TXN0000023127,2024-10-06T01:22:53,ACC00001598,ATM,491.44,-429716.64,JPY,Grocery
TXN0000023128,2024-01-17T06:20:23,ACC00006424,Payment,1261.27,-430977.91,JPY,Target
TXN0000023129,2024-08-12T21:16:26,ACC00002492,Debit,326.28,-431304.19,EUR,Shell
TXN0000023130,2024-02-29T06:51:44,ACC00001413,Debit,1532.25,-432836.44,JPY,Shell
TXN0000023131,2024-07-17T20:20:01,ACC00001380,Payment,1696.86,-434533.3,JPY,Walmart
TXN0000023132,2024-05-01T02:59:20,ACC00009440,Credit,1931.67,-432601.63,JPY,Target
TXN0000023133,2024-04-16T04:58:10,ACC00002182,ATM,960.78,-433562.41,USD,Target
TXN0000023134,2024-11-28T12:31:07,ACC00009388,Transfer,1956.41,-431606.0,EUR,Walmart
TXN0000023135,2024-02-20T04:38:19,ACC00000274,ATM,1383.73,-432989.73,JPY,Online Store
TXN0000023136,2024-09-23T06:44:28,ACC00003734,Credit,767.43,-432222.3,JPY,Shell
TXN0000023137,2024-02-22T13:48:27,ACC00005969,Transfer,1925.61,-430296.69,GBP,Shell
TXN0000023138,2024-08-08T17:24:24,ACC00002683,ATM,1801.25,-432097.94,JPY,Target
TXN0000023139,2024-05-01T18:12:53,ACC00007569,Payment,1360.41,-433458.35,GBP,Target
TXN0000023140,2024-02-24T14:38:36,ACC00007780,Payment,15.48,-433473.83,EUR,Shell
TXN0000023141,2024-06-10T02:27:19,ACC00000259,Debit,1122.04,-434595.87,USD,Restaurant
TXN0000023142,2024-11-11T06:45:53,ACC00002005,Payment,340.97,-434936.84,EUR,Target
TXN0000023143,2024-07-11T16:06:36,ACC00009146,ATM,978.81,-435915.65,JPY,Shell
TXN0000023144,2024-09-04T19:22:57,ACC00001405,Credit,30.95,-435884.7,GBP,Walmart
TXN0000023145,2024-10-22T12:50:14,ACC00006611,Debit,82.51,-435967.21,USD,Online Store
TXN0000023146,2024-11-07T01:24:13,ACC00009732,Credit,1774.9,-434192.31,GBP,Online Store
TXN0000023147,2024-12-19T20:05:55,ACC00005902,Payment,241.88,-434434.19,JPY,Grocery
TXN0000023148,2024-09-07T18:21:38,ACC00008509,Credit,72.61,-434361.58,GBP,Target
TXN0000023149,2024-11-29T00:49:47,ACC00009134,Debit,1158.05,-435519.63,JPY,Amazon
TXN0000023150,2024-09-26T14:00:51,ACC00008619,Credit,1897.79,-433621.84,USD,Target
TXN0000023151,2024-01-28T12:53:47,ACC00009523,Transfer,1913.78,-431708.06,GBP,Amazon
TXN0000023152,2024-01-01T09:40:24,ACC00003029,ATM,663.8,-432371.86,USD,Restaurant
TXN0000023153,2024-06-20T02:14:51,ACC00005640,Transfer,1068.23,-431303.63,EUR,Restaurant
TXN0000023154,2024-08-23T15:46:40,ACC00008379,ATM,1176.12,-432479.75,GBP,Walmart
TXN0000023155,2024-06-25T17:59:08,ACC00005140,Payment,1247.06,-433726.81,USD,Online Store
TXN0000023156,2024-12-21T20:44:50,ACC00002051,Transfer,319.55,-433407.26,EUR,Grocery
TXN0000023157,2024-11-12T07:18:50,ACC00002763,Transfer,125.68,-433281.58,GBP,Starbucks
TXN0000023158,2024-05-25T15:49:13,ACC00005250,Transfer,1489.25,-431792.33,JPY,Starbucks
TXN0000023159,2024-09-20T11:00:35,ACC00003816,Debit,641.53,-432433.86,EUR,Target
TXN0000023160,2024-12-16T11:44:56,ACC00001508,Transfer,1887.86,-430546.0,JPY,Grocery
TXN0000023161,2024-04-04T01:07:12,ACC00005400,Credit,1036.85,-429509.15,EUR,Restaurant
TXN0000023162,2024-07-06T06:17:28,ACC00007711,ATM,656.83,-430165.98,EUR,Shell
TXN0000023163,2024-04-10T14:58:30,ACC00004777,Payment,1963.86,-432129.84,GBP,Amazon
TXN0000023164,2024-04-28T07:58:05,ACC00009399,ATM,439.5,-432569.34,EUR,Online Store
TXN0000023165,2024-05-17T04:44:43,ACC00004257,ATM,262.89,-432832.23,USD,Target
TXN0000023166,2024-06-11T08:19:22,ACC00005962,Payment,1556.59,-434388.82,GBP,Starbucks
TXN0000023167,2024-06-23T07:38:45,ACC00003819,Debit,746.93,-435135.75,GBP,Target
TXN0000023168,2024-04-05T01:58:06,ACC00002560,Payment,645.06,-435780.81,GBP,Walmart
TXN0000023169,2024-07-19T09:30:57,ACC00007685,Transfer,1321.74,-434459.07,EUR,Walmart
TXN0000023170,2024-10-12T09:46:36,ACC00002122,Credit,634.82,-433824.25,USD,Grocery
TXN0000023171,2024-12-27T14:13:02,ACC00008971,Credit,1962.0,-431862.25,JPY,Online Store
TXN0000023172,2024-01-10T09:42:10,ACC00007031,ATM,1266.43,-433128.68,GBP,Amazon
TXN0000023173,2024-10-12T15:29:02,ACC00002441,Transfer,982.24,-432146.44,EUR,Restaurant
TXN0000023174,2024-11-30T04:22:08,ACC00008433,Transfer,870.17,-431276.27,EUR,Amazon
TXN0000023175,2024-10-28T20:44:51,ACC00009537,Payment,1927.74,-433204.01,USD,Starbucks
TXN0000023176,2024-04-03T12:18:31,ACC00000614,Transfer,1344.03,-431859.98,JPY,Shell
TXN0000023177,2024-05-21T04:28:10,ACC00009750,ATM,319.64,-432179.62,GBP,Amazon
TXN0000023178,2024-08-25T22:09:47,ACC00007988,Debit,1548.88,-433728.5,EUR,Grocery
TXN0000023179,2024-05-25T22:45:14,ACC00004438,Transfer,864.67,-432863.83,JPY,Grocery
TXN0000023180,2024-01-18T23:11:28,ACC00009425,Payment,1487.84,-434351.67,USD,Online Store
TXN0000023181,2024-01-18T16:18:35,ACC00003025,ATM,343.4,-434695.07,JPY,Amazon
TXN0000023182,2024-06-12T08:48:13,ACC00001569,Credit,448.47,-434246.6,JPY,Starbucks
TXN0000023183,2024-11-18T23:25:15,ACC00009493,Payment,122.16,-434368.76,EUR,Amazon
TXN0000023184,2024-02-28T07:11:04,ACC00005716,Transfer,474.12,-433894.64,USD,Grocery
TXN0000023185,2024-10-01T20:56:59,ACC00009856,Debit,851.42,-434746.06,EUR,Shell
TXN0000023186,2024-11-08T11:08:55,ACC00005843,Debit,377.2,-435123.26,JPY,Walmart
TXN0000023187,2024-09-14T07:21:08,ACC00001244,ATM,696.5,-435819.76,JPY,Starbucks
TXN0000023188,2024-06-19T00:48:47,ACC00002994,Credit,1035.79,-434783.97,GBP,Starbucks
TXN0000023189,2024-11-25T05:14:07,ACC00007527,Debit,720.06,-435504.03,GBP,Starbucks
TXN0000023190,2024-12-21T10:39:33,ACC00007645,Payment,1933.87,-437437.9,JPY,Restaurant
TXN0000023191,2024-12-05T17:09:13,ACC00002708,Payment,841.32,-438279.22,USD,Restaurant
TXN0000023192,2024-07-09T06:26:29,ACC00005129,Transfer,1877.43,-436401.79,JPY,Shell
TXN0000023193,2024-08-17T18:34:02,ACC00008347,Transfer,1129.82,-435271.97,USD,Online Store
TXN0000023194,2024-08-15T10:41:38,ACC00000163,Credit,1912.0,-433359.97,GBP,Amazon
TXN0000023195,2024-12-05T15:21:04,ACC00002423,Transfer,612.69,-432747.28,USD,Amazon
TXN0000023196,2024-07-08T00:24:07,ACC00006545,Payment,441.88,-433189.16,GBP,Online Store
TXN0000023197,2024-08-24T19:59:37,ACC00002359,Credit,866.72,-432322.44,GBP,Restaurant
TXN0000023198,2024-01-04T13:42:38,ACC00009906,Transfer,1178.72,-431143.72,USD,Shell
TXN0000023199,2024-12-17T20:45:06,ACC00006272,Transfer,710.3,-430433.42,JPY,Amazon
TXN0000023200,2024-03-09T10:35:40,ACC00002083,Transfer,1506.73,-428926.69,EUR,Online Store
TXN0000023201,2024-01-06T20:28:54,ACC00009735,ATM,111.23,-429037.92,USD,Restaurant
TXN0000023202,2024-08-13T09:44:23,ACC00004187,Credit,666.14,-428371.78,JPY,Grocery
TXN0000023203,2024-01-05T00:03:01,ACC00007807,ATM,725.88,-429097.66,GBP,Target
TXN0000023204,2024-03-13T23:12:36,ACC00005909,Credit,847.11,-428250.55,EUR,Walmart
TXN0000023205,2024-01-18T04:14:59,ACC00000951,Payment,1208.47,-429459.02,GBP,Walmart
TXN0000023206,2024-06-17T23:38:58,ACC00002486,ATM,142.72,-429601.74,EUR,Online Store
TXN0000023207,2024-05-31T02:05:48,ACC00006006,Debit,1776.74,-431378.48,JPY,Target
TXN0000023208,2024-06-26T06:32:58,ACC00006767,Credit,1392.58,-429985.9,GBP,Online Store
TXN0000023209,2024-09-21T17:27:18,ACC00006063,ATM,1045.23,-431031.13,GBP,Restaurant
TXN0000023210,2024-02-29T23:17:04,ACC00006565,Credit,1078.44,-429952.69,EUR,Starbucks
TXN0000023211,2024-02-10T12:45:18,ACC00008070,ATM,283.77,-430236.46,JPY,Amazon
TXN0000023212,2024-04-06T06:33:52,ACC00005084,Transfer,709.19,-429527.27,USD,Shell
TXN0000023213,2024-06-04T18:21:06,ACC00002750,Transfer,241.1,-429286.17,JPY,Starbucks
TXN0000023214,2024-08-29T04:38:58,ACC00004226,Credit,1296.33,-427989.84,GBP,Target
TXN0000023215,2024-01-12T23:59:11,ACC00002606,Credit,1642.95,-426346.89,USD,Amazon
TXN0000023216,2024-04-08T07:33:39,ACC00007396,Credit,473.4,-425873.49,GBP,Walmart
TXN0000023217,2024-09-30T11:05:06,ACC00006794,ATM,343.1,-426216.59,EUR,Amazon
TXN0000023218,2024-02-20T00:45:57,ACC00000121,ATM,200.31,-426416.9,JPY,Starbucks
TXN0000023219,2024-03-15T18:37:13,ACC00000938,ATM,237.4,-426654.3,EUR,Shell
TXN0000023220,2024-05-25T12:16:51,ACC00009725,Debit,467.16,-427121.46,USD,Restaurant
TXN0000023221,2024-07-10T01:20:40,ACC00005496,ATM,375.96,-427497.42,GBP,Walmart
TXN0000023222,2024-12-09T22:57:34,ACC00003234,Transfer,876.9,-426620.52,GBP,Target
TXN0000023223,2024-11-15T20:52:35,ACC00007266,Credit,156.33,-426464.19,JPY,Shell
TXN0000023224,2024-03-18T18:54:58,ACC00009057,ATM,152.65,-426616.84,GBP,Walmart
TXN0000023225,2024-04-28T10:33:00,ACC00007099,ATM,321.58,-426938.42,GBP,Amazon
TXN0000023226,2024-01-24T14:31:10,ACC00000866,Credit,1531.09,-425407.33,GBP,Starbucks
TXN0000023227,2024-03-22T06:13:50,ACC00006960,Credit,79.24,-425328.09,JPY,Restaurant
TXN0000023228,2024-10-02T05:28:30,ACC00001918,Credit,822.45,-424505.64,JPY,Amazon
TXN0000023229,2024-02-05T02:54:50,ACC00005397,Credit,696.5,-423809.14,JPY,Starbucks
TXN0000023230,2024-03-27T03:16:45,ACC00007627,Debit,525.74,-424334.88,USD,Online Store
TXN0000023231,2024-04-09T21:00:10,ACC00009556,Payment,744.96,-425079.84,JPY,Grocery
TXN0000023232,2024-11-03T16:00:00,ACC00005370,Payment,445.73,-425525.57,JPY,Amazon
TXN0000023233,2024-10-14T16:39:15,ACC00002893,Transfer,99.73,-425425.84,EUR,Grocery
TXN0000023234,2024-12-26T04:04:40,ACC00002532,Credit,1522.46,-423903.38,JPY,Walmart
TXN0000023235,2024-12-09T23:13:31,ACC00005146,Credit,1749.65,-422153.73,GBP,Walmart
TXN0000023236,2024-11-22T04:39:17,ACC00002229,ATM,627.2,-422780.93,EUR,Starbucks
TXN0000023237,2024-02-06T04:38:06,ACC00005192,Debit,1092.71,-423873.64,USD,Starbucks
TXN0000023238,2024-06-14T19:59:39,ACC00007790,Debit,1409.49,-425283.13,GBP,Amazon
TXN0000023239,2024-05-12T10:23:01,ACC00003290,Debit,1998.38,-427281.51,GBP,Restaurant
TXN0000023240,2024-10-23T20:41:01,ACC00006526,Transfer,1804.19,-425477.32,GBP,Online Store
TXN0000023241,2024-06-20T11:03:40,ACC00003685,Transfer,121.33,-425355.99,GBP,Restaurant
TXN0000023242,2024-08-16T05:02:38,ACC00002920,Transfer,942.91,-424413.08,USD,Online Store
TXN0000023243,2024-03-17T00:13:14,ACC00009986,Credit,833.27,-423579.81,USD,Starbucks
TXN0000023244,2024-03-27T19:38:42,ACC00008037,ATM,906.27,-424486.08,USD,Shell
TXN0000023245,2024-09-03T22:45:10,ACC00006861,Credit,1965.41,-422520.67,EUR,Online Store
TXN0000023246,2024-10-08T06:14:55,ACC00007061,Credit,1763.21,-420757.46,JPY,Restaurant
TXN0000023247,2024-04-16T20:54:10,ACC00004577,Debit,1901.76,-422659.22,EUR,Shell
TXN0000023248,2024-09-23T06:21:44,ACC00002428,Credit,1896.85,-420762.37,JPY,Starbucks
TXN0000023249,2024-12-05T05:18:38,ACC00007790,Transfer,991.97,-419770.4,GBP,Grocery
TXN0000023250,2024-06-15T11:22:05,ACC00006680,Payment,1315.92,-421086.32,JPY,Walmart
TXN0000023251,2024-10-08T03:22:38,ACC00009251,Transfer,753.07,-420333.25,USD,Starbucks
TXN0000023252,2024-06-02T14:52:18,ACC00002914,ATM,1820.17,-422153.42,GBP,Target
TXN0000023253,2024-01-24T08:54:32,ACC00003278,ATM,900.92,-423054.34,JPY,Amazon
TXN0000023254,2024-05-03T14:22:16,ACC00006516,Credit,63.34,-422991.0,GBP,Target
TXN0000023255,2024-05-31T22:55:03,ACC00001473,Transfer,1660.83,-421330.17,JPY,Amazon
TXN0000023256,2024-09-25T17:14:13,ACC00007939,Credit,1006.55,-420323.62,EUR,Online Store
TXN0000023257,2024-12-21T01:42:00,ACC00003027,Credit,1812.08,-418511.54,GBP,Online Store
TXN0000023258,2024-09-29T11:56:41,ACC00009917,Credit,765.81,-417745.73,EUR,Grocery
TXN0000023259,2024-05-30T16:26:11,ACC00007200,ATM,954.97,-418700.7,JPY,Grocery
TXN0000023260,2024-05-30T15:24:42,ACC00000798,Debit,633.34,-419334.04,EUR,Amazon
TXN0000023261,2024-08-02T23:05:32,ACC00005756,Debit,1938.36,-421272.4,JPY,Shell
TXN0000023262,2024-05-13T02:42:28,ACC00009257,ATM,828.38,-422100.78,USD,Walmart
TXN0000023263,2024-10-19T16:03:56,ACC00002467,Transfer,1389.79,-420710.99,USD,Walmart
TXN0000023264,2024-10-20T05:30:10,ACC00002559,Payment,1089.13,-421800.12,USD,Online Store
TXN0000023265,2024-11-13T14:26:40,ACC00008851,Payment,190.36,-421990.48,JPY,Amazon
TXN0000023266,2024-05-21T12:44:41,ACC00009195,Transfer,762.21,-421228.27,EUR,Amazon
TXN0000023267,2024-04-07T07:46:21,ACC00007823,Payment,1876.08,-423104.35,EUR,Walmart
TXN0000023268,2024-03-01T05:18:41,ACC00002537,ATM,256.06,-423360.41,USD,Amazon
TXN0000023269,2024-05-27T19:41:27,ACC00002134,Payment,1980.3,-425340.71,USD,Shell
TXN0000023270,2024-02-29T02:31:37,ACC00004706,Payment,414.37,-425755.08,EUR,Starbucks
TXN0000023271,2024-09-21T01:27:43,ACC00001019,Transfer,628.72,-425126.36,EUR,Shell
TXN0000023272,2024-10-01T14:16:54,ACC00005078,Transfer,913.77,-424212.59,GBP,Starbucks
TXN0000023273,2024-04-25T14:17:21,ACC00004429,Debit,368.25,-424580.84,JPY,Restaurant
TXN0000023274,2024-02-13T09:50:45,ACC00005406,Credit,871.75,-423709.09,GBP,Target
TXN0000023275,2024-02-22T23:32:09,ACC00006043,Credit,785.41,-422923.68,JPY,Walmart
TXN0000023276,2024-02-14T05:44:41,ACC00004884,Payment,1255.66,-424179.34,GBP,Shell
TXN0000023277,2024-01-28T20:13:20,ACC00004617,ATM,627.11,-424806.45,JPY,Target
TXN0000023278,2024-10-16T13:42:15,ACC00001735,Credit,973.18,-423833.27,JPY,Amazon
TXN0000023279,2024-08-05T21:57:44,ACC00007402,Debit,1774.41,-425607.68,JPY,Target
TXN0000023280,2024-11-10T12:17:54,ACC00008784,Debit,925.35,-426533.03,JPY,Target
TXN0000023281,2024-09-07T00:50:32,ACC00000714,Credit,1721.61,-424811.42,EUR,Target
TXN0000023282,2024-07-29T02:47:57,ACC00006603,Credit,1098.62,-423712.8,JPY,Grocery
TXN0000023283,2024-08-02T19:51:22,ACC00000975,Credit,348.25,-423364.55,GBP,Restaurant
TXN0000023284,2024-08-12T04:11:09,ACC00005680,Transfer,1767.75,-421596.8,JPY,Online Store
TXN0000023285,2024-11-25T02:11:22,ACC00006896,Transfer,400.32,-421196.48,EUR,Amazon
TXN0000023286,2024-06-26T02:12:30,ACC00003041,Debit,728.28,-421924.76,JPY,Grocery
TXN0000023287,2024-12-30T11:34:02,ACC00006149,ATM,1704.53,-423629.29,USD,Online Store
TXN0000023288,2024-03-29T21:26:43,ACC00002632,ATM,1986.91,-425616.2,EUR,Amazon
TXN0000023289,2024-11-14T07:57:38,ACC00002806,Transfer,1956.86,-423659.34,EUR,Starbucks
TXN0000023290,2024-07-08T10:53:14,ACC00008341,ATM,610.61,-424269.95,EUR,Grocery
TXN0000023291,2024-06-13T08:08:50,ACC00008437,Credit,194.4,-424075.55,JPY,Amazon
TXN0000023292,2024-06-28T05:51:52,ACC00002982,Transfer,462.65,-423612.9,GBP,Amazon
TXN0000023293,2024-03-25T12:17:51,ACC00002017,Credit,390.19,-423222.71,JPY,Starbucks
TXN0000023294,2024-04-20T18:40:36,ACC00009781,ATM,820.36,-424043.07,JPY,Walmart
TXN0000023295,2024-07-26T06:20:43,ACC00001402,Credit,1599.36,-422443.71,USD,Starbucks
TXN0000023296,2024-02-17T18:17:23,ACC00003769,Debit,1924.81,-424368.52,EUR,Walmart
TXN0000023297,2024-07-06T19:31:58,ACC00006100,Credit,1937.61,-422430.91,EUR,Grocery
TXN0000023298,2024-12-13T00:49:16,ACC00009546,Debit,764.48,-423195.39,USD,Target
TXN0000023299,2024-07-13T13:40:57,ACC00004290,ATM,1245.39,-424440.78,JPY,Starbucks
TXN0000023300,2024-05-21T19:16:58,ACC00001939,Payment,1113.67,-425554.45,GBP,Shell
TXN0000023301,2024-06-24T16:02:12,ACC00007512,Payment,1473.75,-427028.2,JPY,Online Store
TXN0000023302,2024-09-15T21:32:10,ACC00006263,Payment,1305.49,-428333.69,GBP,Target
TXN0000023303,2024-03-11T17:59:10,ACC00003633,Credit,767.43,-427566.26,JPY,Grocery
TXN0000023304,2024-12-02T16:56:48,ACC00001484,Payment,1561.64,-429127.9,GBP,Restaurant
TXN0000023305,2024-07-02T13:04:06,ACC00000145,Credit,781.71,-428346.19,USD,Walmart
TXN0000023306,2024-06-11T10:45:21,ACC00002041,Debit,129.14,-428475.33,EUR,Walmart
TXN0000023307,2024-07-18T08:00:18,ACC00005150,Transfer,939.82,-427535.51,JPY,Restaurant
TXN0000023308,2024-02-05T12:08:47,ACC00001910,Transfer,169.45,-427366.06,USD,Target
TXN0000023309,2024-08-10T23:58:42,ACC00004056,Debit,1873.85,-429239.91,JPY,Online Store
TXN0000023310,2024-01-11T14:24:01,ACC00000912,Credit,1701.75,-427538.16,GBP,Online Store
TXN0000023311,2024-09-15T18:11:33,ACC00008234,Credit,1616.93,-425921.23,GBP,Shell
TXN0000023312,2024-05-08T06:15:30,ACC00001485,Credit,454.76,-425466.47,EUR,Shell
TXN0000023313,2024-08-10T14:49:52,ACC00006158,Payment,650.29,-426116.76,USD,Online Store
TXN0000023314,2024-05-17T12:23:48,ACC00007047,Debit,1593.44,-427710.2,EUR,Walmart
TXN0000023315,2024-09-25T05:29:10,ACC00004297,Credit,150.34,-427559.86,GBP,Amazon
TXN0000023316,2024-03-04T03:56:14,ACC00007120,Credit,212.33,-427347.53,GBP,Shell
TXN0000023317,2024-06-18T00:42:54,ACC00009271,ATM,1992.13,-429339.66,EUR,Target
TXN0000023318,2024-01-21T17:29:14,ACC00007460,Payment,1390.42,-430730.08,USD,Starbucks
TXN0000023319,2024-11-20T20:02:17,ACC00007246,Credit,110.52,-430619.56,GBP,Restaurant
TXN0000023320,2024-04-28T14:09:53,ACC00008922,Debit,760.91,-431380.47,JPY,Walmart
TXN0000023321,2024-05-06T21:11:58,ACC00005876,Debit,737.6,-432118.07,USD,Target
TXN0000023322,2024-02-07T09:53:55,ACC00001021,Debit,1588.15,-433706.22,GBP,Amazon
TXN0000023323,2024-03-02T09:53:10,ACC00007431,Credit,1616.68,-432089.54,EUR,Online Store
TXN0000023324,2024-06-24T06:14:00,ACC00003411,Credit,1817.45,-430272.09,EUR,Restaurant
TXN0000023325,2024-02-10T00:24:45,ACC00007248,ATM,1144.86,-431416.95,EUR,Online Store
TXN0000023326,2024-11-29T15:44:44,ACC00007374,Credit,1060.11,-430356.84,JPY,Online Store
TXN0000023327,2024-11-19T00:30:57,ACC00002778,Credit,390.13,-429966.71,USD,Target
TXN0000023328,2024-10-09T19:00:33,ACC00007010,Credit,927.88,-429038.83,JPY,Target
TXN0000023329,2024-03-29T10:42:37,ACC00000547,Transfer,520.66,-428518.17,USD,Walmart
TXN0000023330,2024-12-19T18:48:58,ACC00005412,Payment,1064.01,-429582.18,EUR,Shell
TXN0000023331,2024-10-16T16:44:37,ACC00004249,Debit,492.49,-430074.67,EUR,Walmart
TXN0000023332,2024-03-21T01:56:16,ACC00009242,ATM,404.41,-430479.08,GBP,Online Store
TXN0000023333,2024-04-16T11:56:50,ACC00008792,Payment,1213.88,-431692.96,GBP,Walmart
TXN0000023334,2024-05-07T15:49:34,ACC00000897,Transfer,329.0,-431363.96,EUR,Shell
TXN0000023335,2024-09-07T12:13:03,ACC00000138,Transfer,1356.69,-430007.27,USD,Restaurant
TXN0000023336,2024-02-14T03:58:45,ACC00009291,Debit,679.84,-430687.11,JPY,Shell
TXN0000023337,2024-09-12T15:34:40,ACC00008483,ATM,1285.99,-431973.1,USD,Walmart
TXN0000023338,2024-09-22T20:30:58,ACC00008494,ATM,1896.98,-433870.08,GBP,Shell
TXN0000023339,2024-06-22T20:00:46,ACC00006408,Transfer,1565.48,-432304.6,EUR,Amazon
TXN0000023340,2024-11-30T17:15:41,ACC00000885,Payment,89.44,-432394.04,EUR,Amazon
TXN0000023341,2024-06-09T22:01:05,ACC00009828,Payment,1754.56,-434148.6,JPY,Shell
TXN0000023342,2024-08-19T01:51:05,ACC00003434,Payment,347.76,-434496.36,GBP,Restaurant
TXN0000023343,2024-04-18T01:59:38,ACC00004965,ATM,1576.43,-436072.79,EUR,Starbucks
TXN0000023344,2024-01-18T23:01:25,ACC00004472,Transfer,613.73,-435459.06,JPY,Amazon
TXN0000023345,2024-05-20T04:25:28,ACC00006555,Credit,1565.39,-433893.67,JPY,Online Store
TXN0000023346,2024-10-06T21:14:47,ACC00000426,Credit,1433.24,-432460.43,JPY,Shell
TXN0000023347,2024-07-15T07:04:42,ACC00007887,Debit,227.9,-432688.33,GBP,Shell
TXN0000023348,2024-04-14T07:29:40,ACC00009466,Credit,1855.84,-430832.49,USD,Restaurant
TXN0000023349,2024-02-16T16:49:43,ACC00002416,ATM,1917.86,-432750.35,EUR,Restaurant
TXN0000023350,2024-10-28T00:52:54,ACC00006640,Transfer,757.72,-431992.63,USD,Online Store
TXN0000023351,2024-03-25T02:33:12,ACC00003590,ATM,1311.37,-433304.0,USD,Restaurant
TXN0000023352,2024-11-01T15:03:45,ACC00002290,Debit,475.43,-433779.43,EUR,Restaurant
TXN0000023353,2024-01-05T04:24:50,ACC00000603,Debit,1470.86,-435250.29,USD,Amazon
TXN0000023354,2024-05-20T16:16:26,ACC00001441,ATM,922.14,-436172.43,JPY,Grocery
TXN0000023355,2024-01-17T22:18:27,ACC00000625,Credit,394.93,-435777.5,EUR,Restaurant
TXN0000023356,2024-05-01T01:44:16,ACC00006933,ATM,1473.39,-437250.89,USD,Grocery
TXN0000023357,2024-01-04T04:22:44,ACC00005071,Transfer,1270.03,-435980.86,EUR,Walmart
TXN0000023358,2024-10-12T20:10:03,ACC00008222,ATM,1678.86,-437659.72,USD,Walmart
TXN0000023359,2024-12-05T14:14:20,ACC00009845,Transfer,1463.41,-436196.31,JPY,Shell
TXN0000023360,2024-10-30T22:07:17,ACC00000987,Debit,1559.89,-437756.2,GBP,Target
TXN0000023361,2024-02-25T01:19:59,ACC00004772,Payment,827.47,-438583.67,EUR,Restaurant
TXN0000023362,2024-06-19T00:39:27,ACC00007951,Credit,982.23,-437601.44,EUR,Shell
TXN0000023363,2024-02-23T00:51:52,ACC00001097,Payment,1327.29,-438928.73,USD,Starbucks
TXN0000023364,2024-01-09T19:52:08,ACC00000767,ATM,660.83,-439589.56,JPY,Starbucks
TXN0000023365,2024-05-10T01:22:05,ACC00005009,Transfer,1019.46,-438570.1,GBP,Amazon
TXN0000023366,2024-11-05T12:36:10,ACC00001765,Debit,22.27,-438592.37,GBP,Amazon
TXN0000023367,2024-11-25T12:21:51,ACC00004589,Transfer,49.46,-438542.91,EUR,Restaurant
TXN0000023368,2024-10-11T03:14:57,ACC00008189,Credit,688.51,-437854.4,JPY,Grocery
TXN0000023369,2024-06-05T23:06:02,ACC00003387,Payment,1017.34,-438871.74,EUR,Grocery
TXN0000023370,2024-07-05T20:37:40,ACC00008512,Credit,1614.02,-437257.72,EUR,Target
TXN0000023371,2024-10-21T08:38:08,ACC00004263,Payment,1113.09,-438370.81,EUR,Target
TXN0000023372,2024-07-14T01:44:29,ACC00006163,Payment,1697.37,-440068.18,GBP,Restaurant
TXN0000023373,2024-05-08T12:42:18,ACC00006458,Debit,214.48,-440282.66,EUR,Amazon
TXN0000023374,2024-01-19T05:06:20,ACC00002841,Payment,706.86,-440989.52,GBP,Walmart
TXN0000023375,2024-10-05T11:57:46,ACC00004400,Debit,1268.66,-442258.18,GBP,Starbucks
TXN0000023376,2024-12-07T22:03:31,ACC00006191,Payment,276.31,-442534.49,USD,Shell
TXN0000023377,2024-02-23T18:00:03,ACC00009471,Transfer,1007.58,-441526.91,USD,Target
TXN0000023378,2024-05-14T00:29:29,ACC00005189,ATM,863.65,-442390.56,EUR,Online Store
TXN0000023379,2024-07-03T18:12:58,ACC00003508,Credit,332.06,-442058.5,USD,Amazon
TXN0000023380,2024-11-17T12:07:12,ACC00008944,ATM,750.54,-442809.04,GBP,Walmart
TXN0000023381,2024-04-16T20:26:38,ACC00003865,ATM,960.77,-443769.81,EUR,Walmart
TXN0000023382,2024-06-23T03:52:22,ACC00005080,Debit,1430.78,-445200.59,USD,Starbucks
TXN0000023383,2024-03-19T12:33:19,ACC00003297,Credit,1577.46,-443623.13,JPY,Shell
TXN0000023384,2024-11-06T15:12:31,ACC00005599,ATM,1498.81,-445121.94,GBP,Shell
TXN0000023385,2024-10-02T20:20:34,ACC00001212,Credit,1337.46,-443784.48,JPY,Online Store
TXN0000023386,2024-09-30T20:11:51,ACC00006426,Debit,564.3,-444348.78,USD,Walmart
TXN0000023387,2024-11-25T07:45:39,ACC00008425,ATM,312.68,-444661.46,GBP,Restaurant
TXN0000023388,2024-05-15T16:40:15,ACC00002297,Transfer,915.1,-443746.36,EUR,Grocery
TXN0000023389,2024-11-29T08:14:26,ACC00003745,ATM,245.52,-443991.88,GBP,Starbucks
TXN0000023390,2024-10-21T07:26:34,ACC00002642,Transfer,1165.3,-442826.58,JPY,Shell
TXN0000023391,2024-03-18T10:16:06,ACC00007044,Transfer,871.69,-441954.89,EUR,Walmart
TXN0000023392,2024-12-17T13:30:40,ACC00000143,Debit,679.61,-442634.5,USD,Grocery
TXN0000023393,2024-06-01T23:34:19,ACC00001233,Debit,62.27,-442696.77,USD,Restaurant
TXN0000023394,2024-03-19T02:07:23,ACC00005545,Debit,1289.75,-443986.52,GBP,Grocery
TXN0000023395,2024-04-14T18:26:58,ACC00007309,Payment,807.34,-444793.86,EUR,Target
TXN0000023396,2024-05-24T14:59:15,ACC00009713,Transfer,728.23,-444065.63,USD,Target
TXN0000023397,2024-04-26T08:03:40,ACC00006866,Credit,1048.1,-443017.53,EUR,Online Store
TXN0000023398,2024-01-08T15:07:23,ACC00008172,Transfer,758.63,-442258.9,EUR,Target
TXN0000023399,2024-01-26T16:45:46,ACC00003142,Payment,1939.47,-444198.37,GBP,Restaurant
TXN0000023400,2024-03-11T08:08:43,ACC00001962,Payment,202.91,-444401.28,GBP,Grocery
TXN0000023401,2024-09-06T22:07:31,ACC00007217,Credit,1005.78,-443395.5,USD,Starbucks
TXN0000023402,2024-01-03T00:13:57,ACC00007504,Transfer,1614.7,-441780.8,USD,Online Store
TXN0000023403,2024-05-05T01:38:53,ACC00001889,Debit,1137.25,-442918.05,GBP,Restaurant
TXN0000023404,2024-04-15T17:39:40,ACC00007465,Debit,1516.35,-444434.4,JPY,Online Store
TXN0000023405,2024-10-02T17:44:01,ACC00009341,Credit,1951.83,-442482.57,GBP,Walmart
TXN0000023406,2024-02-04T14:22:16,ACC00004463,ATM,1057.91,-443540.48,EUR,Starbucks
TXN0000023407,2024-05-11T04:06:03,ACC00002007,ATM,1561.2,-445101.68,GBP,Restaurant
TXN0000023408,2024-06-22T01:19:43,ACC00004254,Credit,1579.21,-443522.47,GBP,Restaurant
TXN0000023409,2024-06-03T01:56:43,ACC00002229,Payment,897.37,-444419.84,JPY,Amazon
TXN0000023410,2024-07-25T14:21:17,ACC00005206,Credit,620.85,-443798.99,EUR,Starbucks
TXN0000023411,2024-03-26T09:16:29,ACC00003607,Transfer,650.38,-443148.61,EUR,Starbucks
TXN0000023412,2024-10-22T04:31:47,ACC00001578,Debit,236.44,-443385.05,GBP,Online Store
TXN0000023413,2024-06-19T11:25:17,ACC00003931,Credit,522.05,-442863.0,JPY,Starbucks
TXN0000023414,2024-07-08T23:40:48,ACC00004411,Debit,362.39,-443225.39,GBP,Grocery
TXN0000023415,2024-01-02T17:18:43,ACC00005535,ATM,1350.62,-444576.01,JPY,Amazon
TXN0000023416,2024-01-08T02:56:05,ACC00004166,Payment,1444.07,-446020.08,GBP,Amazon
TXN0000023417,2024-09-08T17:14:53,ACC00005087,Payment,1694.85,-447714.93,USD,Shell
TXN0000023418,2024-03-15T05:59:44,ACC00002905,Credit,1803.68,-445911.25,GBP,Walmart
TXN0000023419,2024-10-05T04:42:59,ACC00005460,ATM,472.18,-446383.43,JPY,Amazon
TXN0000023420,2024-06-30T00:01:25,ACC00008953,ATM,482.07,-446865.5,GBP,Target
TXN0000023421,2024-05-30T01:13:00,ACC00005246,Debit,71.97,-446937.47,JPY,Online Store
TXN0000023422,2024-06-11T02:03:52,ACC00001980,Debit,1810.65,-448748.12,JPY,Target
TXN0000023423,2024-09-03T03:39:07,ACC00005562,Transfer,175.76,-448572.36,JPY,Target
TXN0000023424,2024-07-30T16:03:11,ACC00000609,Debit,1122.86,-449695.22,USD,Amazon
TXN0000023425,2024-03-11T00:22:23,ACC00002704,Transfer,692.21,-449003.01,GBP,Walmart
TXN0000023426,2024-10-27T13:59:00,ACC00007367,Credit,1267.18,-447735.83,JPY,Restaurant
TXN0000023427,2024-02-03T03:16:22,ACC00001089,Transfer,1201.82,-446534.01,EUR,Amazon
TXN0000023428,2024-07-15T00:06:51,ACC00005318,Transfer,37.94,-446496.07,USD,Amazon
TXN0000023429,2024-10-02T06:58:31,ACC00009712,Payment,1587.26,-448083.33,GBP,Grocery
TXN0000023430,2024-06-14T05:09:08,ACC00000667,ATM,1744.33,-449827.66,EUR,Walmart
TXN0000023431,2024-11-10T12:47:27,ACC00003220,Debit,1198.88,-451026.54,GBP,Shell
TXN0000023432,2024-12-22T20:19:39,ACC00005706,Payment,1848.82,-452875.36,EUR,Grocery
TXN0000023433,2024-02-05T05:57:40,ACC00006025,Payment,285.59,-453160.95,GBP,Walmart
TXN0000023434,2024-06-16T22:39:07,ACC00000137,Payment,953.59,-454114.54,GBP,Restaurant
TXN0000023435,2024-08-01T16:49:13,ACC00009742,ATM,1069.09,-455183.63,JPY,Target
TXN0000023436,2024-10-20T13:30:09,ACC00004214,Payment,1581.27,-456764.9,EUR,Grocery
TXN0000023437,2024-05-06T10:13:50,ACC00006046,ATM,1968.69,-458733.59,JPY,Walmart
TXN0000023438,2024-08-15T18:25:30,ACC00009958,Transfer,1639.19,-457094.4,EUR,Grocery
TXN0000023439,2024-04-19T06:03:34,ACC00007114,ATM,112.74,-457207.14,JPY,Online Store
TXN0000023440,2024-03-05T04:09:20,ACC00005858,ATM,832.72,-458039.86,EUR,Restaurant
TXN0000023441,2024-10-08T09:14:44,ACC00005508,Debit,987.77,-459027.63,EUR,Starbucks
TXN0000023442,2024-04-07T02:09:16,ACC00001312,ATM,1816.16,-460843.79,GBP,Online Store
TXN0000023443,2024-12-20T14:45:48,ACC00002073,Transfer,408.39,-460435.4,USD,Shell
TXN0000023444,2024-03-17T23:50:01,ACC00005090,Transfer,1372.22,-459063.18,USD,Walmart
TXN0000023445,2024-07-08T02:20:09,ACC00009905,Payment,52.54,-459115.72,USD,Amazon
TXN0000023446,2024-06-30T12:49:15,ACC00008671,Transfer,1709.45,-457406.27,GBP,Target
TXN0000023447,2024-01-29T21:27:44,ACC00000189,Transfer,1611.05,-455795.22,EUR,Grocery
TXN0000023448,2024-06-15T03:37:02,ACC00004635,ATM,1941.36,-457736.58,USD,Amazon
TXN0000023449,2024-06-11T06:27:49,ACC00008722,Debit,1066.7,-458803.28,JPY,Walmart
TXN0000023450,2024-06-18T01:36:36,ACC00009075,Credit,1157.04,-457646.24,EUR,Grocery
TXN0000023451,2024-03-24T09:02:28,ACC00005069,ATM,1660.34,-459306.58,GBP,Amazon
TXN0000023452,2024-06-13T18:01:56,ACC00000312,Payment,1499.6,-460806.18,JPY,Starbucks
TXN0000023453,2024-03-07T01:06:32,ACC00009504,Transfer,734.37,-460071.81,GBP,Walmart
TXN0000023454,2024-10-16T05:11:44,ACC00006927,Transfer,55.1,-460016.71,EUR,Starbucks
TXN0000023455,2024-08-21T12:16:36,ACC00007425,Payment,381.11,-460397.82,GBP,Walmart
TXN0000023456,2024-07-09T19:22:39,ACC00008131,Transfer,934.01,-459463.81,USD,Amazon
TXN0000023457,2024-01-07T12:10:27,ACC00001500,ATM,850.66,-460314.47,GBP,Starbucks
TXN0000023458,2024-03-24T18:13:47,ACC00007435,Credit,586.83,-459727.64,USD,Amazon
TXN0000023459,2024-06-20T11:38:14,ACC00003685,Credit,1341.16,-458386.48,GBP,Restaurant
TXN0000023460,2024-06-13T18:19:17,ACC00007384,Payment,1102.25,-459488.73,JPY,Walmart
TXN0000023461,2024-03-20T18:27:52,ACC00009659,ATM,628.23,-460116.96,JPY,Starbucks
TXN0000023462,2024-03-11T12:36:19,ACC00000133,Debit,334.76,-460451.72,GBP,Grocery
TXN0000023463,2024-03-24T22:45:04,ACC00004503,ATM,719.49,-461171.21,GBP,Grocery
TXN0000023464,2024-03-09T12:30:49,ACC00007114,ATM,905.77,-462076.98,EUR,Amazon
TXN0000023465,2024-08-21T09:05:26,ACC00005148,ATM,351.43,-462428.41,GBP,Target
TXN0000023466,2024-05-20T07:42:25,ACC00007730,Credit,1269.74,-461158.67,USD,Restaurant
TXN0000023467,2024-03-31T17:52:59,ACC00001243,Transfer,260.15,-460898.52,GBP,Target
TXN0000023468,2024-08-07T12:22:47,ACC00002495,Credit,1181.96,-459716.56,USD,Online Store
TXN0000023469,2024-04-12T13:57:45,ACC00003668,Debit,1006.56,-460723.12,GBP,Shell
TXN0000023470,2024-01-09T04:51:08,ACC00001200,Transfer,508.78,-460214.34,GBP,Grocery
TXN0000023471,2024-05-02T16:51:22,ACC00007681,Payment,88.89,-460303.23,USD,Shell
TXN0000023472,2024-08-22T08:51:11,ACC00004486,Payment,62.36,-460365.59,EUR,Online Store
TXN0000023473,2024-06-21T22:27:17,ACC00004043,Debit,1334.45,-461700.04,USD,Walmart
TXN0000023474,2024-02-12T06:47:44,ACC00003186,Credit,1998.07,-459701.97,JPY,Shell
TXN0000023475,2024-05-19T20:42:17,ACC00003098,ATM,1565.88,-461267.85,JPY,Shell
TXN0000023476,2024-03-06T19:52:52,ACC00004366,Transfer,577.8,-460690.05,JPY,Target
TXN0000023477,2024-01-07T22:36:26,ACC00006851,Payment,1555.44,-462245.49,JPY,Amazon
TXN0000023478,2024-02-16T02:36:23,ACC00001808,Debit,825.63,-463071.12,USD,Target
TXN0000023479,2024-11-01T05:17:20,ACC00000196,Transfer,1952.26,-461118.86,EUR,Grocery
TXN0000023480,2024-12-28T02:23:08,ACC00007954,Debit,1948.36,-463067.22,JPY,Starbucks
TXN0000023481,2024-02-17T23:27:32,ACC00000600,Payment,600.37,-463667.59,GBP,Amazon
TXN0000023482,2024-03-16T04:36:48,ACC00001509,Credit,736.71,-462930.88,GBP,Starbucks
TXN0000023483,2024-01-09T13:58:41,ACC00001499,Debit,604.37,-463535.25,GBP,Starbucks
TXN0000023484,2024-02-04T12:36:38,ACC00000355,Transfer,1251.47,-462283.78,GBP,Online Store
TXN0000023485,2024-05-20T06:43:04,ACC00005246,Transfer,1338.16,-460945.62,JPY,Online Store
TXN0000023486,2024-12-20T06:38:15,ACC00003135,Transfer,213.14,-460732.48,JPY,Walmart
TXN0000023487,2024-09-04T23:22:59,ACC00004094,Transfer,1881.0,-458851.48,JPY,Target
TXN0000023488,2024-06-17T13:59:54,ACC00008365,Debit,475.81,-459327.29,JPY,Amazon
TXN0000023489,2024-09-30T15:37:39,ACC00001123,Debit,170.97,-459498.26,GBP,Amazon
TXN0000023490,2024-04-14T04:51:34,ACC00004419,Transfer,460.08,-459038.18,JPY,Walmart
TXN0000023491,2024-02-17T20:36:46,ACC00000650,Payment,33.27,-459071.45,USD,Walmart
TXN0000023492,2024-10-22T20:57:47,ACC00001761,Transfer,1205.13,-457866.32,JPY,Restaurant
TXN0000023493,2024-02-24T00:25:33,ACC00002150,ATM,1426.4,-459292.72,EUR,Restaurant
TXN0000023494,2024-04-02T18:21:15,ACC00008334,Transfer,399.48,-458893.24,USD,Online Store
TXN0000023495,2024-11-08T22:54:17,ACC00001517,Transfer,100.49,-458792.75,USD,Shell
TXN0000023496,2024-12-13T00:33:07,ACC00002347,Transfer,966.11,-457826.64,USD,Amazon
TXN0000023497,2024-09-22T13:12:17,ACC00001404,ATM,567.81,-458394.45,JPY,Grocery
TXN0000023498,2024-06-12T04:05:30,ACC00000805,Transfer,411.02,-457983.43,GBP,Target
TXN0000023499,2024-09-11T15:11:41,ACC00006651,Payment,301.66,-458285.09,GBP,Grocery
TXN0000023500,2024-03-16T21:03:45,ACC00009313,Credit,214.37,-458070.72,USD,Walmart
TXN0000023501,2024-06-06T02:08:57,ACC00002576,Debit,706.63,-458777.35,EUR,Target
TXN0000023502,2024-12-18T12:41:42,ACC00003185,Credit,1983.37,-456793.98,JPY,Amazon
TXN0000023503,2024-02-19T23:15:24,ACC00002835,Debit,1239.01,-458032.99,USD,Walmart
TXN0000023504,2024-07-05T18:40:49,ACC00008554,Transfer,483.0,-457549.99,EUR,Starbucks
TXN0000023505,2024-09-03T09:25:13,ACC00002318,Debit,29.2,-457579.19,EUR,Target
TXN0000023506,2024-09-09T21:25:02,ACC00001722,Transfer,1658.82,-455920.37,GBP,Starbucks
TXN0000023507,2024-02-06T12:15:46,ACC00000691,Payment,308.74,-456229.11,USD,Walmart
TXN0000023508,2024-01-04T02:51:23,ACC00004057,Debit,1338.68,-457567.79,EUR,Starbucks
TXN0000023509,2024-07-03T12:58:00,ACC00001891,ATM,1831.63,-459399.42,USD,Starbucks
TXN0000023510,2024-01-30T23:47:30,ACC00007474,Credit,208.92,-459190.5,USD,Grocery
TXN0000023511,2024-08-29T18:09:25,ACC00008295,Payment,870.01,-460060.51,USD,Shell
TXN0000023512,2024-06-14T23:11:23,ACC00004275,Payment,896.89,-460957.4,JPY,Restaurant
TXN0000023513,2024-03-06T06:59:04,ACC00006455,Credit,1862.08,-459095.32,USD,Restaurant
TXN0000023514,2024-05-29T08:22:39,ACC00002654,Credit,884.02,-458211.3,EUR,Starbucks
TXN0000023515,2024-03-28T10:02:31,ACC00004620,Debit,1477.93,-459689.23,GBP,Starbucks
TXN0000023516,2024-01-15T05:28:42,ACC00001081,Debit,1316.55,-461005.78,USD,Walmart
TXN0000023517,2024-04-12T21:51:18,ACC00008147,Payment,283.21,-461288.99,EUR,Restaurant
TXN0000023518,2024-10-12T04:19:50,ACC00008148,Debit,1105.35,-462394.34,EUR,Amazon
TXN0000023519,2024-10-24T05:23:54,ACC00000850,Transfer,31.85,-462362.49,USD,Target
TXN0000023520,2024-07-18T02:43:44,ACC00007340,Credit,89.99,-462272.5,JPY,Grocery
TXN0000023521,2024-10-14T17:07:57,ACC00006604,Transfer,166.54,-462105.96,USD,Target
TXN0000023522,2024-02-23T08:37:49,ACC00004254,ATM,1619.0,-463724.96,USD,Starbucks
TXN0000023523,2024-05-01T04:41:37,ACC00005108,ATM,222.22,-463947.18,GBP,Starbucks
TXN0000023524,2024-04-23T09:28:26,ACC00004522,ATM,1242.1,-465189.28,EUR,Amazon
TXN0000023525,2024-02-09T18:57:14,ACC00001795,Debit,1681.73,-466871.01,EUR,Restaurant
TXN0000023526,2024-01-18T11:04:57,ACC00009341,Credit,1062.41,-465808.6,EUR,Starbucks
TXN0000023527,2024-03-26T18:10:49,ACC00002672,Payment,1099.31,-466907.91,JPY,Shell
TXN0000023528,2024-09-05T23:55:09,ACC00004052,Credit,1842.8,-465065.11,EUR,Walmart
TXN0000023529,2024-05-21T04:29:20,ACC00008698,Credit,625.93,-464439.18,EUR,Restaurant
TXN0000023530,2024-09-30T03:13:16,ACC00005820,Payment,114.21,-464553.39,EUR,Amazon
TXN0000023531,2024-05-16T17:38:47,ACC00008242,Payment,773.91,-465327.3,GBP,Online Store
TXN0000023532,2024-01-26T12:41:11,ACC00001606,ATM,1421.64,-466748.94,EUR,Grocery
TXN0000023533,2024-04-18T04:06:24,ACC00005898,Payment,1070.61,-467819.55,USD,Restaurant
TXN0000023534,2024-07-12T04:52:40,ACC00007720,Credit,674.64,-467144.91,USD,Amazon
TXN0000023535,2024-01-16T17:24:09,ACC00003638,Credit,169.47,-466975.44,EUR,Amazon
TXN0000023536,2024-09-09T01:41:18,ACC00008241,Transfer,631.57,-466343.87,EUR,Shell
TXN0000023537,2024-10-09T05:51:30,ACC00009905,Payment,1183.79,-467527.66,USD,Amazon
TXN0000023538,2024-05-19T18:34:50,ACC00003401,Debit,1024.75,-468552.41,USD,Target
TXN0000023539,2024-01-05T05:54:51,ACC00001915,Transfer,563.1,-467989.31,USD,Walmart
TXN0000023540,2024-08-31T20:13:53,ACC00005485,ATM,988.8,-468978.11,EUR,Starbucks
TXN0000023541,2024-09-07T00:35:19,ACC00007599,Payment,685.76,-469663.87,JPY,Restaurant
TXN0000023542,2024-05-07T23:51:50,ACC00005495,Credit,1865.65,-467798.22,USD,Grocery
TXN0000023543,2024-07-23T01:54:10,ACC00005466,Debit,473.52,-468271.74,EUR,Grocery
TXN0000023544,2024-07-15T12:23:00,ACC00001482,Transfer,968.03,-467303.71,GBP,Target
TXN0000023545,2024-05-04T22:24:04,ACC00005113,Transfer,1872.98,-465430.73,JPY,Shell
TXN0000023546,2024-10-06T17:02:45,ACC00006480,Debit,1999.44,-467430.17,JPY,Restaurant
TXN0000023547,2024-03-05T10:26:32,ACC00006545,ATM,447.08,-467877.25,GBP,Starbucks
TXN0000023548,2024-03-18T06:24:19,ACC00006231,Credit,258.21,-467619.04,GBP,Grocery
TXN0000023549,2024-07-20T11:42:56,ACC00004206,Debit,1056.0,-468675.04,JPY,Online Store
TXN0000023550,2024-05-19T20:53:26,ACC00001934,Debit,1597.07,-470272.11,USD,Shell
TXN0000023551,2024-11-23T10:40:19,ACC00009167,Debit,1862.87,-472134.98,JPY,Restaurant
TXN0000023552,2024-06-04T02:44:21,ACC00003544,Payment,1686.69,-473821.67,EUR,Shell
TXN0000023553,2024-05-09T12:16:41,ACC00000308,Payment,1482.2,-475303.87,JPY,Grocery
TXN0000023554,2024-08-19T02:18:46,ACC00004705,Debit,1789.04,-477092.91,JPY,Shell
TXN0000023555,2024-05-24T16:54:46,ACC00001406,Debit,297.51,-477390.42,GBP,Restaurant
TXN0000023556,2024-12-04T20:57:14,ACC00001133,Debit,950.32,-478340.74,GBP,Starbucks
TXN0000023557,2024-01-03T16:27:20,ACC00004500,Credit,1919.95,-476420.79,GBP,Walmart
TXN0000023558,2024-07-04T20:50:45,ACC00008108,Transfer,633.44,-475787.35,USD,Shell
TXN0000023559,2024-05-06T00:52:01,ACC00009133,Debit,1465.5,-477252.85,USD,Amazon
TXN0000023560,2024-04-27T07:21:34,ACC00004922,Payment,1980.07,-479232.92,EUR,Walmart
TXN0000023561,2024-04-03T09:29:41,ACC00008147,ATM,1856.43,-481089.35,GBP,Starbucks
TXN0000023562,2024-01-10T23:32:11,ACC00004837,Payment,1841.72,-482931.07,USD,Amazon
TXN0000023563,2024-01-28T19:03:11,ACC00000863,Debit,230.14,-483161.21,USD,Shell
TXN0000023564,2024-09-06T22:58:35,ACC00003674,Debit,1307.49,-484468.7,GBP,Target
TXN0000023565,2024-10-22T01:15:43,ACC00005794,Credit,985.26,-483483.44,JPY,Online Store
TXN0000023566,2024-09-13T11:20:55,ACC00004998,Transfer,1239.7,-482243.74,USD,Grocery
TXN0000023567,2024-03-12T12:01:12,ACC00008034,Credit,1714.61,-480529.13,GBP,Restaurant
TXN0000023568,2024-05-08T22:31:05,ACC00001728,Credit,160.83,-480368.3,GBP,Online Store
TXN0000023569,2024-06-24T07:29:59,ACC00003056,Debit,179.82,-480548.12,USD,Walmart
TXN0000023570,2024-06-28T12:10:05,ACC00008895,Payment,1996.47,-482544.59,JPY,Grocery
TXN0000023571,2024-08-08T05:30:03,ACC00002242,Transfer,274.75,-482269.84,JPY,Target
TXN0000023572,2024-09-30T21:53:03,ACC00000667,Payment,1950.4,-484220.24,USD,Online Store
TXN0000023573,2024-11-22T18:32:13,ACC00001175,Transfer,1038.08,-483182.16,JPY,Shell
TXN0000023574,2024-03-02T22:53:28,ACC00002600,Debit,1905.79,-485087.95,EUR,Starbucks
TXN0000023575,2024-03-10T14:46:05,ACC00006251,Credit,1742.14,-483345.81,USD,Walmart
TXN0000023576,2024-12-25T14:20:17,ACC00007429,Debit,1854.3,-485200.11,USD,Shell
TXN0000023577,2024-05-30T13:10:02,ACC00007530,Debit,1032.89,-486233.0,GBP,Shell
TXN0000023578,2024-04-26T13:38:28,ACC00000262,ATM,181.31,-486414.31,JPY,Shell
TXN0000023579,2024-12-16T08:07:38,ACC00008745,Payment,1814.22,-488228.53,EUR,Shell
TXN0000023580,2024-05-31T08:51:29,ACC00004477,ATM,1093.99,-489322.52,EUR,Grocery
TXN0000023581,2024-12-22T15:38:54,ACC00008592,Credit,117.55,-489204.97,EUR,Target
TXN0000023582,2024-04-14T07:44:54,ACC00001012,Payment,1852.01,-491056.98,USD,Shell
TXN0000023583,2024-07-31T03:26:01,ACC00006956,ATM,1292.25,-492349.23,USD,Walmart
TXN0000023584,2024-10-06T01:26:56,ACC00002047,Payment,262.91,-492612.14,USD,Shell
TXN0000023585,2024-12-19T05:10:28,ACC00006515,Debit,74.83,-492686.97,GBP,Online Store
TXN0000023586,2024-01-15T08:26:23,ACC00000892,Transfer,1773.1,-490913.87,EUR,Target
TXN0000023587,2024-10-12T19:04:26,ACC00002877,Payment,1332.48,-492246.35,JPY,Shell
TXN0000023588,2024-04-03T00:51:37,ACC00000238,Credit,380.11,-491866.24,EUR,Grocery
TXN0000023589,2024-11-17T01:49:44,ACC00006407,Payment,961.83,-492828.07,USD,Amazon
TXN0000023590,2024-10-04T13:10:16,ACC00003269,Credit,733.81,-492094.26,GBP,Walmart
TXN0000023591,2024-06-28T07:06:35,ACC00009923,Credit,1650.68,-490443.58,JPY,Online Store
TXN0000023592,2024-08-23T02:50:49,ACC00007776,Credit,880.58,-489563.0,GBP,Restaurant
TXN0000023593,2024-01-13T07:12:32,ACC00005427,Payment,1459.99,-491022.99,GBP,Shell
TXN0000023594,2024-02-01T17:24:03,ACC00001609,Payment,1291.47,-492314.46,USD,Grocery
TXN0000023595,2024-04-23T16:58:01,ACC00005983,Credit,1286.64,-491027.82,JPY,Online Store
TXN0000023596,2024-05-25T12:36:54,ACC00008758,Credit,811.12,-490216.7,USD,Amazon
TXN0000023597,2024-10-23T02:48:55,ACC00003899,Transfer,1576.19,-488640.51,EUR,Shell
TXN0000023598,2024-04-14T07:03:05,ACC00005410,Transfer,1986.24,-486654.27,GBP,Starbucks
TXN0000023599,2024-11-25T20:37:15,ACC00005936,Debit,608.97,-487263.24,EUR,Amazon
TXN0000023600,2024-05-08T00:24:36,ACC00004410,ATM,1435.76,-488699.0,JPY,Online Store
TXN0000023601,2024-10-26T20:59:08,ACC00006237,Payment,346.0,-489045.0,EUR,Starbucks
TXN0000023602,2024-12-07T20:16:39,ACC00003013,Payment,1838.83,-490883.83,EUR,Amazon
TXN0000023603,2024-04-06T03:13:51,ACC00003508,Transfer,408.16,-490475.67,GBP,Walmart
TXN0000023604,2024-08-08T13:35:46,ACC00008823,Credit,661.15,-489814.52,JPY,Amazon
TXN0000023605,2024-10-04T15:40:21,ACC00005893,Payment,1870.68,-491685.2,GBP,Grocery
TXN0000023606,2024-04-21T13:46:58,ACC00001665,Payment,1805.39,-493490.59,GBP,Restaurant
TXN0000023607,2024-05-30T15:37:44,ACC00009451,Transfer,562.72,-492927.87,EUR,Restaurant
TXN0000023608,2024-04-23T21:46:59,ACC00002286,ATM,1161.7,-494089.57,EUR,Starbucks
TXN0000023609,2024-05-25T16:13:27,ACC00005888,Payment,119.01,-494208.58,JPY,Shell
TXN0000023610,2024-11-24T10:24:54,ACC00003702,Payment,1649.13,-495857.71,JPY,Online Store
TXN0000023611,2024-10-29T20:52:03,ACC00005549,Debit,1701.38,-497559.09,JPY,Amazon
TXN0000023612,2024-03-15T22:40:55,ACC00009397,Transfer,619.08,-496940.01,EUR,Starbucks
TXN0000023613,2024-07-03T01:01:16,ACC00008287,Transfer,1336.36,-495603.65,EUR,Restaurant
TXN0000023614,2024-06-10T05:04:52,ACC00007188,Debit,1241.26,-496844.91,EUR,Amazon
TXN0000023615,2024-04-24T20:05:48,ACC00005248,Debit,1333.64,-498178.55,JPY,Target
TXN0000023616,2024-12-01T20:05:19,ACC00000672,Payment,1264.31,-499442.86,EUR,Restaurant
TXN0000023617,2024-01-14T00:32:40,ACC00002082,Credit,392.13,-499050.73,EUR,Online Store
TXN0000023618,2024-01-25T10:54:31,ACC00005919,Transfer,1524.22,-497526.51,EUR,Target
TXN0000023619,2024-11-16T13:34:35,ACC00001139,Transfer,902.65,-496623.86,JPY,Shell
TXN0000023620,2024-01-30T17:05:52,ACC00003801,Credit,615.29,-496008.57,USD,Amazon
TXN0000023621,2024-11-14T13:47:10,ACC00005324,Debit,1917.66,-497926.23,EUR,Starbucks
TXN0000023622,2024-02-02T08:18:00,ACC00003184,Debit,32.28,-497958.51,EUR,Restaurant
TXN0000023623,2024-06-19T13:54:15,ACC00008424,Credit,225.71,-497732.8,GBP,Walmart
TXN0000023624,2024-05-28T03:50:16,ACC00009407,Debit,1091.16,-498823.96,GBP,Amazon
TXN0000023625,2024-11-27T11:03:35,ACC00007719,Debit,1283.61,-500107.57,EUR,Online Store
TXN0000023626,2024-02-09T15:19:17,ACC00006719,Credit,315.12,-499792.45,JPY,Target
TXN0000023627,2024-09-03T03:07:19,ACC00005050,Payment,1861.9,-501654.35,JPY,Shell
TXN0000023628,2024-05-16T13:20:56,ACC00003180,Credit,901.29,-500753.06,EUR,Starbucks
TXN0000023629,2024-02-03T16:14:03,ACC00008650,ATM,1573.97,-502327.03,GBP,Starbucks
TXN0000023630,2024-09-20T21:58:21,ACC00000364,Debit,1510.29,-503837.32,EUR,Starbucks
TXN0000023631,2024-09-22T22:20:44,ACC00008301,Debit,1964.48,-505801.8,JPY,Shell
TXN0000023632,2024-11-13T03:21:31,ACC00001090,Transfer,1919.66,-503882.14,JPY,Grocery
TXN0000023633,2024-12-22T10:25:46,ACC00003275,Transfer,1408.83,-502473.31,GBP,Online Store
TXN0000023634,2024-08-02T17:50:41,ACC00002528,Debit,1381.98,-503855.29,USD,Amazon
TXN0000023635,2024-11-09T08:07:29,ACC00002062,Debit,424.72,-504280.01,USD,Grocery
TXN0000023636,2024-08-08T20:55:24,ACC00004774,Transfer,1876.86,-502403.15,GBP,Amazon
TXN0000023637,2024-04-22T03:31:51,ACC00009882,Payment,1225.94,-503629.09,USD,Restaurant
TXN0000023638,2024-01-31T11:55:39,ACC00002556,ATM,966.55,-504595.64,JPY,Walmart
TXN0000023639,2024-09-13T13:43:53,ACC00006301,Debit,15.91,-504611.55,EUR,Amazon
TXN0000023640,2024-02-15T07:36:26,ACC00004370,Transfer,1070.24,-503541.31,USD,Restaurant
TXN0000023641,2024-05-04T07:23:52,ACC00006772,Credit,1516.67,-502024.64,GBP,Walmart
TXN0000023642,2024-06-05T12:06:07,ACC00003390,Credit,40.6,-501984.04,EUR,Online Store
TXN0000023643,2024-05-03T10:18:23,ACC00008347,Transfer,112.4,-501871.64,EUR,Walmart
TXN0000023644,2024-04-08T14:26:37,ACC00008255,Debit,1824.77,-503696.41,EUR,Amazon
TXN0000023645,2024-01-06T07:17:09,ACC00002824,Transfer,1022.15,-502674.26,EUR,Target
TXN0000023646,2024-09-05T08:03:35,ACC00009678,Transfer,267.2,-502407.06,GBP,Restaurant
TXN0000023647,2024-07-02T23:54:09,ACC00001776,Debit,1877.71,-504284.77,EUR,Shell
TXN0000023648,2024-01-09T03:54:14,ACC00003163,ATM,1657.13,-505941.9,JPY,Online Store
TXN0000023649,2024-03-22T21:08:01,ACC00005510,Credit,1904.1,-504037.8,JPY,Starbucks
TXN0000023650,2024-05-25T03:52:47,ACC00001738,ATM,422.57,-504460.37,USD,Online Store
TXN0000023651,2024-03-09T16:30:02,ACC00001049,Payment,1301.17,-505761.54,USD,Starbucks
TXN0000023652,2024-07-24T08:23:53,ACC00007062,Transfer,926.23,-504835.31,USD,Restaurant
TXN0000023653,2024-04-22T14:16:33,ACC00009872,Credit,901.11,-503934.2,EUR,Grocery
TXN0000023654,2024-10-01T20:32:55,ACC00009641,Credit,291.91,-503642.29,USD,Target
TXN0000023655,2024-04-11T16:19:39,ACC00002362,ATM,1544.13,-505186.42,GBP,Starbucks
TXN0000023656,2024-02-16T05:36:01,ACC00004983,Debit,1552.8,-506739.22,EUR,Online Store
TXN0000023657,2024-09-23T12:25:20,ACC00008247,Transfer,678.72,-506060.5,JPY,Online Store
TXN0000023658,2024-08-23T08:00:20,ACC00005267,Payment,1088.09,-507148.59,JPY,Amazon
TXN0000023659,2024-01-31T00:29:14,ACC00003232,Debit,1066.55,-508215.14,GBP,Amazon
TXN0000023660,2024-05-27T04:28:14,ACC00004354,Transfer,685.45,-507529.69,USD,Amazon
TXN0000023661,2024-06-08T21:11:17,ACC00004408,Credit,465.11,-507064.58,EUR,Amazon
TXN0000023662,2024-06-29T19:20:08,ACC00008628,ATM,1071.95,-508136.53,USD,Target
TXN0000023663,2024-09-15T04:29:14,ACC00008692,Payment,1665.03,-509801.56,GBP,Online Store
TXN0000023664,2024-06-14T17:30:45,ACC00009034,Debit,1816.95,-511618.51,GBP,Grocery
TXN0000023665,2024-12-23T03:08:05,ACC00000501,ATM,1169.27,-512787.78,JPY,Amazon
TXN0000023666,2024-07-07T22:33:05,ACC00000054,Debit,1992.73,-514780.51,EUR,Grocery
TXN0000023667,2024-05-10T11:42:26,ACC00001579,Transfer,1738.53,-513041.98,JPY,Grocery
TXN0000023668,2024-07-22T05:42:29,ACC00006382,Credit,474.85,-512567.13,USD,Online Store
TXN0000023669,2024-08-17T17:39:44,ACC00007598,Credit,1508.72,-511058.41,EUR,Restaurant
TXN0000023670,2024-12-08T14:30:56,ACC00003291,ATM,335.85,-511394.26,GBP,Restaurant
TXN0000023671,2024-02-04T22:32:08,ACC00001251,Credit,1677.87,-509716.39,USD,Starbucks
TXN0000023672,2024-03-19T09:13:30,ACC00001916,Transfer,1922.17,-507794.22,EUR,Amazon
TXN0000023673,2024-07-28T04:21:07,ACC00004892,Transfer,161.72,-507632.5,USD,Restaurant
TXN0000023674,2024-11-08T18:51:05,ACC00000960,Debit,1342.4,-508974.9,GBP,Grocery
TXN0000023675,2024-08-05T14:55:17,ACC00005842,ATM,964.2,-509939.1,USD,Amazon
TXN0000023676,2024-07-19T18:41:56,ACC00005870,Credit,1736.04,-508203.06,GBP,Grocery
TXN0000023677,2024-07-24T19:08:22,ACC00001565,ATM,564.83,-508767.89,USD,Restaurant
TXN0000023678,2024-09-18T23:05:27,ACC00000516,Transfer,585.54,-508182.35,USD,Starbucks
TXN0000023679,2024-07-24T02:40:12,ACC00007034,Transfer,183.34,-507999.01,USD,Walmart
TXN0000023680,2024-02-19T06:00:37,ACC00009328,Debit,1990.63,-509989.64,USD,Starbucks
TXN0000023681,2024-09-12T19:36:06,ACC00008140,ATM,880.28,-510869.92,USD,Online Store
TXN0000023682,2024-05-29T23:56:22,ACC00002283,Credit,816.29,-510053.63,EUR,Walmart
TXN0000023683,2024-02-27T14:18:55,ACC00000710,Credit,471.38,-509582.25,EUR,Target
TXN0000023684,2024-10-02T07:29:57,ACC00000156,ATM,1017.66,-510599.91,EUR,Starbucks
TXN0000023685,2024-08-03T04:26:48,ACC00000757,Payment,1181.24,-511781.15,USD,Grocery
TXN0000023686,2024-11-08T08:03:12,ACC00006125,ATM,1857.22,-513638.37,USD,Walmart
TXN0000023687,2024-06-24T23:38:20,ACC00002454,Transfer,1186.84,-512451.53,USD,Grocery
TXN0000023688,2024-05-26T02:29:07,ACC00002902,Payment,785.04,-513236.57,USD,Online Store
TXN0000023689,2024-01-17T13:14:24,ACC00003452,ATM,164.31,-513400.88,JPY,Starbucks
TXN0000023690,2024-12-28T20:00:09,ACC00005240,Credit,259.65,-513141.23,JPY,Grocery
TXN0000023691,2024-01-12T20:45:13,ACC00008909,Transfer,170.35,-512970.88,GBP,Starbucks
TXN0000023692,2024-03-27T04:46:01,ACC00000454,Payment,1902.9,-514873.78,JPY,Restaurant
TXN0000023693,2024-04-22T07:08:31,ACC00003157,ATM,789.66,-515663.44,JPY,Grocery
TXN0000023694,2024-12-17T14:50:58,ACC00009370,ATM,1566.24,-517229.68,GBP,Amazon
TXN0000023695,2024-01-29T02:11:22,ACC00002308,Payment,188.38,-517418.06,JPY,Starbucks
TXN0000023696,2024-02-11T09:04:29,ACC00006321,Debit,1421.35,-518839.41,JPY,Starbucks
TXN0000023697,2024-06-09T23:10:47,ACC00003611,Payment,1314.96,-520154.37,EUR,Shell
TXN0000023698,2024-03-12T02:32:02,ACC00007746,Credit,1008.4,-519145.97,USD,Target
TXN0000023699,2024-03-08T22:18:01,ACC00005703,Transfer,686.22,-518459.75,USD,Target
TXN0000023700,2024-01-28T07:42:00,ACC00001585,Transfer,944.23,-517515.52,GBP,Restaurant
TXN0000023701,2024-04-21T19:45:17,ACC00009128,Credit,1438.73,-516076.79,JPY,Amazon
TXN0000023702,2024-07-31T06:36:59,ACC00006209,Payment,1104.35,-517181.14,USD,Grocery
TXN0000023703,2024-09-14T16:55:23,ACC00006270,Debit,1886.92,-519068.06,EUR,Restaurant
TXN0000023704,2024-01-29T19:50:00,ACC00004337,ATM,906.95,-519975.01,JPY,Shell
TXN0000023705,2024-02-03T03:28:05,ACC00005419,ATM,1869.28,-521844.29,EUR,Target
TXN0000023706,2024-03-27T13:59:02,ACC00009770,Debit,1105.57,-522949.86,EUR,Walmart
TXN0000023707,2024-08-09T19:03:20,ACC00007776,Debit,988.91,-523938.77,USD,Restaurant
TXN0000023708,2024-05-22T08:43:43,ACC00006834,Transfer,1667.31,-522271.46,USD,Shell
TXN0000023709,2024-01-17T17:54:44,ACC00000388,Transfer,1684.8,-520586.66,JPY,Online Store
TXN0000023710,2024-08-28T13:28:42,ACC00009907,Debit,1279.47,-521866.13,USD,Amazon
TXN0000023711,2024-11-18T06:42:12,ACC00000080,ATM,1905.29,-523771.42,EUR,Walmart
TXN0000023712,2024-12-13T00:46:25,ACC00006477,Credit,295.31,-523476.11,USD,Walmart
TXN0000023713,2024-03-27T09:01:41,ACC00003515,Transfer,1586.39,-521889.72,EUR,Amazon
TXN0000023714,2024-08-28T20:52:55,ACC00000560,Debit,1061.6,-522951.32,JPY,Target
TXN0000023715,2024-05-29T06:28:19,ACC00005220,Credit,1713.38,-521237.94,USD,Restaurant
TXN0000023716,2024-11-27T13:36:47,ACC00004184,ATM,940.75,-522178.69,GBP,Target
TXN0000023717,2024-06-13T14:54:07,ACC00004986,Payment,1380.68,-523559.37,JPY,Online Store
TXN0000023718,2024-06-23T21:29:35,ACC00002058,Transfer,1900.99,-521658.38,EUR,Shell
TXN0000023719,2024-05-19T17:17:10,ACC00003312,Debit,1074.4,-522732.78,EUR,Target
TXN0000023720,2024-05-22T15:13:52,ACC00004641,Transfer,467.02,-522265.76,EUR,Amazon
TXN0000023721,2024-10-16T23:42:16,ACC00006595,Payment,461.32,-522727.08,EUR,Grocery
TXN0000023722,2024-11-11T10:30:21,ACC00001528,Payment,1445.8,-524172.88,GBP,Amazon
TXN0000023723,2024-09-27T01:27:46,ACC00006779,Credit,1593.34,-522579.54,EUR,Grocery
TXN0000023724,2024-08-09T17:59:28,ACC00007336,Payment,1393.52,-523973.06,USD,Starbucks
TXN0000023725,2024-09-22T11:15:58,ACC00007772,Credit,1949.78,-522023.28,USD,Shell
TXN0000023726,2024-10-31T04:29:39,ACC00008472,Transfer,1044.37,-520978.91,JPY,Amazon
TXN0000023727,2024-02-12T01:27:38,ACC00001499,ATM,620.44,-521599.35,EUR,Shell
TXN0000023728,2024-06-01T20:35:07,ACC00000184,Transfer,1938.13,-519661.22,GBP,Amazon
TXN0000023729,2024-12-14T05:58:22,ACC00004386,Credit,1109.38,-518551.84,USD,Restaurant
TXN0000023730,2024-03-17T13:44:49,ACC00008222,ATM,962.73,-519514.57,JPY,Shell
TXN0000023731,2024-04-15T08:39:04,ACC00002160,Debit,1641.92,-521156.49,USD,Online Store
TXN0000023732,2024-04-22T21:30:31,ACC00003531,Transfer,320.83,-520835.66,GBP,Amazon
TXN0000023733,2024-02-19T01:50:11,ACC00003673,Payment,1699.8,-522535.46,JPY,Walmart
TXN0000023734,2024-12-06T18:48:13,ACC00008920,ATM,1797.24,-524332.7,USD,Walmart
TXN0000023735,2024-07-10T17:13:50,ACC00005397,Transfer,601.55,-523731.15,GBP,Starbucks
TXN0000023736,2024-01-21T20:55:13,ACC00006897,Transfer,1262.59,-522468.56,JPY,Shell
TXN0000023737,2024-05-21T13:54:38,ACC00008591,Debit,1931.14,-524399.7,JPY,Online Store
TXN0000023738,2024-09-14T10:02:56,ACC00005501,Payment,1992.25,-526391.95,JPY,Starbucks
TXN0000023739,2024-09-25T11:37:25,ACC00003120,ATM,848.66,-527240.61,GBP,Shell
TXN0000023740,2024-07-20T06:58:06,ACC00006502,ATM,1441.45,-528682.06,GBP,Target
TXN0000023741,2024-03-27T07:00:37,ACC00007312,Transfer,1915.47,-526766.59,EUR,Restaurant
TXN0000023742,2024-06-05T06:00:48,ACC00007017,ATM,1512.01,-528278.6,GBP,Shell
TXN0000023743,2024-06-10T17:11:00,ACC00000608,ATM,1664.76,-529943.36,EUR,Grocery
TXN0000023744,2024-05-14T13:52:52,ACC00007842,Debit,1942.69,-531886.05,JPY,Target
TXN0000023745,2024-05-12T02:28:27,ACC00007279,Transfer,1385.29,-530500.76,GBP,Restaurant
TXN0000023746,2024-10-08T19:15:15,ACC00000052,Payment,567.94,-531068.7,GBP,Amazon
TXN0000023747,2024-02-05T01:34:01,ACC00003287,ATM,156.66,-531225.36,EUR,Target
TXN0000023748,2024-07-29T02:08:39,ACC00006843,Debit,753.25,-531978.61,EUR,Online Store
TXN0000023749,2024-07-04T04:20:03,ACC00008557,Debit,918.53,-532897.14,JPY,Target
TXN0000023750,2024-03-29T00:16:17,ACC00003154,Credit,1576.11,-531321.03,USD,Target
TXN0000023751,2024-11-04T17:23:22,ACC00007457,Transfer,1399.28,-529921.75,EUR,Starbucks
TXN0000023752,2024-05-28T17:20:29,ACC00000456,Transfer,1284.56,-528637.19,GBP,Amazon
TXN0000023753,2024-01-24T17:35:16,ACC00001034,ATM,1526.95,-530164.14,USD,Shell
TXN0000023754,2024-01-05T18:54:39,ACC00009184,Debit,1762.86,-531927.0,GBP,Starbucks
TXN0000023755,2024-10-09T00:01:43,ACC00008995,Credit,574.34,-531352.66,GBP,Restaurant
TXN0000023756,2024-11-15T00:28:24,ACC00005867,Transfer,1858.41,-529494.25,JPY,Starbucks
TXN0000023757,2024-11-10T18:14:59,ACC00000487,Transfer,1502.36,-527991.89,JPY,Grocery
TXN0000023758,2024-12-07T03:15:57,ACC00008506,Debit,590.14,-528582.03,EUR,Starbucks
TXN0000023759,2024-12-11T01:34:07,ACC00001064,Transfer,13.04,-528568.99,EUR,Shell
TXN0000023760,2024-09-15T21:45:56,ACC00002976,ATM,1021.01,-529590.0,GBP,Starbucks
TXN0000023761,2024-05-11T16:14:52,ACC00006203,Credit,136.91,-529453.09,EUR,Amazon
TXN0000023762,2024-11-08T13:34:08,ACC00001610,Credit,627.2,-528825.89,USD,Amazon
TXN0000023763,2024-10-17T09:02:16,ACC00009369,Debit,1062.64,-529888.53,JPY,Online Store
TXN0000023764,2024-09-11T17:55:14,ACC00000908,Payment,1800.06,-531688.59,EUR,Walmart
TXN0000023765,2024-01-25T10:03:46,ACC00006803,Debit,1333.89,-533022.48,USD,Walmart
TXN0000023766,2024-04-19T21:52:28,ACC00001540,Payment,743.27,-533765.75,EUR,Amazon
TXN0000023767,2024-09-23T20:00:59,ACC00000004,Debit,1529.11,-535294.86,JPY,Online Store
TXN0000023768,2024-08-26T00:49:04,ACC00009543,Credit,1803.18,-533491.68,JPY,Online Store
TXN0000023769,2024-12-02T22:31:33,ACC00004381,Transfer,41.04,-533450.64,GBP,Grocery
TXN0000023770,2024-10-31T04:58:42,ACC00004631,ATM,74.06,-533524.7,USD,Target
TXN0000023771,2024-03-14T06:22:25,ACC00007784,ATM,1589.84,-535114.54,JPY,Online Store
TXN0000023772,2024-12-18T01:36:52,ACC00006410,Debit,1365.61,-536480.15,EUR,Amazon
TXN0000023773,2024-11-17T06:11:26,ACC00002408,ATM,813.22,-537293.37,JPY,Grocery
TXN0000023774,2024-10-10T15:47:33,ACC00004488,ATM,1327.47,-538620.84,GBP,Restaurant
TXN0000023775,2024-08-06T00:36:51,ACC00000743,ATM,196.67,-538817.51,USD,Online Store
TXN0000023776,2024-08-16T12:39:41,ACC00008000,Debit,1106.24,-539923.75,EUR,Amazon
TXN0000023777,2024-04-19T10:08:24,ACC00007416,ATM,1176.43,-541100.18,EUR,Starbucks
TXN0000023778,2024-01-07T20:34:43,ACC00002033,Debit,110.05,-541210.23,JPY,Grocery
TXN0000023779,2024-06-13T08:59:29,ACC00006565,Transfer,1756.75,-539453.48,JPY,Starbucks
TXN0000023780,2024-05-09T20:34:17,ACC00002696,Credit,905.51,-538547.97,JPY,Target
TXN0000023781,2024-10-30T22:19:03,ACC00005871,Transfer,1260.56,-537287.41,USD,Starbucks
TXN0000023782,2024-03-31T16:30:41,ACC00000096,Debit,1386.64,-538674.05,JPY,Target
TXN0000023783,2024-12-01T17:26:42,ACC00006787,Credit,1262.91,-537411.14,EUR,Target
TXN0000023784,2024-02-18T11:14:09,ACC00001611,Credit,317.18,-537093.96,JPY,Starbucks
TXN0000023785,2024-09-14T01:07:44,ACC00000175,ATM,474.55,-537568.51,JPY,Shell
TXN0000023786,2024-08-10T14:52:37,ACC00004151,Transfer,174.3,-537394.21,JPY,Walmart
TXN0000023787,2024-06-27T10:34:15,ACC00007974,Transfer,1081.09,-536313.12,JPY,Shell
TXN0000023788,2024-07-01T18:33:02,ACC00000284,Transfer,956.96,-535356.16,JPY,Amazon
TXN0000023789,2024-02-13T06:18:40,ACC00007869,ATM,641.25,-535997.41,GBP,Grocery
TXN0000023790,2024-11-01T09:46:08,ACC00007958,ATM,524.24,-536521.65,JPY,Target
TXN0000023791,2024-01-03T16:45:18,ACC00001775,ATM,1029.49,-537551.14,JPY,Amazon
TXN0000023792,2024-04-11T02:43:00,ACC00007368,Payment,379.68,-537930.82,EUR,Target
TXN0000023793,2024-01-12T05:10:36,ACC00008449,Credit,181.97,-537748.85,USD,Target
TXN0000023794,2024-04-23T12:16:45,ACC00003916,Debit,1664.84,-539413.69,EUR,Restaurant
TXN0000023795,2024-08-07T00:21:45,ACC00006156,Debit,1144.25,-540557.94,EUR,Starbucks
TXN0000023796,2024-04-12T16:53:12,ACC00007241,Transfer,218.28,-540339.66,GBP,Online Store
TXN0000023797,2024-04-16T12:59:52,ACC00002961,Debit,792.59,-541132.25,JPY,Walmart
TXN0000023798,2024-12-18T01:25:41,ACC00007555,ATM,1051.02,-542183.27,GBP,Amazon
TXN0000023799,2024-04-30T15:48:57,ACC00005653,Transfer,1598.83,-540584.44,GBP,Grocery
TXN0000023800,2024-12-05T11:33:56,ACC00000843,Payment,1134.83,-541719.27,USD,Target
TXN0000023801,2024-12-24T22:24:38,ACC00008742,Transfer,710.01,-541009.26,JPY,Grocery
TXN0000023802,2024-12-05T21:42:34,ACC00007488,Debit,883.06,-541892.32,JPY,Shell
TXN0000023803,2024-02-08T05:06:00,ACC00009019,Transfer,1310.24,-540582.08,USD,Restaurant
TXN0000023804,2024-05-22T09:17:38,ACC00008186,Payment,1833.32,-542415.4,GBP,Amazon
TXN0000023805,2024-06-14T05:47:56,ACC00009886,Payment,1044.98,-543460.38,GBP,Shell
TXN0000023806,2024-07-02T07:11:47,ACC00009284,Payment,822.64,-544283.02,USD,Amazon
TXN0000023807,2024-08-02T15:42:50,ACC00000220,ATM,1558.59,-545841.61,JPY,Starbucks
TXN0000023808,2024-09-25T09:44:52,ACC00004921,ATM,727.82,-546569.43,USD,Walmart
TXN0000023809,2024-05-29T02:59:31,ACC00008204,Debit,1419.77,-547989.2,EUR,Restaurant
TXN0000023810,2024-07-18T06:54:37,ACC00007452,Debit,434.55,-548423.75,EUR,Shell
TXN0000023811,2024-11-14T19:25:37,ACC00003238,ATM,709.73,-549133.48,USD,Restaurant
TXN0000023812,2024-09-01T12:22:35,ACC00003375,Transfer,1655.98,-547477.5,JPY,Online Store
TXN0000023813,2024-08-30T21:51:49,ACC00005069,Payment,1480.46,-548957.96,GBP,Walmart
TXN0000023814,2024-12-07T21:35:07,ACC00008903,ATM,1676.1,-550634.06,USD,Shell
TXN0000023815,2024-08-26T01:56:01,ACC00004845,Payment,1813.82,-552447.88,JPY,Online Store
TXN0000023816,2024-09-02T13:30:00,ACC00003210,Credit,1491.47,-550956.41,JPY,Grocery
TXN0000023817,2024-11-08T03:09:28,ACC00002947,Payment,1421.55,-552377.96,USD,Target
TXN0000023818,2024-10-21T11:05:15,ACC00003168,ATM,518.75,-552896.71,GBP,Amazon
TXN0000023819,2024-08-20T16:25:55,ACC00000332,Transfer,569.25,-552327.46,USD,Online Store
TXN0000023820,2024-06-24T10:22:05,ACC00006045,Payment,927.92,-553255.38,EUR,Shell
TXN0000023821,2024-10-13T10:37:24,ACC00002500,Transfer,341.31,-552914.07,JPY,Starbucks
TXN0000023822,2024-05-24T22:24:28,ACC00001874,Credit,1890.25,-551023.82,USD,Walmart
TXN0000023823,2024-07-30T04:30:20,ACC00000022,Transfer,636.13,-550387.69,USD,Shell
TXN0000023824,2024-02-07T07:13:10,ACC00004106,Credit,317.59,-550070.1,EUR,Restaurant
TXN0000023825,2024-07-29T00:45:36,ACC00005652,Transfer,1817.94,-548252.16,EUR,Shell
TXN0000023826,2024-04-21T07:04:20,ACC00001012,Payment,734.82,-548986.98,JPY,Target
TXN0000023827,2024-12-11T02:03:43,ACC00005318,ATM,1435.91,-550422.89,EUR,Online Store
TXN0000023828,2024-06-20T01:40:53,ACC00002421,ATM,1108.02,-551530.91,JPY,Shell
TXN0000023829,2024-06-17T16:50:12,ACC00006693,Payment,1842.67,-553373.58,USD,Amazon
TXN0000023830,2024-08-07T03:39:15,ACC00006151,Transfer,644.36,-552729.22,EUR,Restaurant
TXN0000023831,2024-06-30T16:39:47,ACC00009877,Credit,903.65,-551825.57,USD,Shell
TXN0000023832,2024-06-06T03:58:31,ACC00008853,Payment,1005.79,-552831.36,JPY,Walmart
TXN0000023833,2024-08-10T12:39:41,ACC00001026,Payment,1268.89,-554100.25,USD,Starbucks
TXN0000023834,2024-06-16T22:48:09,ACC00005703,Payment,203.63,-554303.88,GBP,Walmart
TXN0000023835,2024-12-22T21:46:56,ACC00001492,ATM,1864.99,-556168.87,EUR,Grocery
TXN0000023836,2024-06-23T16:10:04,ACC00005573,Payment,1466.77,-557635.64,GBP,Shell
TXN0000023837,2024-04-29T06:27:04,ACC00000768,Transfer,504.39,-557131.25,EUR,Walmart
TXN0000023838,2024-11-10T00:59:11,ACC00004661,Credit,1057.49,-556073.76,JPY,Amazon
TXN0000023839,2024-02-13T03:02:35,ACC00009000,Debit,1095.53,-557169.29,JPY,Amazon
TXN0000023840,2024-03-11T19:13:39,ACC00009875,Debit,1933.85,-559103.14,JPY,Restaurant
TXN0000023841,2024-01-22T19:25:37,ACC00009221,Debit,1842.76,-560945.9,EUR,Amazon
TXN0000023842,2024-04-28T09:39:25,ACC00006305,Payment,297.72,-561243.62,EUR,Restaurant
TXN0000023843,2024-11-28T03:09:53,ACC00002078,ATM,66.72,-561310.34,GBP,Walmart
TXN0000023844,2024-12-22T12:49:32,ACC00000369,Credit,130.05,-561180.29,USD,Restaurant
TXN0000023845,2024-09-17T13:22:02,ACC00005133,Debit,183.99,-561364.28,USD,Restaurant
TXN0000023846,2024-11-03T03:07:27,ACC00002368,Payment,595.06,-561959.34,EUR,Target
TXN0000023847,2024-01-13T15:31:52,ACC00006996,Payment,1845.71,-563805.05,USD,Online Store
TXN0000023848,2024-03-28T22:50:57,ACC00002761,Payment,603.57,-564408.62,GBP,Amazon
TXN0000023849,2024-10-17T17:03:47,ACC00001665,Debit,618.41,-565027.03,EUR,Walmart
TXN0000023850,2024-12-22T10:52:33,ACC00009050,Transfer,1827.28,-563199.75,JPY,Restaurant
TXN0000023851,2024-05-05T16:20:16,ACC00001242,Transfer,1093.48,-562106.27,JPY,Restaurant
TXN0000023852,2024-04-04T14:15:22,ACC00000948,ATM,636.0,-562742.27,USD,Shell
TXN0000023853,2024-10-03T14:38:14,ACC00002150,Credit,1976.08,-560766.19,USD,Shell
TXN0000023854,2024-02-17T13:34:17,ACC00001722,Debit,1972.4,-562738.59,EUR,Walmart
TXN0000023855,2024-04-22T11:51:04,ACC00002257,Debit,1880.71,-564619.3,EUR,Amazon
TXN0000023856,2024-05-01T14:43:53,ACC00009204,Credit,207.26,-564412.04,USD,Amazon
TXN0000023857,2024-03-10T03:20:18,ACC00007402,ATM,73.41,-564485.45,USD,Amazon
TXN0000023858,2024-08-27T01:26:06,ACC00006811,Debit,1083.59,-565569.04,USD,Walmart
TXN0000023859,2024-06-17T02:25:01,ACC00002744,Transfer,1551.56,-564017.48,USD,Restaurant
TXN0000023860,2024-01-12T13:29:09,ACC00007170,Payment,1409.6,-565427.08,GBP,Grocery
TXN0000023861,2024-07-07T06:23:20,ACC00006014,Debit,138.47,-565565.55,GBP,Starbucks
TXN0000023862,2024-08-05T21:25:55,ACC00004060,Payment,729.01,-566294.56,USD,Online Store
TXN0000023863,2024-10-03T21:10:36,ACC00004284,ATM,1588.58,-567883.14,EUR,Restaurant
TXN0000023864,2024-08-02T16:40:13,ACC00004425,ATM,840.4,-568723.54,EUR,Shell
TXN0000023865,2024-07-11T08:54:09,ACC00001033,Debit,121.82,-568845.36,EUR,Shell
TXN0000023866,2024-09-16T01:19:53,ACC00003643,Credit,745.57,-568099.79,JPY,Walmart
TXN0000023867,2024-11-24T02:21:16,ACC00008401,ATM,396.53,-568496.32,GBP,Restaurant
TXN0000023868,2024-04-30T03:09:50,ACC00005719,Transfer,809.66,-567686.66,JPY,Walmart
TXN0000023869,2024-06-28T18:02:27,ACC00005933,Payment,351.38,-568038.04,JPY,Walmart
TXN0000023870,2024-12-26T16:31:29,ACC00000978,Credit,1900.87,-566137.17,EUR,Shell
TXN0000023871,2024-10-30T13:29:16,ACC00004602,Transfer,1119.71,-565017.46,USD,Starbucks
TXN0000023872,2024-05-30T02:05:42,ACC00000154,Credit,347.49,-564669.97,USD,Grocery
TXN0000023873,2024-02-14T23:17:48,ACC00001259,Debit,324.04,-564994.01,EUR,Grocery
TXN0000023874,2024-04-10T03:53:48,ACC00003702,Debit,1451.0,-566445.01,JPY,Online Store
TXN0000023875,2024-12-11T05:26:08,ACC00009298,Debit,1339.84,-567784.85,USD,Restaurant
TXN0000023876,2024-08-22T22:37:21,ACC00007028,ATM,1309.18,-569094.03,EUR,Walmart
TXN0000023877,2024-02-27T09:33:39,ACC00006801,Debit,801.5,-569895.53,EUR,Grocery
TXN0000023878,2024-08-19T15:51:43,ACC00003941,Debit,1320.86,-571216.39,GBP,Starbucks
TXN0000023879,2024-03-18T03:50:14,ACC00008334,ATM,878.88,-572095.27,EUR,Target
TXN0000023880,2024-03-16T00:06:44,ACC00007946,Credit,350.31,-571744.96,GBP,Grocery
TXN0000023881,2024-05-29T09:45:43,ACC00005248,Debit,1381.05,-573126.01,USD,Starbucks
TXN0000023882,2024-11-29T03:31:04,ACC00003321,Debit,1974.67,-575100.68,EUR,Shell
TXN0000023883,2024-10-28T02:07:45,ACC00005893,ATM,1286.19,-576386.87,EUR,Grocery
TXN0000023884,2024-12-17T14:50:18,ACC00006584,Debit,1796.85,-578183.72,EUR,Restaurant
TXN0000023885,2024-11-04T01:03:21,ACC00006826,Credit,193.23,-577990.49,USD,Amazon
TXN0000023886,2024-12-07T18:52:52,ACC00004458,Payment,635.43,-578625.92,JPY,Amazon
TXN0000023887,2024-06-27T03:25:25,ACC00006770,Transfer,1026.31,-577599.61,GBP,Grocery
TXN0000023888,2024-12-24T21:01:41,ACC00009833,ATM,1176.59,-578776.2,USD,Starbucks
TXN0000023889,2024-06-22T21:11:48,ACC00008705,Debit,1694.78,-580470.98,JPY,Amazon
TXN0000023890,2024-11-22T11:20:59,ACC00002827,Credit,1374.88,-579096.1,JPY,Restaurant
TXN0000023891,2024-01-13T13:00:47,ACC00000731,Credit,721.37,-578374.73,JPY,Shell
TXN0000023892,2024-06-19T14:54:59,ACC00001014,Debit,225.64,-578600.37,JPY,Starbucks
TXN0000023893,2024-10-01T20:18:08,ACC00007113,Payment,77.81,-578678.18,GBP,Shell
TXN0000023894,2024-05-05T07:46:47,ACC00009319,ATM,1538.9,-580217.08,GBP,Walmart
TXN0000023895,2024-07-25T23:33:45,ACC00004693,Transfer,1427.04,-578790.04,EUR,Amazon
TXN0000023896,2024-01-16T07:06:02,ACC00007890,ATM,993.04,-579783.08,USD,Starbucks
TXN0000023897,2024-01-15T10:14:07,ACC00007481,Debit,1113.66,-580896.74,EUR,Grocery
TXN0000023898,2024-10-14T17:57:03,ACC00001590,Credit,1225.05,-579671.69,EUR,Target
TXN0000023899,2024-03-26T03:22:00,ACC00002751,Credit,749.7,-578921.99,GBP,Online Store
TXN0000023900,2024-12-02T05:07:42,ACC00004527,Transfer,1087.94,-577834.05,GBP,Starbucks
TXN0000023901,2024-11-02T03:41:02,ACC00006895,Debit,411.74,-578245.79,GBP,Target
TXN0000023902,2024-02-10T21:45:01,ACC00009193,Transfer,1567.77,-576678.02,JPY,Target
TXN0000023903,2024-03-10T18:04:38,ACC00005630,ATM,1917.65,-578595.67,JPY,Target
TXN0000023904,2024-08-11T03:19:36,ACC00003355,Transfer,1454.21,-577141.46,GBP,Walmart
TXN0000023905,2024-05-23T01:34:08,ACC00001849,ATM,516.98,-577658.44,JPY,Grocery
TXN0000023906,2024-12-08T16:45:33,ACC00008745,Transfer,1631.57,-576026.87,GBP,Walmart
TXN0000023907,2024-03-14T19:26:21,ACC00006782,ATM,475.2,-576502.07,EUR,Online Store
TXN0000023908,2024-01-17T21:13:32,ACC00007284,Debit,505.08,-577007.15,USD,Amazon
TXN0000023909,2024-08-15T22:17:37,ACC00006918,Payment,382.0,-577389.15,EUR,Amazon
TXN0000023910,2024-11-06T23:19:14,ACC00005000,Transfer,1454.89,-575934.26,JPY,Target
TXN0000023911,2024-01-28T19:53:41,ACC00000843,ATM,471.46,-576405.72,GBP,Grocery
TXN0000023912,2024-03-12T01:18:32,ACC00002394,Payment,352.21,-576757.93,USD,Online Store
TXN0000023913,2024-09-12T01:26:27,ACC00005543,Debit,1369.74,-578127.67,GBP,Restaurant
TXN0000023914,2024-12-12T06:36:18,ACC00004502,Transfer,323.6,-577804.07,GBP,Target
TXN0000023915,2024-05-10T00:16:54,ACC00005987,ATM,1913.96,-579718.03,USD,Amazon
TXN0000023916,2024-11-05T11:29:26,ACC00008203,Credit,1121.75,-578596.28,USD,Restaurant
TXN0000023917,2024-09-25T10:25:38,ACC00006851,Credit,1616.03,-576980.25,EUR,Restaurant
TXN0000023918,2024-10-10T01:44:25,ACC00008413,Debit,714.43,-577694.68,USD,Grocery
TXN0000023919,2024-12-27T17:23:52,ACC00005113,Credit,1789.3,-575905.38,USD,Restaurant
TXN0000023920,2024-02-29T14:01:16,ACC00001666,Transfer,181.04,-575724.34,EUR,Grocery
TXN0000023921,2024-01-04T22:10:30,ACC00000955,Payment,1830.92,-577555.26,GBP,Grocery
TXN0000023922,2024-09-05T00:11:11,ACC00007888,Transfer,1663.48,-575891.78,USD,Amazon
TXN0000023923,2024-09-29T11:11:34,ACC00005237,Debit,1075.59,-576967.37,GBP,Online Store
TXN0000023924,2024-10-03T22:01:26,ACC00006311,Debit,1211.78,-578179.15,GBP,Shell
TXN0000023925,2024-08-20T15:31:25,ACC00005860,ATM,1129.44,-579308.59,JPY,Shell
TXN0000023926,2024-05-24T08:43:57,ACC00007324,Transfer,1384.38,-577924.21,EUR,Target
TXN0000023927,2024-05-06T05:13:35,ACC00002019,Debit,1007.01,-578931.22,EUR,Target
TXN0000023928,2024-05-12T06:02:25,ACC00000014,ATM,647.61,-579578.83,GBP,Grocery
TXN0000023929,2024-12-29T10:40:21,ACC00007779,ATM,1920.39,-581499.22,EUR,Target
TXN0000023930,2024-01-17T14:27:23,ACC00006203,ATM,11.61,-581510.83,GBP,Grocery
TXN0000023931,2024-07-04T23:03:06,ACC00004689,Transfer,1872.91,-579637.92,EUR,Target
TXN0000023932,2024-02-16T10:17:31,ACC00003106,Transfer,983.2,-578654.72,USD,Restaurant
TXN0000023933,2024-10-22T19:43:21,ACC00004992,Transfer,419.04,-578235.68,EUR,Walmart
TXN0000023934,2024-10-02T00:14:33,ACC00006726,Credit,1791.22,-576444.46,EUR,Shell
TXN0000023935,2024-07-14T05:07:31,ACC00005897,Payment,1055.91,-577500.37,EUR,Online Store
TXN0000023936,2024-07-22T13:37:36,ACC00005760,Debit,154.72,-577655.09,USD,Restaurant
TXN0000023937,2024-11-12T02:26:43,ACC00003002,ATM,1685.95,-579341.04,EUR,Grocery
TXN0000023938,2024-01-03T22:45:44,ACC00004406,Transfer,1045.45,-578295.59,EUR,Starbucks
TXN0000023939,2024-08-19T19:01:15,ACC00006361,ATM,597.37,-578892.96,USD,Starbucks
TXN0000023940,2024-03-19T01:58:39,ACC00000577,Payment,624.8,-579517.76,EUR,Online Store
TXN0000023941,2024-10-01T23:34:38,ACC00000566,Credit,45.19,-579472.57,USD,Walmart
TXN0000023942,2024-12-15T06:14:11,ACC00002064,ATM,1542.85,-581015.42,JPY,Shell
TXN0000023943,2024-08-26T23:49:09,ACC00003725,Debit,1131.98,-582147.4,USD,Starbucks
TXN0000023944,2024-08-23T07:08:48,ACC00006731,Debit,1713.06,-583860.46,GBP,Shell
TXN0000023945,2024-12-23T03:05:52,ACC00004980,Debit,419.16,-584279.62,GBP,Restaurant
TXN0000023946,2024-12-19T07:08:20,ACC00006372,ATM,343.34,-584622.96,USD,Online Store
TXN0000023947,2024-05-08T06:18:36,ACC00006971,Credit,1712.81,-582910.15,JPY,Restaurant
TXN0000023948,2024-01-07T02:02:06,ACC00005213,Transfer,552.19,-582357.96,JPY,Online Store
TXN0000023949,2024-08-10T06:40:35,ACC00003585,Debit,1660.12,-584018.08,JPY,Shell
TXN0000023950,2024-07-27T22:17:37,ACC00004027,Credit,1891.18,-582126.9,USD,Online Store
TXN0000023951,2024-12-27T16:07:12,ACC00002802,Payment,355.82,-582482.72,EUR,Restaurant
TXN0000023952,2024-08-31T03:21:33,ACC00008961,Payment,495.75,-582978.47,EUR,Shell
TXN0000023953,2024-09-16T18:19:00,ACC00007132,Debit,1709.42,-584687.89,JPY,Target
TXN0000023954,2024-04-19T14:56:29,ACC00002414,Transfer,462.98,-584224.91,USD,Amazon
TXN0000023955,2024-08-30T23:34:12,ACC00000315,Payment,356.25,-584581.16,USD,Starbucks
TXN0000023956,2024-07-12T10:30:43,ACC00007345,Credit,346.88,-584234.28,EUR,Restaurant
TXN0000023957,2024-07-23T01:59:46,ACC00002385,Payment,1885.75,-586120.03,USD,Starbucks
TXN0000023958,2024-06-14T21:13:30,ACC00008417,Credit,1540.29,-584579.74,GBP,Target
TXN0000023959,2024-03-21T01:31:19,ACC00006700,Payment,1780.86,-586360.6,JPY,Amazon
TXN0000023960,2024-07-01T11:56:00,ACC00009251,Payment,1933.46,-588294.06,EUR,Shell
TXN0000023961,2024-08-03T07:10:07,ACC00004337,Payment,1978.59,-590272.65,GBP,Walmart
TXN0000023962,2024-12-05T10:01:29,ACC00000681,Payment,725.77,-590998.42,JPY,Walmart
TXN0000023963,2024-08-13T03:56:24,ACC00006165,Credit,971.06,-590027.36,EUR,Target
TXN0000023964,2024-01-20T09:07:01,ACC00002841,Debit,940.0,-590967.36,EUR,Amazon
TXN0000023965,2024-05-13T21:24:24,ACC00007698,ATM,1944.78,-592912.14,USD,Restaurant
TXN0000023966,2024-11-30T08:10:50,ACC00005900,Credit,238.21,-592673.93,EUR,Shell
TXN0000023967,2024-03-31T04:35:46,ACC00005466,Payment,477.69,-593151.62,GBP,Online Store
TXN0000023968,2024-11-12T10:38:39,ACC00005790,Transfer,513.54,-592638.08,EUR,Grocery
TXN0000023969,2024-01-05T01:21:53,ACC00005168,Debit,905.54,-593543.62,EUR,Grocery
TXN0000023970,2024-08-04T18:55:39,ACC00008194,Transfer,1554.94,-591988.68,EUR,Amazon
TXN0000023971,2024-05-11T14:40:22,ACC00006017,ATM,1783.8,-593772.48,EUR,Starbucks
TXN0000023972,2024-01-08T19:44:42,ACC00009596,Credit,481.43,-593291.05,GBP,Grocery
TXN0000023973,2024-03-21T13:30:57,ACC00002460,ATM,1213.43,-594504.48,EUR,Online Store
TXN0000023974,2024-10-25T14:00:00,ACC00000475,Transfer,302.42,-594202.06,GBP,Target
TXN0000023975,2024-07-05T04:53:31,ACC00002604,Debit,162.48,-594364.54,JPY,Amazon
TXN0000023976,2024-05-03T05:28:17,ACC00009919,Credit,10.63,-594353.91,USD,Restaurant
TXN0000023977,2024-05-29T23:48:42,ACC00008916,Debit,1230.74,-595584.65,EUR,Grocery
TXN0000023978,2024-02-21T00:15:33,ACC00009489,Payment,838.26,-596422.91,JPY,Restaurant
TXN0000023979,2024-03-26T15:55:28,ACC00005474,Credit,1020.68,-595402.23,USD,Grocery
TXN0000023980,2024-03-03T13:26:21,ACC00003570,Debit,125.17,-595527.4,JPY,Starbucks
TXN0000023981,2024-08-09T10:00:53,ACC00003467,Transfer,922.92,-594604.48,GBP,Shell
TXN0000023982,2024-02-17T06:16:55,ACC00001967,Transfer,45.66,-594558.82,JPY,Restaurant
TXN0000023983,2024-08-03T20:33:59,ACC00009427,Transfer,1952.0,-592606.82,JPY,Amazon
TXN0000023984,2024-08-29T00:28:19,ACC00005684,Transfer,397.38,-592209.44,EUR,Target
TXN0000023985,2024-11-18T14:24:52,ACC00006260,ATM,860.15,-593069.59,JPY,Restaurant
TXN0000023986,2024-12-02T20:53:47,ACC00004635,Credit,228.24,-592841.35,GBP,Amazon
TXN0000023987,2024-11-22T16:50:25,ACC00006409,ATM,1159.6,-594000.95,USD,Online Store
TXN0000023988,2024-04-10T20:37:51,ACC00004505,Debit,1228.19,-595229.14,JPY,Restaurant
TXN0000023989,2024-06-06T01:15:24,ACC00009987,Credit,1228.55,-594000.59,EUR,Walmart
TXN0000023990,2024-07-04T03:46:50,ACC00004344,Debit,1962.31,-595962.9,EUR,Amazon
TXN0000023991,2024-11-06T04:21:06,ACC00005956,Transfer,20.81,-595942.09,USD,Amazon
TXN0000023992,2024-04-09T07:24:32,ACC00007046,Payment,486.71,-596428.8,GBP,Target
TXN0000023993,2024-07-20T14:08:37,ACC00000033,Credit,999.3,-595429.5,EUR,Shell
TXN0000023994,2024-04-13T14:40:23,ACC00007793,Payment,1985.4,-597414.9,JPY,Amazon
TXN0000023995,2024-02-19T18:29:33,ACC00008646,Payment,1675.3,-599090.2,JPY,Online Store
TXN0000023996,2024-02-02T10:12:08,ACC00000567,Payment,1911.3,-601001.5,JPY,Online Store
TXN0000023997,2024-06-22T17:37:04,ACC00008128,Payment,388.49,-601389.99,EUR,Restaurant
TXN0000023998,2024-11-04T01:53:07,ACC00009547,Debit,1780.97,-603170.96,JPY,Restaurant
TXN0000023999,2024-12-21T21:06:27,ACC00004874,Payment,926.25,-604097.21,GBP,Walmart
TXN0000024000,2024-10-14T07:37:50,ACC00003891,Payment,23.23,-604120.44,USD,Amazon
TXN0000024001,2024-03-24T01:07:46,ACC00007536,Debit,239.02,-604359.46,JPY,Online Store
TXN0000024002,2024-09-07T04:22:27,ACC00007985,Payment,846.54,-605206.0,EUR,Restaurant
TXN0000024003,2024-03-03T21:48:09,ACC00008018,Debit,1105.48,-606311.48,USD,Shell
TXN0000024004,2024-06-20T07:15:13,ACC00001686,Payment,1804.43,-608115.91,GBP,Grocery
TXN0000024005,2024-05-13T18:33:32,ACC00005666,Transfer,404.11,-607711.8,EUR,Target
TXN0000024006,2024-08-20T22:24:59,ACC00005714,Transfer,30.14,-607681.66,JPY,Starbucks
TXN0000024007,2024-02-05T11:51:21,ACC00004962,Transfer,1049.26,-606632.4,EUR,Shell
TXN0000024008,2024-03-03T01:10:04,ACC00009624,ATM,1642.97,-608275.37,JPY,Online Store
TXN0000024009,2024-09-05T08:06:18,ACC00003488,Transfer,1297.21,-606978.16,GBP,Grocery
TXN0000024010,2024-04-27T21:42:32,ACC00003115,Payment,566.92,-607545.08,JPY,Restaurant
TXN0000024011,2024-03-10T09:23:53,ACC00004807,Credit,871.37,-606673.71,USD,Starbucks
TXN0000024012,2024-01-14T04:37:49,ACC00008076,Transfer,1516.35,-605157.36,GBP,Walmart
TXN0000024013,2024-07-04T00:38:31,ACC00000452,Credit,1511.63,-603645.73,GBP,Online Store
TXN0000024014,2024-02-13T04:24:18,ACC00009848,Payment,1661.23,-605306.96,GBP,Online Store
TXN0000024015,2024-12-23T06:39:15,ACC00000240,Transfer,1503.09,-603803.87,EUR,Grocery
TXN0000024016,2024-07-30T09:43:23,ACC00002512,Payment,1271.92,-605075.79,GBP,Starbucks
TXN0000024017,2024-06-21T10:50:26,ACC00000466,Payment,321.64,-605397.43,EUR,Amazon
TXN0000024018,2024-05-19T11:57:04,ACC00006757,Credit,800.07,-604597.36,EUR,Grocery
TXN0000024019,2024-11-11T21:32:24,ACC00001144,Credit,1067.63,-603529.73,JPY,Restaurant
TXN0000024020,2024-05-19T20:43:26,ACC00008278,Credit,1059.06,-602470.67,GBP,Starbucks
TXN0000024021,2024-03-16T02:52:35,ACC00000328,Transfer,1244.57,-601226.1,JPY,Amazon
TXN0000024022,2024-01-14T05:04:13,ACC00005352,Payment,1024.27,-602250.37,USD,Amazon
TXN0000024023,2024-10-13T17:11:32,ACC00009750,Transfer,339.5,-601910.87,USD,Starbucks
TXN0000024024,2024-03-07T17:29:07,ACC00004320,Debit,235.72,-602146.59,USD,Online Store
TXN0000024025,2024-11-29T21:54:32,ACC00007112,Transfer,1591.09,-600555.5,GBP,Walmart
TXN0000024026,2024-05-03T00:52:17,ACC00007129,ATM,676.45,-601231.95,JPY,Shell
TXN0000024027,2024-10-01T10:42:05,ACC00003646,Credit,31.06,-601200.89,JPY,Walmart
TXN0000024028,2024-03-27T09:15:45,ACC00008801,Credit,943.01,-600257.88,GBP,Amazon
TXN0000024029,2024-09-16T20:53:42,ACC00000243,Debit,188.25,-600446.13,GBP,Target
TXN0000024030,2024-03-19T20:49:07,ACC00009423,Transfer,1388.46,-599057.67,GBP,Walmart
TXN0000024031,2024-04-20T21:12:28,ACC00008563,Payment,403.51,-599461.18,EUR,Restaurant
TXN0000024032,2024-09-10T22:27:59,ACC00003739,Payment,682.77,-600143.95,EUR,Grocery
TXN0000024033,2024-05-25T06:19:48,ACC00009824,Payment,1364.71,-601508.66,USD,Amazon
TXN0000024034,2024-01-25T09:01:36,ACC00008982,ATM,893.96,-602402.62,JPY,Grocery
TXN0000024035,2024-12-17T07:47:38,ACC00005810,ATM,1712.59,-604115.21,USD,Shell
TXN0000024036,2024-04-02T05:18:52,ACC00008263,Transfer,1148.86,-602966.35,GBP,Amazon
TXN0000024037,2024-10-02T03:00:00,ACC00002515,Payment,420.89,-603387.24,USD,Amazon
TXN0000024038,2024-06-09T01:36:20,ACC00005797,Payment,887.45,-604274.69,GBP,Starbucks
TXN0000024039,2024-05-13T21:57:28,ACC00009900,Transfer,649.31,-603625.38,EUR,Shell
TXN0000024040,2024-01-23T00:40:03,ACC00006910,ATM,1053.75,-604679.13,EUR,Restaurant
TXN0000024041,2024-02-23T21:21:18,ACC00007235,Debit,985.82,-605664.95,GBP,Shell
TXN0000024042,2024-08-24T14:19:25,ACC00009139,ATM,725.22,-606390.17,JPY,Starbucks
TXN0000024043,2024-03-04T15:43:48,ACC00004828,Credit,1258.74,-605131.43,JPY,Walmart
TXN0000024044,2024-03-27T20:51:50,ACC00002446,Transfer,320.68,-604810.75,JPY,Amazon
TXN0000024045,2024-03-28T14:28:03,ACC00007510,ATM,350.76,-605161.51,USD,Restaurant
TXN0000024046,2024-08-12T17:27:16,ACC00000535,Payment,1391.1,-606552.61,JPY,Target
TXN0000024047,2024-12-25T21:09:16,ACC00001214,Credit,980.61,-605572.0,USD,Restaurant
TXN0000024048,2024-07-14T02:49:21,ACC00003467,Payment,52.16,-605624.16,JPY,Walmart
TXN0000024049,2024-02-24T07:59:10,ACC00005319,ATM,890.2,-606514.36,EUR,Target
TXN0000024050,2024-12-30T03:49:40,ACC00000547,Debit,75.94,-606590.3,USD,Restaurant
TXN0000024051,2024-09-11T15:05:12,ACC00001028,Credit,835.73,-605754.57,GBP,Starbucks
TXN0000024052,2024-05-09T12:47:17,ACC00005920,Debit,1810.64,-607565.21,GBP,Starbucks
TXN0000024053,2024-01-27T11:52:22,ACC00001916,Payment,1293.2,-608858.41,GBP,Walmart
TXN0000024054,2024-08-23T06:17:03,ACC00008231,ATM,374.99,-609233.4,JPY,Walmart
TXN0000024055,2024-10-21T20:02:52,ACC00008273,Payment,1156.08,-610389.48,JPY,Target
TXN0000024056,2024-07-18T10:43:45,ACC00008045,Payment,1938.77,-612328.25,JPY,Online Store
TXN0000024057,2024-05-14T13:09:49,ACC00004669,Payment,1215.6,-613543.85,JPY,Amazon
TXN0000024058,2024-01-27T13:52:58,ACC00007815,Credit,436.97,-613106.88,USD,Online Store
TXN0000024059,2024-10-17T07:02:05,ACC00000294,ATM,1097.52,-614204.4,USD,Shell
TXN0000024060,2024-08-29T23:06:32,ACC00009687,Payment,1987.76,-616192.16,EUR,Online Store
TXN0000024061,2024-09-03T09:59:23,ACC00007471,Transfer,903.59,-615288.57,JPY,Amazon
TXN0000024062,2024-12-24T19:15:43,ACC00004792,Payment,838.18,-616126.75,JPY,Amazon
TXN0000024063,2024-10-13T15:56:09,ACC00005687,Credit,1923.92,-614202.83,JPY,Target
TXN0000024064,2024-07-28T11:01:13,ACC00003369,Payment,838.45,-615041.28,GBP,Shell
TXN0000024065,2024-07-06T01:20:41,ACC00002245,Payment,1716.39,-616757.67,GBP,Amazon
TXN0000024066,2024-09-27T06:32:07,ACC00009842,ATM,561.22,-617318.89,USD,Grocery
TXN0000024067,2024-10-10T16:28:21,ACC00003081,Transfer,1385.66,-615933.23,USD,Online Store
TXN0000024068,2024-09-11T10:04:56,ACC00003006,ATM,746.51,-616679.74,USD,Amazon
TXN0000024069,2024-01-19T17:54:10,ACC00002089,Debit,443.93,-617123.67,GBP,Grocery
TXN0000024070,2024-10-17T06:37:37,ACC00007106,Transfer,1813.53,-615310.14,USD,Shell
TXN0000024071,2024-09-10T18:25:56,ACC00003912,Debit,1590.54,-616900.68,USD,Online Store
TXN0000024072,2024-01-22T22:45:41,ACC00007223,Transfer,1951.1,-614949.58,EUR,Target
TXN0000024073,2024-12-23T11:13:37,ACC00002626,Transfer,59.88,-614889.7,JPY,Amazon
TXN0000024074,2024-07-27T12:56:43,ACC00001977,Transfer,840.86,-614048.84,USD,Shell
TXN0000024075,2024-04-14T22:17:27,ACC00004230,ATM,1192.04,-615240.88,JPY,Walmart
TXN0000024076,2024-06-24T04:53:05,ACC00006490,ATM,439.16,-615680.04,EUR,Walmart
TXN0000024077,2024-01-16T12:53:31,ACC00002168,Debit,1384.61,-617064.65,EUR,Grocery
TXN0000024078,2024-12-16T23:07:35,ACC00006999,Debit,1761.5,-618826.15,EUR,Shell
TXN0000024079,2024-05-25T17:00:26,ACC00001282,Debit,1899.45,-620725.6,USD,Online Store
TXN0000024080,2024-11-09T07:09:28,ACC00005646,Transfer,409.25,-620316.35,USD,Target
TXN0000024081,2024-10-24T20:33:55,ACC00005761,Transfer,118.63,-620197.72,EUR,Shell
TXN0000024082,2024-02-28T19:19:35,ACC00002865,Credit,374.63,-619823.09,GBP,Starbucks
TXN0000024083,2024-02-16T06:25:26,ACC00009346,Credit,238.6,-619584.49,EUR,Restaurant
TXN0000024084,2024-12-22T02:37:29,ACC00007109,Transfer,327.79,-619256.7,EUR,Grocery
TXN0000024085,2024-11-07T23:05:57,ACC00009986,Transfer,431.46,-618825.24,GBP,Target
TXN0000024086,2024-09-15T11:16:17,ACC00003141,Credit,1958.27,-616866.97,JPY,Amazon
TXN0000024087,2024-05-20T13:13:31,ACC00009822,Transfer,345.86,-616521.11,JPY,Target
TXN0000024088,2024-01-23T19:45:18,ACC00002742,Debit,1392.86,-617913.97,GBP,Shell
TXN0000024089,2024-06-08T01:55:53,ACC00007377,ATM,1764.3,-619678.27,GBP,Restaurant
TXN0000024090,2024-05-08T12:20:54,ACC00005817,Debit,1511.45,-621189.72,EUR,Restaurant
TXN0000024091,2024-05-11T09:54:31,ACC00000028,Transfer,1993.02,-619196.7,USD,Online Store
TXN0000024092,2024-03-22T00:24:57,ACC00003819,ATM,172.05,-619368.75,GBP,Shell
TXN0000024093,2024-08-21T01:28:38,ACC00002467,Transfer,227.37,-619141.38,EUR,Amazon
TXN0000024094,2024-02-12T13:04:07,ACC00008453,ATM,1184.21,-620325.59,USD,Walmart
TXN0000024095,2024-11-09T20:14:10,ACC00009437,Payment,1673.04,-621998.63,JPY,Walmart
TXN0000024096,2024-05-23T11:59:52,ACC00008593,Transfer,989.12,-621009.51,USD,Restaurant
TXN0000024097,2024-08-10T19:33:35,ACC00002153,Payment,1739.68,-622749.19,GBP,Shell
TXN0000024098,2024-12-11T01:09:46,ACC00005190,Transfer,1734.14,-621015.05,EUR,Online Store
TXN0000024099,2024-06-26T04:11:10,ACC00004021,Payment,653.61,-621668.66,GBP,Shell
TXN0000024100,2024-08-30T17:09:42,ACC00007296,Credit,920.73,-620747.93,EUR,Grocery
TXN0000024101,2024-10-19T15:55:02,ACC00000120,Credit,139.49,-620608.44,USD,Online Store
TXN0000024102,2024-08-26T13:33:23,ACC00002940,ATM,1233.61,-621842.05,USD,Amazon
TXN0000024103,2024-04-13T17:25:44,ACC00001733,Debit,1014.15,-622856.2,EUR,Online Store
TXN0000024104,2024-01-31T23:00:18,ACC00004444,ATM,1636.82,-624493.02,JPY,Walmart
TXN0000024105,2024-11-23T10:24:02,ACC00007908,Transfer,1131.31,-623361.71,JPY,Amazon
TXN0000024106,2024-08-06T12:46:50,ACC00004496,Payment,1418.55,-624780.26,USD,Target
TXN0000024107,2024-06-01T20:51:22,ACC00009172,Credit,1457.14,-623323.12,JPY,Online Store
TXN0000024108,2024-08-30T19:37:06,ACC00002250,Payment,341.27,-623664.39,USD,Grocery
TXN0000024109,2024-11-09T21:16:37,ACC00004513,Payment,471.24,-624135.63,GBP,Shell
TXN0000024110,2024-11-27T11:36:11,ACC00006716,Debit,145.18,-624280.81,EUR,Amazon
TXN0000024111,2024-09-17T02:09:55,ACC00005376,Debit,489.55,-624770.36,GBP,Grocery
TXN0000024112,2024-06-28T19:34:35,ACC00000884,ATM,245.36,-625015.72,EUR,Restaurant
TXN0000024113,2024-06-09T01:38:01,ACC00002199,Payment,777.64,-625793.36,USD,Amazon
TXN0000024114,2024-09-02T05:47:54,ACC00001949,ATM,1026.77,-626820.13,JPY,Amazon
TXN0000024115,2024-09-23T15:11:16,ACC00009937,Transfer,1057.06,-625763.07,JPY,Starbucks
TXN0000024116,2024-09-30T05:06:56,ACC00002512,ATM,562.34,-626325.41,GBP,Target
TXN0000024117,2024-06-30T12:57:47,ACC00001922,Debit,1144.13,-627469.54,GBP,Amazon
TXN0000024118,2024-09-04T16:39:52,ACC00000405,Payment,1347.3,-628816.84,EUR,Restaurant
TXN0000024119,2024-05-30T19:05:24,ACC00004435,Transfer,1205.17,-627611.67,USD,Walmart
TXN0000024120,2024-09-24T13:06:31,ACC00006621,Debit,1448.18,-629059.85,GBP,Walmart
TXN0000024121,2024-10-27T07:37:20,ACC00008732,Transfer,78.28,-628981.57,USD,Grocery
TXN0000024122,2024-04-11T04:08:47,ACC00006138,Debit,101.3,-629082.87,EUR,Restaurant
TXN0000024123,2024-03-19T07:59:01,ACC00006936,ATM,244.0,-629326.87,EUR,Online Store
TXN0000024124,2024-07-08T02:46:54,ACC00007195,ATM,1688.02,-631014.89,GBP,Shell
TXN0000024125,2024-04-16T11:21:04,ACC00007093,Payment,276.79,-631291.68,USD,Restaurant
TXN0000024126,2024-06-30T02:39:02,ACC00001281,Credit,1757.8,-629533.88,GBP,Walmart
TXN0000024127,2024-01-17T22:58:03,ACC00009592,ATM,1361.09,-630894.97,USD,Shell
TXN0000024128,2024-03-13T11:11:41,ACC00006733,Payment,1492.38,-632387.35,JPY,Shell
TXN0000024129,2024-06-21T07:38:48,ACC00007246,Transfer,798.91,-631588.44,JPY,Amazon
TXN0000024130,2024-10-13T14:37:19,ACC00006191,Payment,1614.4,-633202.84,EUR,Amazon
TXN0000024131,2024-02-04T18:09:41,ACC00003319,Debit,148.36,-633351.2,USD,Online Store
TXN0000024132,2024-01-12T04:12:02,ACC00004260,Credit,921.21,-632429.99,USD,Online Store
TXN0000024133,2024-11-09T09:57:12,ACC00000702,Credit,1118.13,-631311.86,GBP,Target
TXN0000024134,2024-07-19T15:29:47,ACC00008414,Debit,1753.37,-633065.23,JPY,Online Store
TXN0000024135,2024-01-18T19:21:55,ACC00008738,Payment,872.65,-633937.88,USD,Grocery
TXN0000024136,2024-12-11T15:24:16,ACC00003062,ATM,611.68,-634549.56,GBP,Target
TXN0000024137,2024-01-18T21:20:03,ACC00004948,Transfer,971.23,-633578.33,JPY,Starbucks
TXN0000024138,2024-12-20T13:23:56,ACC00002476,Transfer,643.92,-632934.41,JPY,Shell
TXN0000024139,2024-12-10T04:39:22,ACC00008145,ATM,846.58,-633780.99,GBP,Online Store
TXN0000024140,2024-07-27T13:36:01,ACC00003887,Debit,624.46,-634405.45,JPY,Walmart
TXN0000024141,2024-10-07T04:00:32,ACC00004085,Debit,1344.13,-635749.58,EUR,Walmart
TXN0000024142,2024-10-21T07:35:31,ACC00001015,Debit,982.4,-636731.98,GBP,Walmart
TXN0000024143,2024-10-08T06:11:27,ACC00002256,Payment,1244.0,-637975.98,JPY,Grocery
TXN0000024144,2024-08-01T00:11:21,ACC00006146,Credit,600.32,-637375.66,GBP,Target
TXN0000024145,2024-07-30T00:58:01,ACC00008710,Credit,1975.26,-635400.4,GBP,Online Store
TXN0000024146,2024-07-23T02:47:01,ACC00006098,Credit,125.43,-635274.97,JPY,Restaurant
TXN0000024147,2024-06-06T17:10:29,ACC00005035,Debit,1966.2,-637241.17,GBP,Grocery
TXN0000024148,2024-12-05T15:10:10,ACC00008466,ATM,381.36,-637622.53,GBP,Target
TXN0000024149,2024-02-20T16:36:48,ACC00002841,Debit,1335.33,-638957.86,USD,Walmart
TXN0000024150,2024-10-09T21:14:54,ACC00007696,Debit,446.82,-639404.68,USD,Shell
TXN0000024151,2024-09-10T03:39:32,ACC00004647,Debit,704.28,-640108.96,EUR,Online Store
TXN0000024152,2024-05-27T22:37:18,ACC00007966,Credit,327.69,-639781.27,JPY,Target
TXN0000024153,2024-07-25T12:34:17,ACC00009004,Debit,1884.24,-641665.51,EUR,Amazon
TXN0000024154,2024-10-07T13:57:16,ACC00001178,ATM,1018.05,-642683.56,EUR,Walmart
TXN0000024155,2024-01-05T12:32:22,ACC00000885,Credit,1050.97,-641632.59,USD,Starbucks
TXN0000024156,2024-08-02T01:15:02,ACC00005931,Payment,491.85,-642124.44,USD,Target
TXN0000024157,2024-09-21T22:29:00,ACC00009964,ATM,1762.52,-643886.96,USD,Starbucks
TXN0000024158,2024-10-13T12:04:05,ACC00004202,Transfer,1510.68,-642376.28,JPY,Target
TXN0000024159,2024-08-03T05:20:44,ACC00006524,Debit,1146.18,-643522.46,JPY,Restaurant
TXN0000024160,2024-04-10T21:08:31,ACC00004528,ATM,1804.38,-645326.84,JPY,Target
TXN0000024161,2024-10-31T08:35:30,ACC00004021,Credit,285.75,-645041.09,JPY,Restaurant
TXN0000024162,2024-02-19T08:57:12,ACC00005803,Credit,1649.96,-643391.13,JPY,Shell
TXN0000024163,2024-01-12T03:51:02,ACC00006475,Payment,1952.71,-645343.84,USD,Amazon
TXN0000024164,2024-03-21T01:53:10,ACC00000230,Payment,771.67,-646115.51,EUR,Online Store
TXN0000024165,2024-01-14T23:20:49,ACC00004522,Debit,697.94,-646813.45,GBP,Shell
TXN0000024166,2024-09-22T04:41:38,ACC00006794,Debit,30.69,-646844.14,EUR,Amazon
TXN0000024167,2024-04-05T01:23:12,ACC00007060,Debit,1748.14,-648592.28,GBP,Grocery
TXN0000024168,2024-05-24T01:07:38,ACC00009008,Payment,1816.7,-650408.98,EUR,Restaurant
TXN0000024169,2024-07-06T11:54:13,ACC00009266,Credit,1190.28,-649218.7,USD,Grocery
TXN0000024170,2024-06-05T00:24:47,ACC00008805,Debit,1519.5,-650738.2,JPY,Target
TXN0000024171,2024-04-23T04:34:58,ACC00009607,Transfer,170.66,-650567.54,JPY,Walmart
TXN0000024172,2024-04-14T03:47:41,ACC00000372,Debit,29.64,-650597.18,GBP,Walmart
TXN0000024173,2024-05-11T07:28:07,ACC00002033,Payment,726.37,-651323.55,EUR,Online Store
TXN0000024174,2024-04-11T08:46:53,ACC00008922,Transfer,1038.59,-650284.96,EUR,Shell
TXN0000024175,2024-08-01T14:39:07,ACC00008855,ATM,1916.49,-652201.45,EUR,Shell
TXN0000024176,2024-03-30T12:38:36,ACC00007292,ATM,1624.53,-653825.98,EUR,Grocery
TXN0000024177,2024-10-09T04:59:42,ACC00004476,ATM,1161.95,-654987.93,USD,Grocery
TXN0000024178,2024-08-06T09:25:07,ACC00007404,ATM,1218.69,-656206.62,USD,Online Store
TXN0000024179,2024-05-07T17:37:37,ACC00007742,Credit,996.81,-655209.81,GBP,Amazon
TXN0000024180,2024-03-08T14:11:12,ACC00005446,Debit,1352.87,-656562.68,USD,Amazon
TXN0000024181,2024-02-28T18:15:29,ACC00006023,Payment,60.68,-656623.36,GBP,Shell
TXN0000024182,2024-05-24T10:06:27,ACC00002275,Transfer,836.85,-655786.51,JPY,Amazon
TXN0000024183,2024-08-12T19:04:16,ACC00007676,Payment,1305.08,-657091.59,JPY,Amazon
TXN0000024184,2024-02-09T15:41:11,ACC00008612,ATM,231.08,-657322.67,EUR,Shell
TXN0000024185,2024-05-22T03:01:25,ACC00006983,Payment,1957.21,-659279.88,EUR,Online Store
TXN0000024186,2024-09-24T17:37:15,ACC00007788,Payment,1758.38,-661038.26,GBP,Target
TXN0000024187,2024-02-29T16:52:10,ACC00000618,Credit,110.07,-660928.19,USD,Target
TXN0000024188,2024-08-30T00:43:50,ACC00005358,Transfer,1066.49,-659861.7,JPY,Target
TXN0000024189,2024-07-09T09:31:16,ACC00006022,Transfer,1353.38,-658508.32,USD,Starbucks
TXN0000024190,2024-01-13T23:57:53,ACC00002815,Transfer,531.78,-657976.54,GBP,Starbucks
TXN0000024191,2024-03-01T17:59:19,ACC00001723,Credit,1109.31,-656867.23,GBP,Shell
TXN0000024192,2024-02-12T22:47:19,ACC00005225,Credit,1577.11,-655290.12,EUR,Starbucks
TXN0000024193,2024-11-17T16:58:59,ACC00000178,ATM,1026.57,-656316.69,USD,Walmart
TXN0000024194,2024-10-21T00:25:28,ACC00001503,Debit,380.43,-656697.12,USD,Grocery
TXN0000024195,2024-12-15T08:41:42,ACC00008318,Payment,1175.32,-657872.44,JPY,Restaurant
TXN0000024196,2024-01-06T21:26:08,ACC00008195,ATM,687.48,-658559.92,EUR,Target
TXN0000024197,2024-07-24T07:24:43,ACC00000759,Debit,1761.64,-660321.56,USD,Grocery
TXN0000024198,2024-05-21T10:29:27,ACC00009295,ATM,1874.01,-662195.57,GBP,Amazon
TXN0000024199,2024-11-24T22:39:09,ACC00008455,Debit,385.1,-662580.67,EUR,Online Store
TXN0000024200,2024-04-22T22:29:14,ACC00008745,Debit,1869.36,-664450.03,EUR,Online Store
TXN0000024201,2024-03-15T18:54:57,ACC00005360,Credit,1889.3,-662560.73,JPY,Amazon
TXN0000024202,2024-01-16T06:53:36,ACC00000306,Debit,525.01,-663085.74,GBP,Shell
TXN0000024203,2024-08-28T11:38:10,ACC00008609,Debit,907.78,-663993.52,EUR,Shell
TXN0000024204,2024-11-05T01:14:46,ACC00002828,Debit,1559.86,-665553.38,JPY,Walmart
TXN0000024205,2024-03-16T01:22:11,ACC00006257,ATM,1434.67,-666988.05,GBP,Amazon
TXN0000024206,2024-07-10T09:58:16,ACC00006785,Transfer,893.42,-666094.63,USD,Grocery
TXN0000024207,2024-01-19T17:16:41,ACC00006557,ATM,1350.46,-667445.09,USD,Grocery
TXN0000024208,2024-09-19T06:12:30,ACC00000375,ATM,1202.21,-668647.3,JPY,Restaurant
TXN0000024209,2024-05-10T10:32:31,ACC00009031,Transfer,662.46,-667984.84,JPY,Target
TXN0000024210,2024-05-17T21:29:42,ACC00009656,Credit,478.61,-667506.23,USD,Amazon
TXN0000024211,2024-06-01T00:21:14,ACC00001226,Debit,1233.72,-668739.95,JPY,Target
TXN0000024212,2024-03-14T10:24:38,ACC00004735,Transfer,143.62,-668596.33,EUR,Walmart
TXN0000024213,2024-08-04T21:52:47,ACC00008904,Payment,212.48,-668808.81,USD,Target
TXN0000024214,2024-01-07T23:15:23,ACC00007405,Payment,1757.58,-670566.39,GBP,Restaurant
TXN0000024215,2024-03-29T01:31:47,ACC00006147,ATM,286.14,-670852.53,EUR,Starbucks
TXN0000024216,2024-12-15T23:26:42,ACC00008560,Credit,1305.65,-669546.88,USD,Shell
TXN0000024217,2024-04-29T16:16:02,ACC00000718,Debit,1602.23,-671149.11,JPY,Walmart
TXN0000024218,2024-08-04T06:05:56,ACC00006066,ATM,1595.69,-672744.8,EUR,Restaurant
TXN0000024219,2024-05-01T12:38:06,ACC00006696,Debit,610.83,-673355.63,USD,Target
TXN0000024220,2024-11-25T08:54:05,ACC00002698,ATM,411.51,-673767.14,EUR,Walmart
TXN0000024221,2024-03-01T12:31:12,ACC00007136,Credit,1702.87,-672064.27,EUR,Online Store
TXN0000024222,2024-02-04T08:44:24,ACC00008961,Payment,571.16,-672635.43,JPY,Target
TXN0000024223,2024-08-21T22:17:30,ACC00005410,Payment,1362.97,-673998.4,GBP,Grocery
TXN0000024224,2024-07-11T10:13:07,ACC00001664,Payment,1847.65,-675846.05,USD,Amazon
TXN0000024225,2024-09-28T10:42:26,ACC00001598,Payment,894.48,-676740.53,JPY,Shell
TXN0000024226,2024-08-20T18:24:16,ACC00007161,Debit,1267.27,-678007.8,EUR,Restaurant
TXN0000024227,2024-07-31T20:06:36,ACC00005468,Credit,1286.75,-676721.05,EUR,Online Store
TXN0000024228,2024-09-30T20:32:59,ACC00002971,Payment,815.7,-677536.75,GBP,Restaurant
TXN0000024229,2024-09-04T16:40:42,ACC00006506,Credit,834.25,-676702.5,USD,Target
TXN0000024230,2024-12-28T15:20:29,ACC00003899,Transfer,1038.05,-675664.45,GBP,Starbucks
TXN0000024231,2024-10-04T21:33:21,ACC00005723,Debit,652.26,-676316.71,EUR,Restaurant
TXN0000024232,2024-07-26T14:21:31,ACC00001392,Credit,508.93,-675807.78,JPY,Amazon
TXN0000024233,2024-01-06T04:12:59,ACC00001890,ATM,1807.13,-677614.91,JPY,Online Store
TXN0000024234,2024-01-25T14:05:37,ACC00003265,ATM,309.18,-677924.09,JPY,Walmart
TXN0000024235,2024-03-16T01:12:18,ACC00005600,Debit,74.64,-677998.73,USD,Target
TXN0000024236,2024-12-05T03:02:01,ACC00001636,Credit,1067.84,-676930.89,GBP,Amazon
TXN0000024237,2024-04-07T20:01:43,ACC00000955,Credit,45.48,-676885.41,EUR,Online Store
TXN0000024238,2024-05-30T23:51:00,ACC00000923,Credit,866.1,-676019.31,USD,Shell
TXN0000024239,2024-04-02T11:29:59,ACC00004239,Payment,132.31,-676151.62,GBP,Grocery
TXN0000024240,2024-07-24T02:30:55,ACC00001718,ATM,518.89,-676670.51,GBP,Target
TXN0000024241,2024-06-24T17:06:00,ACC00000838,Transfer,237.52,-676432.99,USD,Restaurant
TXN0000024242,2024-08-26T19:09:23,ACC00005044,Payment,250.87,-676683.86,USD,Online Store
TXN0000024243,2024-06-14T00:42:05,ACC00009442,Credit,1419.71,-675264.15,EUR,Online Store
TXN0000024244,2024-12-24T13:26:21,ACC00008693,ATM,278.01,-675542.16,GBP,Shell
TXN0000024245,2024-09-03T03:26:06,ACC00006433,Credit,369.53,-675172.63,JPY,Shell
TXN0000024246,2024-09-07T17:11:50,ACC00008641,ATM,1065.72,-676238.35,EUR,Amazon
TXN0000024247,2024-11-26T14:36:56,ACC00005260,Payment,1780.28,-678018.63,GBP,Restaurant
TXN0000024248,2024-01-01T07:42:46,ACC00005120,Credit,927.37,-677091.26,GBP,Online Store
TXN0000024249,2024-09-28T21:56:44,ACC00001046,Credit,234.15,-676857.11,GBP,Amazon
TXN0000024250,2024-01-31T06:53:48,ACC00004290,Debit,1367.15,-678224.26,USD,Grocery
TXN0000024251,2024-10-28T07:43:32,ACC00005014,Payment,927.94,-679152.2,JPY,Starbucks
TXN0000024252,2024-07-30T05:54:07,ACC00000069,Payment,1017.45,-680169.65,JPY,Starbucks
TXN0000024253,2024-02-20T03:14:40,ACC00008413,Debit,247.04,-680416.69,EUR,Grocery
TXN0000024254,2024-11-08T03:21:04,ACC00008982,Transfer,1310.69,-679106.0,USD,Shell
TXN0000024255,2024-06-08T13:53:09,ACC00006269,Debit,970.72,-680076.72,JPY,Shell
TXN0000024256,2024-05-02T08:23:28,ACC00009349,Debit,646.94,-680723.66,JPY,Online Store
TXN0000024257,2024-05-31T02:02:13,ACC00002425,ATM,702.69,-681426.35,USD,Grocery
TXN0000024258,2024-11-28T22:21:44,ACC00002520,Payment,275.19,-681701.54,GBP,Walmart
TXN0000024259,2024-09-21T02:17:18,ACC00009477,Transfer,785.59,-680915.95,GBP,Target
TXN0000024260,2024-06-01T01:23:29,ACC00009509,Transfer,1120.02,-679795.93,JPY,Amazon
TXN0000024261,2024-06-28T21:05:14,ACC00000205,Payment,910.81,-680706.74,EUR,Shell
TXN0000024262,2024-09-01T13:19:42,ACC00009990,Transfer,850.2,-679856.54,USD,Amazon
TXN0000024263,2024-04-20T22:20:48,ACC00007864,Transfer,1942.69,-677913.85,JPY,Starbucks
TXN0000024264,2024-06-11T23:05:53,ACC00000072,Transfer,1111.59,-676802.26,JPY,Starbucks
TXN0000024265,2024-11-24T16:18:11,ACC00000206,Payment,1472.03,-678274.29,JPY,Shell
TXN0000024266,2024-04-26T15:53:17,ACC00003497,Credit,445.72,-677828.57,GBP,Online Store
TXN0000024267,2024-12-19T17:57:42,ACC00001367,Debit,931.97,-678760.54,GBP,Starbucks
TXN0000024268,2024-03-05T10:34:45,ACC00009129,Credit,1635.99,-677124.55,USD,Shell
TXN0000024269,2024-08-28T05:29:08,ACC00008764,Debit,292.25,-677416.8,EUR,Starbucks
TXN0000024270,2024-08-22T12:26:22,ACC00000271,Debit,647.45,-678064.25,GBP,Amazon
TXN0000024271,2024-04-15T22:31:04,ACC00003490,Payment,1886.66,-679950.91,USD,Restaurant
TXN0000024272,2024-06-04T06:56:45,ACC00000716,Transfer,158.31,-679792.6,GBP,Grocery
TXN0000024273,2024-10-18T17:35:52,ACC00009650,Debit,1262.3,-681054.9,GBP,Walmart
TXN0000024274,2024-07-29T23:54:41,ACC00003846,Credit,506.5,-680548.4,USD,Restaurant
TXN0000024275,2024-06-17T03:26:59,ACC00006217,Credit,1226.1,-679322.3,GBP,Shell
TXN0000024276,2024-08-13T12:33:23,ACC00005757,Debit,47.85,-679370.15,GBP,Grocery
TXN0000024277,2024-12-05T22:13:40,ACC00006838,ATM,371.17,-679741.32,JPY,Shell
TXN0000024278,2024-04-16T03:21:24,ACC00004079,Transfer,675.17,-679066.15,EUR,Shell
TXN0000024279,2024-07-06T13:11:30,ACC00009511,Payment,455.89,-679522.04,JPY,Target
TXN0000024280,2024-06-28T18:30:45,ACC00008721,Credit,256.91,-679265.13,GBP,Starbucks
TXN0000024281,2024-06-24T02:57:48,ACC00003731,Transfer,982.45,-678282.68,GBP,Amazon
TXN0000024282,2024-12-08T15:01:39,ACC00009995,ATM,14.38,-678297.06,USD,Amazon
TXN0000024283,2024-01-10T10:51:54,ACC00004422,Payment,1027.94,-679325.0,JPY,Target
TXN0000024284,2024-11-23T03:24:45,ACC00001978,Credit,1578.57,-677746.43,EUR,Restaurant
TXN0000024285,2024-05-06T13:07:26,ACC00005874,ATM,1949.8,-679696.23,JPY,Grocery
TXN0000024286,2024-11-26T18:41:33,ACC00002771,Credit,43.14,-679653.09,USD,Shell
TXN0000024287,2024-04-24T10:33:16,ACC00002384,Credit,101.99,-679551.1,JPY,Amazon
TXN0000024288,2024-09-01T03:44:16,ACC00006850,Payment,371.93,-679923.03,EUR,Online Store
TXN0000024289,2024-12-30T05:18:07,ACC00001500,ATM,1523.16,-681446.19,USD,Target
TXN0000024290,2024-08-29T16:07:44,ACC00002289,Payment,1556.19,-683002.38,USD,Online Store
TXN0000024291,2024-12-26T11:50:57,ACC00004220,Debit,1992.81,-684995.19,JPY,Grocery
TXN0000024292,2024-11-18T01:46:14,ACC00004434,Debit,721.85,-685717.04,JPY,Shell
TXN0000024293,2024-05-31T10:24:27,ACC00007321,Debit,360.6,-686077.64,GBP,Online Store
TXN0000024294,2024-03-20T03:34:52,ACC00009638,Transfer,237.93,-685839.71,EUR,Shell
TXN0000024295,2024-04-18T21:12:50,ACC00002172,ATM,87.17,-685926.88,GBP,Shell
TXN0000024296,2024-01-18T18:31:23,ACC00004427,Debit,1526.25,-687453.13,USD,Target
TXN0000024297,2024-01-29T07:36:51,ACC00009439,ATM,1622.0,-689075.13,GBP,Target
TXN0000024298,2024-07-30T10:01:37,ACC00009416,Credit,1126.89,-687948.24,JPY,Grocery
TXN0000024299,2024-07-19T09:37:01,ACC00006661,Payment,118.94,-688067.18,GBP,Amazon
TXN0000024300,2024-04-26T21:59:46,ACC00005229,Debit,1870.06,-689937.24,USD,Starbucks
TXN0000024301,2024-09-21T00:51:43,ACC00000291,ATM,64.77,-690002.01,GBP,Shell
TXN0000024302,2024-04-04T05:58:27,ACC00001734,Payment,1421.71,-691423.72,USD,Shell
TXN0000024303,2024-02-19T00:05:36,ACC00007233,Credit,963.77,-690459.95,GBP,Amazon
TXN0000024304,2024-11-15T20:19:55,ACC00001334,Transfer,143.23,-690316.72,GBP,Target
TXN0000024305,2024-12-13T18:57:38,ACC00002823,Payment,807.92,-691124.64,USD,Starbucks
TXN0000024306,2024-08-16T10:34:47,ACC00001563,Payment,1411.99,-692536.63,EUR,Restaurant
TXN0000024307,2024-01-22T16:19:35,ACC00002707,Transfer,1261.73,-691274.9,GBP,Grocery
TXN0000024308,2024-07-13T05:06:19,ACC00003808,ATM,1526.25,-692801.15,EUR,Walmart
TXN0000024309,2024-11-18T07:26:46,ACC00008893,Transfer,1610.58,-691190.57,JPY,Amazon
TXN0000024310,2024-12-18T22:18:37,ACC00003560,ATM,822.87,-692013.44,GBP,Shell
TXN0000024311,2024-04-11T14:55:02,ACC00003224,ATM,1450.46,-693463.9,JPY,Walmart
TXN0000024312,2024-02-04T21:59:52,ACC00000389,Transfer,874.94,-692588.96,JPY,Restaurant
TXN0000024313,2024-08-07T04:20:25,ACC00001365,Credit,1246.36,-691342.6,JPY,Restaurant
TXN0000024314,2024-01-16T17:09:13,ACC00005635,Credit,1273.61,-690068.99,EUR,Starbucks
TXN0000024315,2024-01-23T23:41:48,ACC00005661,Payment,1159.22,-691228.21,USD,Target
TXN0000024316,2024-03-27T08:27:07,ACC00003558,Debit,327.9,-691556.11,USD,Grocery
TXN0000024317,2024-04-02T18:50:39,ACC00008488,ATM,352.42,-691908.53,JPY,Restaurant
TXN0000024318,2024-01-20T09:27:41,ACC00000723,ATM,552.08,-692460.61,EUR,Shell
TXN0000024319,2024-08-25T09:13:30,ACC00001834,Payment,139.85,-692600.46,JPY,Grocery
TXN0000024320,2024-10-30T03:43:44,ACC00003623,Payment,725.37,-693325.83,JPY,Grocery
TXN0000024321,2024-10-23T17:18:07,ACC00004628,Transfer,1349.61,-691976.22,GBP,Walmart
TXN0000024322,2024-11-01T03:29:37,ACC00004268,Transfer,603.31,-691372.91,EUR,Starbucks
TXN0000024323,2024-05-04T09:32:13,ACC00009259,ATM,1491.12,-692864.03,JPY,Grocery
TXN0000024324,2024-08-14T03:05:33,ACC00000501,Credit,910.99,-691953.04,JPY,Amazon
TXN0000024325,2024-12-03T09:51:01,ACC00003430,Debit,332.73,-692285.77,EUR,Online Store
TXN0000024326,2024-11-12T22:29:43,ACC00006503,Debit,783.01,-693068.78,EUR,Shell
TXN0000024327,2024-10-20T07:17:24,ACC00009539,ATM,202.88,-693271.66,GBP,Online Store
TXN0000024328,2024-08-29T23:16:32,ACC00002414,Transfer,552.0,-692719.66,JPY,Starbucks
TXN0000024329,2024-01-22T01:37:06,ACC00005049,ATM,886.24,-693605.9,GBP,Grocery
TXN0000024330,2024-12-11T21:47:48,ACC00005832,Transfer,18.51,-693587.39,EUR,Target
TXN0000024331,2024-12-26T15:32:18,ACC00006231,Payment,1875.04,-695462.43,JPY,Shell
TXN0000024332,2024-10-30T04:50:34,ACC00007636,Debit,1076.52,-696538.95,JPY,Walmart
TXN0000024333,2024-03-07T06:06:44,ACC00007387,Credit,1693.04,-694845.91,GBP,Target
TXN0000024334,2024-02-19T12:37:44,ACC00000977,Credit,560.4,-694285.51,USD,Shell
TXN0000024335,2024-02-10T23:55:08,ACC00004524,Payment,1347.5,-695633.01,GBP,Starbucks
TXN0000024336,2024-08-16T17:35:26,ACC00002575,Credit,119.29,-695513.72,EUR,Online Store
TXN0000024337,2024-12-07T00:11:48,ACC00005129,Transfer,911.34,-694602.38,EUR,Grocery
TXN0000024338,2024-09-01T08:51:20,ACC00009734,ATM,1734.31,-696336.69,GBP,Grocery
TXN0000024339,2024-12-15T04:55:45,ACC00009114,Payment,1985.97,-698322.66,GBP,Restaurant
TXN0000024340,2024-08-27T07:03:56,ACC00001579,ATM,1196.85,-699519.51,USD,Target
TXN0000024341,2024-03-24T22:23:53,ACC00009547,Credit,1696.04,-697823.47,EUR,Target
TXN0000024342,2024-10-21T08:24:39,ACC00006482,ATM,1198.52,-699021.99,GBP,Online Store
TXN0000024343,2024-03-21T02:06:51,ACC00002882,Credit,920.31,-698101.68,JPY,Shell
TXN0000024344,2024-03-12T02:04:59,ACC00006437,Payment,400.62,-698502.3,USD,Online Store
TXN0000024345,2024-03-06T11:12:39,ACC00007481,Transfer,1445.73,-697056.57,JPY,Starbucks
TXN0000024346,2024-10-05T12:56:40,ACC00003222,ATM,518.53,-697575.1,EUR,Restaurant
TXN0000024347,2024-05-13T04:19:54,ACC00006293,ATM,246.51,-697821.61,USD,Walmart
TXN0000024348,2024-04-26T05:18:44,ACC00006797,Debit,1715.15,-699536.76,JPY,Shell
TXN0000024349,2024-11-14T02:55:43,ACC00008943,ATM,12.24,-699549.0,USD,Target
TXN0000024350,2024-07-03T19:37:58,ACC00004375,Transfer,335.28,-699213.72,GBP,Grocery
TXN0000024351,2024-04-26T03:02:39,ACC00002497,Payment,1077.95,-700291.67,GBP,Target
TXN0000024352,2024-04-25T10:25:35,ACC00009551,Credit,1812.4,-698479.27,USD,Shell
TXN0000024353,2024-05-09T02:34:18,ACC00006740,Transfer,101.76,-698377.51,JPY,Walmart
TXN0000024354,2024-04-19T17:37:37,ACC00002598,ATM,1689.22,-700066.73,USD,Restaurant
TXN0000024355,2024-07-09T23:56:49,ACC00006791,Transfer,1371.5,-698695.23,JPY,Grocery
TXN0000024356,2024-01-03T04:57:42,ACC00007395,Transfer,1817.96,-696877.27,EUR,Grocery
TXN0000024357,2024-11-19T12:21:54,ACC00000478,Debit,974.22,-697851.49,USD,Starbucks
TXN0000024358,2024-07-07T23:24:15,ACC00006476,Debit,1466.22,-699317.71,EUR,Amazon
TXN0000024359,2024-03-24T23:04:35,ACC00000388,ATM,16.52,-699334.23,JPY,Shell
TXN0000024360,2024-01-13T23:52:52,ACC00006585,Transfer,1139.34,-698194.89,USD,Target
TXN0000024361,2024-07-23T20:08:06,ACC00009416,Transfer,1224.51,-696970.38,GBP,Amazon
TXN0000024362,2024-07-04T12:04:38,ACC00006958,Debit,692.58,-697662.96,USD,Restaurant
TXN0000024363,2024-03-30T00:38:59,ACC00004048,Transfer,1527.26,-696135.7,USD,Shell
TXN0000024364,2024-02-02T22:06:06,ACC00003792,Debit,695.24,-696830.94,EUR,Restaurant
TXN0000024365,2024-07-21T03:08:02,ACC00007558,Payment,624.88,-697455.82,GBP,Starbucks
TXN0000024366,2024-01-29T12:16:34,ACC00003418,Credit,34.61,-697421.21,GBP,Grocery
TXN0000024367,2024-08-19T13:08:18,ACC00002969,Credit,1476.3,-695944.91,GBP,Grocery
TXN0000024368,2024-07-13T12:55:43,ACC00007320,Debit,159.8,-696104.71,EUR,Amazon
TXN0000024369,2024-07-27T01:42:50,ACC00002177,ATM,1954.0,-698058.71,JPY,Online Store
TXN0000024370,2024-03-10T15:06:51,ACC00006105,Credit,799.5,-697259.21,JPY,Amazon
TXN0000024371,2024-07-01T18:24:57,ACC00002023,Transfer,1607.1,-695652.11,JPY,Starbucks
TXN0000024372,2024-04-11T11:08:36,ACC00001479,Debit,1850.66,-697502.77,USD,Online Store
TXN0000024373,2024-05-10T23:21:03,ACC00002215,Credit,1128.01,-696374.76,EUR,Restaurant
TXN0000024374,2024-02-10T11:20:14,ACC00001372,Credit,1630.06,-694744.7,USD,Starbucks
TXN0000024375,2024-10-01T00:09:16,ACC00001352,ATM,511.68,-695256.38,GBP,Target
TXN0000024376,2024-10-06T01:38:41,ACC00005160,Credit,1917.8,-693338.58,USD,Walmart
TXN0000024377,2024-08-14T23:42:41,ACC00008928,Credit,778.84,-692559.74,GBP,Restaurant
TXN0000024378,2024-04-28T22:43:18,ACC00006379,Credit,995.9,-691563.84,JPY,Shell
TXN0000024379,2024-11-01T21:05:05,ACC00008181,Payment,1112.16,-692676.0,EUR,Walmart
TXN0000024380,2024-11-05T04:49:15,ACC00009428,Debit,390.36,-693066.36,EUR,Amazon
TXN0000024381,2024-06-11T11:04:39,ACC00008461,Debit,873.86,-693940.22,USD,Amazon
TXN0000024382,2024-12-12T02:21:51,ACC00001735,Transfer,780.12,-693160.1,JPY,Shell
TXN0000024383,2024-11-09T13:50:52,ACC00003525,Debit,1675.44,-694835.54,USD,Shell
TXN0000024384,2024-12-18T20:00:31,ACC00007130,Debit,281.31,-695116.85,JPY,Target
TXN0000024385,2024-01-30T12:30:39,ACC00007496,ATM,295.35,-695412.2,USD,Starbucks
TXN0000024386,2024-07-15T03:46:04,ACC00002775,ATM,933.32,-696345.52,EUR,Online Store
TXN0000024387,2024-07-28T15:25:25,ACC00004117,Payment,1790.11,-698135.63,USD,Restaurant
TXN0000024388,2024-11-06T08:02:38,ACC00006204,Payment,746.52,-698882.15,JPY,Online Store
TXN0000024389,2024-04-15T06:29:20,ACC00009906,Credit,797.21,-698084.94,USD,Walmart
TXN0000024390,2024-04-06T16:50:38,ACC00007327,Transfer,701.71,-697383.23,USD,Starbucks
TXN0000024391,2024-08-23T14:44:30,ACC00001034,ATM,966.55,-698349.78,EUR,Starbucks
TXN0000024392,2024-01-01T00:44:06,ACC00008598,Debit,1560.58,-699910.36,GBP,Online Store
TXN0000024393,2024-08-27T15:28:22,ACC00004765,Payment,1690.52,-701600.88,USD,Restaurant
TXN0000024394,2024-07-06T23:45:29,ACC00005400,Payment,977.25,-702578.13,USD,Walmart
TXN0000024395,2024-05-15T09:02:30,ACC00008093,Transfer,1748.82,-700829.31,GBP,Restaurant
TXN0000024396,2024-05-03T19:11:15,ACC00008083,Credit,1827.47,-699001.84,USD,Shell
TXN0000024397,2024-10-10T03:32:19,ACC00004489,Payment,849.78,-699851.62,USD,Walmart
TXN0000024398,2024-04-24T16:19:22,ACC00006718,Debit,809.42,-700661.04,GBP,Online Store
TXN0000024399,2024-04-07T08:14:28,ACC00007656,ATM,584.69,-701245.73,GBP,Online Store
TXN0000024400,2024-10-05T15:59:24,ACC00006991,ATM,1798.62,-703044.35,JPY,Walmart
TXN0000024401,2024-03-12T08:07:17,ACC00007559,Transfer,1459.36,-701584.99,USD,Amazon
TXN0000024402,2024-12-10T06:00:32,ACC00005658,Transfer,1020.6,-700564.39,USD,Target
TXN0000024403,2024-09-20T00:58:16,ACC00003983,ATM,1163.57,-701727.96,EUR,Online Store
TXN0000024404,2024-12-23T02:19:24,ACC00000506,Debit,1437.86,-703165.82,GBP,Online Store
TXN0000024405,2024-06-16T00:08:29,ACC00001529,Debit,473.59,-703639.41,EUR,Restaurant
TXN0000024406,2024-03-06T04:43:28,ACC00006990,Debit,1512.48,-705151.89,EUR,Online Store
TXN0000024407,2024-06-29T17:48:27,ACC00009188,Credit,103.53,-705048.36,GBP,Restaurant
TXN0000024408,2024-01-06T02:09:06,ACC00004835,Credit,571.38,-704476.98,EUR,Starbucks
TXN0000024409,2024-02-20T20:09:48,ACC00005268,Transfer,753.0,-703723.98,JPY,Starbucks
TXN0000024410,2024-02-11T21:59:34,ACC00001164,Credit,396.49,-703327.49,GBP,Starbucks
TXN0000024411,2024-08-12T04:06:33,ACC00003181,Debit,1141.79,-704469.28,JPY,Restaurant
TXN0000024412,2024-02-23T18:49:11,ACC00008217,Payment,1324.07,-705793.35,USD,Amazon
TXN0000024413,2024-06-12T01:28:40,ACC00004212,Credit,1891.2,-703902.15,USD,Shell
TXN0000024414,2024-05-27T05:44:26,ACC00004990,Payment,90.9,-703993.05,JPY,Amazon
TXN0000024415,2024-01-20T20:08:39,ACC00008714,Payment,1958.47,-705951.52,EUR,Amazon
TXN0000024416,2024-09-04T01:01:06,ACC00008119,ATM,831.85,-706783.37,GBP,Target
TXN0000024417,2024-12-03T05:04:21,ACC00006787,Payment,1411.79,-708195.16,USD,Shell
TXN0000024418,2024-06-17T00:47:40,ACC00007454,ATM,1101.62,-709296.78,GBP,Shell
TXN0000024419,2024-02-03T16:16:47,ACC00003879,Payment,482.09,-709778.87,USD,Grocery
TXN0000024420,2024-06-20T07:34:07,ACC00008229,Transfer,1241.18,-708537.69,GBP,Restaurant
TXN0000024421,2024-06-07T14:27:09,ACC00005477,Transfer,1072.89,-707464.8,EUR,Target
TXN0000024422,2024-02-14T16:09:03,ACC00005953,Debit,1640.56,-709105.36,USD,Online Store
TXN0000024423,2024-11-02T18:17:51,ACC00000344,Payment,480.89,-709586.25,GBP,Shell
TXN0000024424,2024-07-08T15:13:14,ACC00009874,ATM,149.42,-709735.67,GBP,Shell
TXN0000024425,2024-02-24T00:35:25,ACC00007451,Credit,521.46,-709214.21,EUR,Starbucks
TXN0000024426,2024-08-26T08:40:36,ACC00009517,Transfer,1321.15,-707893.06,USD,Online Store
TXN0000024427,2024-12-17T08:40:25,ACC00005638,Payment,1592.03,-709485.09,JPY,Target
TXN0000024428,2024-07-07T07:41:03,ACC00001246,Debit,709.82,-710194.91,EUR,Online Store
TXN0000024429,2024-04-17T04:07:50,ACC00006734,ATM,897.86,-711092.77,EUR,Walmart
TXN0000024430,2024-11-14T18:26:22,ACC00006947,Debit,158.63,-711251.4,USD,Online Store
TXN0000024431,2024-06-16T02:25:27,ACC00004143,ATM,1098.33,-712349.73,JPY,Target
TXN0000024432,2024-01-30T01:06:01,ACC00008151,Debit,948.5,-713298.23,USD,Amazon
TXN0000024433,2024-01-20T22:31:16,ACC00008104,Debit,1249.98,-714548.21,JPY,Shell
TXN0000024434,2024-11-18T20:43:09,ACC00005357,Credit,1916.42,-712631.79,USD,Walmart
TXN0000024435,2024-03-19T00:42:29,ACC00001448,Debit,1066.05,-713697.84,EUR,Starbucks
TXN0000024436,2024-02-12T13:35:46,ACC00002595,ATM,1211.29,-714909.13,EUR,Walmart
TXN0000024437,2024-10-16T16:07:05,ACC00008449,Credit,1256.58,-713652.55,EUR,Grocery
TXN0000024438,2024-08-30T21:02:53,ACC00006071,Payment,265.52,-713918.07,GBP,Grocery
TXN0000024439,2024-04-20T13:04:31,ACC00008089,Debit,596.47,-714514.54,EUR,Starbucks
TXN0000024440,2024-02-14T18:42:43,ACC00007133,Payment,894.15,-715408.69,GBP,Shell
TXN0000024441,2024-06-18T13:41:03,ACC00006459,Transfer,146.25,-715262.44,JPY,Grocery
TXN0000024442,2024-03-19T19:20:59,ACC00007261,ATM,774.44,-716036.88,USD,Restaurant
TXN0000024443,2024-02-23T06:10:35,ACC00006409,ATM,789.9,-716826.78,JPY,Restaurant
TXN0000024444,2024-05-04T22:55:11,ACC00002817,Payment,19.67,-716846.45,USD,Starbucks
TXN0000024445,2024-02-10T10:37:07,ACC00006428,Payment,1877.91,-718724.36,USD,Amazon
TXN0000024446,2024-07-24T18:39:36,ACC00004647,Credit,1887.36,-716837.0,EUR,Amazon
TXN0000024447,2024-01-13T01:05:06,ACC00003753,Transfer,600.64,-716236.36,JPY,Target
TXN0000024448,2024-04-27T15:05:20,ACC00002782,Credit,1847.43,-714388.93,GBP,Target
TXN0000024449,2024-04-21T02:20:54,ACC00005087,Debit,797.92,-715186.85,EUR,Walmart
TXN0000024450,2024-06-05T20:51:21,ACC00005685,Payment,464.85,-715651.7,GBP,Restaurant
TXN0000024451,2024-03-22T11:11:14,ACC00000891,Debit,808.45,-716460.15,EUR,Shell
TXN0000024452,2024-12-18T17:37:40,ACC00009741,Debit,923.65,-717383.8,USD,Restaurant
TXN0000024453,2024-05-20T11:14:13,ACC00002027,Debit,1112.84,-718496.64,GBP,Walmart
TXN0000024454,2024-05-25T15:01:21,ACC00009958,Credit,603.85,-717892.79,EUR,Target
TXN0000024455,2024-06-14T05:55:19,ACC00004721,Transfer,43.28,-717849.51,JPY,Grocery
TXN0000024456,2024-05-04T07:04:47,ACC00003910,Credit,1390.86,-716458.65,USD,Target
TXN0000024457,2024-04-20T22:14:32,ACC00001788,ATM,1538.23,-717996.88,GBP,Target
TXN0000024458,2024-12-01T19:49:19,ACC00005232,Credit,1050.63,-716946.25,GBP,Walmart
TXN0000024459,2024-08-17T11:33:03,ACC00004679,Payment,1075.39,-718021.64,EUR,Amazon
TXN0000024460,2024-09-22T07:24:51,ACC00009982,Payment,1463.92,-719485.56,EUR,Starbucks
TXN0000024461,2024-03-09T11:52:38,ACC00009265,ATM,1529.22,-721014.78,JPY,Grocery
TXN0000024462,2024-09-05T11:23:48,ACC00003263,Debit,1963.11,-722977.89,JPY,Restaurant
TXN0000024463,2024-11-21T03:40:05,ACC00002351,Credit,687.1,-722290.79,USD,Grocery
TXN0000024464,2024-08-14T17:39:17,ACC00001286,ATM,1355.46,-723646.25,EUR,Amazon
TXN0000024465,2024-10-18T02:15:10,ACC00007212,Debit,1209.83,-724856.08,USD,Target
TXN0000024466,2024-01-09T22:48:04,ACC00009386,Transfer,1517.82,-723338.26,JPY,Online Store
TXN0000024467,2024-01-20T18:43:22,ACC00003439,Payment,1536.04,-724874.3,GBP,Online Store
TXN0000024468,2024-08-17T16:04:17,ACC00008871,Credit,687.09,-724187.21,USD,Restaurant
TXN0000024469,2024-09-30T01:09:24,ACC00003161,Debit,905.69,-725092.9,JPY,Walmart
TXN0000024470,2024-11-02T18:54:23,ACC00004161,Payment,1872.87,-726965.77,USD,Starbucks
TXN0000024471,2024-01-03T02:59:21,ACC00005986,ATM,1338.11,-728303.88,USD,Restaurant
TXN0000024472,2024-04-24T20:13:50,ACC00001002,Credit,502.54,-727801.34,EUR,Restaurant
TXN0000024473,2024-07-07T14:20:24,ACC00004981,ATM,964.25,-728765.59,JPY,Walmart
TXN0000024474,2024-10-30T09:29:44,ACC00009390,Payment,253.64,-729019.23,USD,Amazon
TXN0000024475,2024-02-20T04:32:21,ACC00006157,Payment,1965.95,-730985.18,USD,Target
TXN0000024476,2024-11-09T06:18:04,ACC00009007,ATM,349.44,-731334.62,GBP,Online Store
TXN0000024477,2024-08-02T20:20:42,ACC00000657,ATM,14.08,-731348.7,EUR,Amazon
TXN0000024478,2024-05-26T16:29:30,ACC00008953,Debit,210.81,-731559.51,GBP,Shell
TXN0000024479,2024-05-02T05:07:47,ACC00003994,Payment,1155.13,-732714.64,EUR,Restaurant
TXN0000024480,2024-02-27T00:29:03,ACC00002886,Payment,528.63,-733243.27,GBP,Grocery
TXN0000024481,2024-01-13T04:25:48,ACC00009321,Payment,1607.54,-734850.81,EUR,Target
TXN0000024482,2024-01-14T20:42:55,ACC00003805,Credit,1604.17,-733246.64,EUR,Online Store
TXN0000024483,2024-12-25T16:56:59,ACC00002981,Credit,411.08,-732835.56,GBP,Target
TXN0000024484,2024-03-05T07:46:53,ACC00002471,Payment,984.8,-733820.36,EUR,Shell
TXN0000024485,2024-02-19T16:44:00,ACC00005154,Payment,1230.53,-735050.89,JPY,Online Store
TXN0000024486,2024-06-21T16:51:56,ACC00003762,ATM,1234.49,-736285.38,USD,Online Store
TXN0000024487,2024-07-14T22:15:55,ACC00003840,Payment,1892.49,-738177.87,EUR,Shell
TXN0000024488,2024-07-05T04:42:07,ACC00001566,ATM,1937.33,-740115.2,JPY,Shell
TXN0000024489,2024-05-14T13:29:10,ACC00009948,Credit,491.9,-739623.3,GBP,Walmart
TXN0000024490,2024-03-14T21:46:38,ACC00004289,ATM,1969.43,-741592.73,USD,Restaurant
TXN0000024491,2024-03-21T12:15:16,ACC00005567,Payment,199.39,-741792.12,USD,Target
TXN0000024492,2024-04-23T08:25:39,ACC00004877,Debit,22.63,-741814.75,GBP,Walmart
TXN0000024493,2024-12-28T07:20:38,ACC00000932,Credit,280.12,-741534.63,USD,Grocery
TXN0000024494,2024-06-25T18:03:10,ACC00000512,Payment,449.82,-741984.45,USD,Target
TXN0000024495,2024-01-21T12:40:03,ACC00000369,Payment,1756.31,-743740.76,JPY,Shell
TXN0000024496,2024-02-19T20:05:19,ACC00004628,ATM,828.63,-744569.39,JPY,Starbucks
TXN0000024497,2024-06-28T07:26:07,ACC00007465,Transfer,643.63,-743925.76,EUR,Amazon
TXN0000024498,2024-10-17T14:42:43,ACC00003013,ATM,1911.83,-745837.59,JPY,Shell
TXN0000024499,2024-05-04T21:41:27,ACC00000959,ATM,839.29,-746676.88,GBP,Shell
TXN0000024500,2024-10-13T20:02:30,ACC00009989,Transfer,1033.64,-745643.24,EUR,Grocery
TXN0000024501,2024-12-30T10:56:09,ACC00008827,Credit,834.1,-744809.14,EUR,Shell
TXN0000024502,2024-09-18T21:50:41,ACC00008532,Transfer,65.13,-744744.01,EUR,Shell
TXN0000024503,2024-03-31T05:18:17,ACC00004354,ATM,1195.6,-745939.61,EUR,Starbucks
TXN0000024504,2024-01-02T20:32:24,ACC00005076,ATM,1171.29,-747110.9,USD,Walmart
TXN0000024505,2024-11-30T10:19:45,ACC00008775,Payment,1268.13,-748379.03,GBP,Restaurant
TXN0000024506,2024-03-23T08:57:59,ACC00009265,ATM,1480.28,-749859.31,USD,Online Store
TXN0000024507,2024-01-28T17:15:21,ACC00000410,ATM,1185.09,-751044.4,GBP,Grocery
TXN0000024508,2024-01-12T11:10:27,ACC00009926,ATM,179.34,-751223.74,JPY,Walmart
TXN0000024509,2024-05-22T03:37:17,ACC00002547,Payment,248.05,-751471.79,JPY,Restaurant
TXN0000024510,2024-02-27T15:01:12,ACC00004540,Payment,203.29,-751675.08,JPY,Grocery
TXN0000024511,2024-10-11T17:06:22,ACC00008008,ATM,177.25,-751852.33,JPY,Starbucks
TXN0000024512,2024-09-03T00:30:22,ACC00009001,Debit,547.68,-752400.01,GBP,Walmart
TXN0000024513,2024-05-12T15:31:11,ACC00000667,Transfer,105.47,-752294.54,GBP,Walmart
TXN0000024514,2024-06-24T03:51:52,ACC00001286,ATM,293.2,-752587.74,JPY,Amazon
TXN0000024515,2024-11-05T06:34:45,ACC00000626,Credit,1107.11,-751480.63,JPY,Shell
TXN0000024516,2024-12-14T11:31:51,ACC00005265,ATM,1689.55,-753170.18,EUR,Walmart
TXN0000024517,2024-10-06T19:20:20,ACC00008821,Credit,1632.78,-751537.4,GBP,Restaurant
TXN0000024518,2024-02-04T06:45:10,ACC00001503,Payment,1759.51,-753296.91,JPY,Grocery
TXN0000024519,2024-11-02T03:39:54,ACC00000750,Transfer,1190.0,-752106.91,JPY,Grocery
TXN0000024520,2024-06-28T08:47:57,ACC00004889,Credit,1943.71,-750163.2,GBP,Restaurant
TXN0000024521,2024-10-29T02:49:39,ACC00003007,ATM,1823.76,-751986.96,EUR,Restaurant
TXN0000024522,2024-10-20T21:40:14,ACC00004154,Payment,1765.46,-753752.42,EUR,Shell
TXN0000024523,2024-07-02T20:25:58,ACC00000957,ATM,577.64,-754330.06,JPY,Starbucks
TXN0000024524,2024-06-25T06:30:09,ACC00006707,Debit,913.36,-755243.42,USD,Target
TXN0000024525,2024-10-12T07:59:15,ACC00009013,Debit,1619.02,-756862.44,JPY,Walmart
TXN0000024526,2024-08-31T09:51:12,ACC00009916,Transfer,145.14,-756717.3,JPY,Restaurant
TXN0000024527,2024-10-11T02:39:50,ACC00002076,ATM,970.52,-757687.82,USD,Target
TXN0000024528,2024-04-03T22:31:48,ACC00008754,Debit,328.65,-758016.47,EUR,Shell
TXN0000024529,2024-11-06T09:19:25,ACC00007364,Debit,1916.26,-759932.73,USD,Target
TXN0000024530,2024-05-03T09:31:13,ACC00004084,Transfer,1424.52,-758508.21,USD,Amazon
TXN0000024531,2024-05-07T01:39:45,ACC00006129,ATM,878.95,-759387.16,USD,Restaurant
TXN0000024532,2024-08-17T19:06:22,ACC00005919,Payment,1608.15,-760995.31,JPY,Online Store
TXN0000024533,2024-11-24T18:34:02,ACC00009276,Debit,1120.02,-762115.33,USD,Walmart
TXN0000024534,2024-12-04T07:45:51,ACC00007960,Credit,1238.21,-760877.12,USD,Online Store
TXN0000024535,2024-06-25T18:17:16,ACC00004598,Transfer,1057.21,-759819.91,EUR,Amazon
TXN0000024536,2024-12-01T20:52:29,ACC00005385,Payment,778.1,-760598.01,JPY,Restaurant
TXN0000024537,2024-06-07T13:04:08,ACC00000697,Transfer,218.24,-760379.77,GBP,Restaurant
TXN0000024538,2024-01-06T12:34:35,ACC00000307,Debit,1375.78,-761755.55,GBP,Starbucks
TXN0000024539,2024-03-13T15:49:28,ACC00004046,Credit,1860.12,-759895.43,EUR,Target
TXN0000024540,2024-09-27T12:18:25,ACC00005789,Debit,822.68,-760718.11,GBP,Online Store
TXN0000024541,2024-06-17T04:04:48,ACC00004595,Transfer,476.27,-760241.84,JPY,Online Store
TXN0000024542,2024-09-09T10:50:43,ACC00004308,Debit,153.82,-760395.66,EUR,Target
TXN0000024543,2024-06-04T11:34:11,ACC00002403,Payment,495.77,-760891.43,USD,Grocery
TXN0000024544,2024-03-29T05:54:14,ACC00002748,Debit,1023.31,-761914.74,USD,Grocery
TXN0000024545,2024-05-07T16:50:42,ACC00002173,Debit,453.48,-762368.22,GBP,Amazon
TXN0000024546,2024-03-13T14:52:51,ACC00000939,Payment,818.88,-763187.1,EUR,Amazon
TXN0000024547,2024-01-05T05:36:00,ACC00007305,ATM,1995.07,-765182.17,JPY,Starbucks
TXN0000024548,2024-08-31T09:24:43,ACC00002592,Debit,1989.63,-767171.8,USD,Online Store
TXN0000024549,2024-11-15T13:49:53,ACC00001441,Transfer,439.24,-766732.56,JPY,Starbucks
TXN0000024550,2024-10-18T11:57:06,ACC00009201,Transfer,153.05,-766579.51,USD,Target
TXN0000024551,2024-10-06T18:03:06,ACC00004989,Credit,1045.01,-765534.5,JPY,Grocery
TXN0000024552,2024-06-24T18:39:17,ACC00008245,Payment,1083.42,-766617.92,USD,Walmart
TXN0000024553,2024-11-25T14:40:39,ACC00000207,Debit,563.86,-767181.78,GBP,Online Store
TXN0000024554,2024-07-13T05:02:49,ACC00004185,Payment,1916.63,-769098.41,GBP,Shell
TXN0000024555,2024-03-14T01:47:36,ACC00006643,Debit,133.7,-769232.11,GBP,Amazon
TXN0000024556,2024-07-10T09:41:22,ACC00004276,Transfer,1178.28,-768053.83,USD,Grocery
TXN0000024557,2024-04-11T17:19:18,ACC00002592,Payment,243.6,-768297.43,USD,Walmart
TXN0000024558,2024-04-30T05:24:29,ACC00006997,ATM,1864.6,-770162.03,JPY,Online Store
TXN0000024559,2024-06-28T10:48:26,ACC00004137,Credit,707.59,-769454.44,EUR,Grocery
TXN0000024560,2024-03-12T16:20:18,ACC00005610,Credit,799.99,-768654.45,EUR,Starbucks
TXN0000024561,2024-06-25T02:46:30,ACC00004266,Debit,422.32,-769076.77,GBP,Shell
TXN0000024562,2024-05-29T17:47:14,ACC00002283,Debit,616.14,-769692.91,GBP,Grocery
TXN0000024563,2024-02-09T20:17:46,ACC00002033,Debit,1445.4,-771138.31,EUR,Grocery
TXN0000024564,2024-03-01T00:49:54,ACC00008387,ATM,117.05,-771255.36,USD,Shell
TXN0000024565,2024-04-03T04:56:16,ACC00004616,Debit,1160.7,-772416.06,GBP,Amazon
TXN0000024566,2024-08-20T01:48:13,ACC00000682,Payment,783.7,-773199.76,JPY,Amazon
TXN0000024567,2024-08-07T10:38:43,ACC00004042,Debit,801.1,-774000.86,GBP,Restaurant
TXN0000024568,2024-01-14T21:58:47,ACC00009032,Credit,1371.01,-772629.85,USD,Walmart
TXN0000024569,2024-03-30T18:31:03,ACC00007551,Transfer,1561.95,-771067.9,USD,Grocery
TXN0000024570,2024-10-23T17:25:24,ACC00009374,Payment,1326.5,-772394.4,EUR,Restaurant
TXN0000024571,2024-09-12T07:12:37,ACC00005138,Debit,1328.63,-773723.03,USD,Online Store
TXN0000024572,2024-07-02T14:34:57,ACC00005575,Payment,391.83,-774114.86,JPY,Starbucks
TXN0000024573,2024-06-13T06:50:10,ACC00005722,Credit,1446.92,-772667.94,GBP,Amazon
TXN0000024574,2024-05-08T00:34:27,ACC00002835,ATM,133.64,-772801.58,GBP,Grocery
TXN0000024575,2024-01-04T23:07:19,ACC00003640,Credit,515.27,-772286.31,USD,Grocery
TXN0000024576,2024-06-19T15:43:11,ACC00007921,Credit,585.23,-771701.08,USD,Grocery
TXN0000024577,2024-08-23T15:17:54,ACC00007187,ATM,1210.32,-772911.4,GBP,Restaurant
TXN0000024578,2024-05-21T15:04:59,ACC00000427,ATM,1799.17,-774710.57,GBP,Amazon
TXN0000024579,2024-08-02T07:29:06,ACC00006548,Payment,83.93,-774794.5,EUR,Walmart
TXN0000024580,2024-12-21T20:44:59,ACC00006111,Payment,1250.32,-776044.82,EUR,Target
TXN0000024581,2024-01-05T15:10:37,ACC00006784,Transfer,286.66,-775758.16,USD,Amazon
TXN0000024582,2024-03-23T05:24:56,ACC00005018,Transfer,696.49,-775061.67,EUR,Walmart
TXN0000024583,2024-01-17T00:40:48,ACC00007249,Credit,1777.36,-773284.31,EUR,Amazon
TXN0000024584,2024-09-19T09:33:20,ACC00007223,Payment,1953.5,-775237.81,USD,Shell
TXN0000024585,2024-03-24T20:38:27,ACC00000944,Debit,271.59,-775509.4,JPY,Online Store
TXN0000024586,2024-06-29T01:12:44,ACC00004184,Payment,1086.7,-776596.1,EUR,Starbucks
TXN0000024587,2024-12-03T22:29:19,ACC00008207,ATM,501.17,-777097.27,JPY,Grocery
TXN0000024588,2024-08-03T01:54:32,ACC00005536,Credit,1776.59,-775320.68,USD,Walmart
TXN0000024589,2024-12-24T15:38:37,ACC00009776,Credit,1726.46,-773594.22,USD,Restaurant
TXN0000024590,2024-01-22T15:35:47,ACC00005582,Transfer,1163.89,-772430.33,USD,Grocery
TXN0000024591,2024-12-01T11:56:12,ACC00005191,Credit,575.9,-771854.43,USD,Grocery
TXN0000024592,2024-02-23T22:18:37,ACC00001485,Payment,1600.09,-773454.52,USD,Amazon
TXN0000024593,2024-07-02T07:24:22,ACC00007744,ATM,1287.79,-774742.31,USD,Walmart
TXN0000024594,2024-09-02T17:08:33,ACC00003770,Credit,1478.43,-773263.88,EUR,Grocery
TXN0000024595,2024-09-27T02:43:03,ACC00004680,Payment,1441.84,-774705.72,JPY,Shell
TXN0000024596,2024-04-24T10:30:12,ACC00006860,Credit,643.82,-774061.9,EUR,Online Store
TXN0000024597,2024-04-11T16:25:22,ACC00005546,Transfer,1773.98,-772287.92,JPY,Amazon
TXN0000024598,2024-12-01T12:26:24,ACC00008187,Credit,1399.98,-770887.94,GBP,Grocery
TXN0000024599,2024-08-29T16:19:09,ACC00007693,Payment,759.52,-771647.46,JPY,Starbucks
TXN0000024600,2024-05-29T12:12:03,ACC00004956,Credit,1901.72,-769745.74,USD,Amazon
TXN0000024601,2024-12-19T17:20:20,ACC00007775,Credit,1640.05,-768105.69,EUR,Online Store
TXN0000024602,2024-03-16T19:35:04,ACC00006612,Debit,734.63,-768840.32,USD,Shell
TXN0000024603,2024-04-13T21:55:48,ACC00008281,Transfer,1543.76,-767296.56,EUR,Restaurant
TXN0000024604,2024-12-29T01:28:22,ACC00001256,Payment,857.57,-768154.13,USD,Online Store
TXN0000024605,2024-07-17T02:07:17,ACC00000555,Debit,345.74,-768499.87,GBP,Amazon
TXN0000024606,2024-07-23T04:56:05,ACC00000993,Debit,1319.75,-769819.62,USD,Restaurant
TXN0000024607,2024-01-23T19:54:32,ACC00000099,Credit,133.94,-769685.68,USD,Walmart
TXN0000024608,2024-03-23T16:37:29,ACC00008440,Transfer,1744.65,-767941.03,USD,Shell
TXN0000024609,2024-09-29T00:04:18,ACC00008305,Credit,892.18,-767048.85,EUR,Grocery
TXN0000024610,2024-05-24T10:24:49,ACC00000878,Credit,195.32,-766853.53,GBP,Starbucks
TXN0000024611,2024-01-07T14:57:43,ACC00003035,ATM,716.26,-767569.79,EUR,Walmart
TXN0000024612,2024-08-18T01:53:57,ACC00003219,Payment,1513.35,-769083.14,EUR,Grocery
TXN0000024613,2024-05-22T01:10:24,ACC00008878,ATM,1522.9,-770606.04,GBP,Grocery
TXN0000024614,2024-09-25T04:32:12,ACC00000855,Credit,857.62,-769748.42,JPY,Shell
TXN0000024615,2024-07-16T15:34:23,ACC00005426,Payment,468.47,-770216.89,EUR,Target
TXN0000024616,2024-09-17T11:01:33,ACC00007270,Transfer,764.14,-769452.75,EUR,Target
TXN0000024617,2024-10-29T16:39:23,ACC00005058,Debit,1281.96,-770734.71,JPY,Amazon
TXN0000024618,2024-04-01T07:02:25,ACC00005387,Debit,1840.93,-772575.64,EUR,Online Store
TXN0000024619,2024-02-26T16:18:28,ACC00009943,Debit,1513.75,-774089.39,EUR,Target
TXN0000024620,2024-02-20T06:14:37,ACC00001562,Credit,614.31,-773475.08,EUR,Target
TXN0000024621,2024-02-25T09:22:29,ACC00008978,Transfer,93.41,-773381.67,GBP,Shell
TXN0000024622,2024-03-19T17:49:36,ACC00002328,Debit,233.77,-773615.44,JPY,Shell
TXN0000024623,2024-09-05T20:15:24,ACC00006176,ATM,590.53,-774205.97,JPY,Grocery
TXN0000024624,2024-08-04T16:02:36,ACC00006403,Credit,1931.05,-772274.92,JPY,Restaurant
TXN0000024625,2024-06-18T10:23:22,ACC00000636,Credit,379.6,-771895.32,GBP,Restaurant
TXN0000024626,2024-04-13T14:57:48,ACC00003466,Transfer,413.57,-771481.75,EUR,Amazon
TXN0000024627,2024-05-11T04:27:46,ACC00009523,Credit,471.78,-771009.97,JPY,Online Store
TXN0000024628,2024-10-09T22:49:43,ACC00003982,Payment,495.99,-771505.96,GBP,Amazon
TXN0000024629,2024-09-30T08:01:52,ACC00006981,Credit,348.2,-771157.76,EUR,Walmart
TXN0000024630,2024-01-29T01:20:36,ACC00009558,Transfer,1560.39,-769597.37,JPY,Target
TXN0000024631,2024-04-14T23:46:10,ACC00009313,ATM,1168.08,-770765.45,JPY,Shell
TXN0000024632,2024-05-14T05:21:29,ACC00007839,Transfer,226.49,-770538.96,EUR,Grocery
TXN0000024633,2024-04-03T01:00:29,ACC00009004,ATM,1771.53,-772310.49,EUR,Grocery
TXN0000024634,2024-07-24T15:48:36,ACC00009981,Debit,223.69,-772534.18,GBP,Online Store
TXN0000024635,2024-07-23T06:48:47,ACC00003305,Payment,1256.48,-773790.66,EUR,Amazon
TXN0000024636,2024-07-04T16:11:49,ACC00000684,ATM,1095.66,-774886.32,JPY,Walmart
TXN0000024637,2024-11-23T05:35:09,ACC00007784,Credit,708.07,-774178.25,EUR,Shell
TXN0000024638,2024-11-17T21:41:46,ACC00009743,Debit,1820.73,-775998.98,USD,Grocery
TXN0000024639,2024-04-06T10:25:50,ACC00006347,ATM,1130.48,-777129.46,USD,Restaurant
TXN0000024640,2024-11-25T17:09:37,ACC00008087,Credit,212.66,-776916.8,USD,Starbucks
TXN0000024641,2024-10-08T03:22:57,ACC00002387,Transfer,32.85,-776883.95,JPY,Restaurant
TXN0000024642,2024-10-04T09:36:05,ACC00005829,Payment,829.72,-777713.67,GBP,Shell
TXN0000024643,2024-02-03T04:24:38,ACC00002802,Credit,1318.44,-776395.23,GBP,Shell
TXN0000024644,2024-02-11T19:39:32,ACC00002630,ATM,1988.69,-778383.92,GBP,Walmart
TXN0000024645,2024-06-05T15:33:49,ACC00005554,Debit,1090.99,-779474.91,EUR,Amazon
TXN0000024646,2024-10-04T01:19:15,ACC00003230,Payment,423.81,-779898.72,EUR,Amazon
TXN0000024647,2024-07-30T22:49:53,ACC00008187,ATM,806.83,-780705.55,EUR,Online Store
TXN0000024648,2024-10-22T03:13:22,ACC00006614,ATM,1469.0,-782174.55,USD,Shell
TXN0000024649,2024-09-14T00:01:09,ACC00002065,ATM,1027.17,-783201.72,USD,Starbucks
TXN0000024650,2024-02-23T21:01:54,ACC00002938,ATM,1062.89,-784264.61,USD,Walmart
TXN0000024651,2024-05-05T13:42:26,ACC00003336,Credit,822.96,-783441.65,EUR,Grocery
TXN0000024652,2024-09-18T06:26:08,ACC00007875,ATM,1999.37,-785441.02,JPY,Online Store
TXN0000024653,2024-10-11T01:22:55,ACC00004594,Payment,137.11,-785578.13,USD,Amazon
TXN0000024654,2024-04-28T02:52:23,ACC00001343,Payment,1841.24,-787419.37,JPY,Target
TXN0000024655,2024-08-02T18:46:12,ACC00005390,Credit,1109.45,-786309.92,GBP,Shell
TXN0000024656,2024-09-06T09:02:49,ACC00005242,Payment,885.72,-787195.64,GBP,Target
TXN0000024657,2024-10-07T13:10:19,ACC00009436,Credit,1320.5,-785875.14,JPY,Restaurant
TXN0000024658,2024-12-03T06:13:58,ACC00000682,Credit,1978.62,-783896.52,GBP,Amazon
TXN0000024659,2024-11-01T08:27:58,ACC00000012,ATM,19.59,-783916.11,JPY,Online Store
TXN0000024660,2024-11-15T20:44:39,ACC00006088,ATM,1626.94,-785543.05,EUR,Walmart
TXN0000024661,2024-04-08T16:05:57,ACC00001956,Transfer,839.6,-784703.45,JPY,Walmart
TXN0000024662,2024-10-29T03:10:07,ACC00005439,Debit,308.0,-785011.45,GBP,Walmart
TXN0000024663,2024-04-30T20:49:14,ACC00008967,Transfer,801.89,-784209.56,EUR,Shell
TXN0000024664,2024-04-08T11:13:06,ACC00004552,ATM,488.91,-784698.47,USD,Starbucks
TXN0000024665,2024-09-08T09:58:13,ACC00001145,Credit,1286.69,-783411.78,USD,Target
TXN0000024666,2024-02-16T16:53:35,ACC00005890,ATM,1311.97,-784723.75,USD,Target
TXN0000024667,2024-05-17T15:23:09,ACC00007459,Payment,1393.73,-786117.48,USD,Starbucks
TXN0000024668,2024-05-19T13:34:16,ACC00007732,Credit,1834.07,-784283.41,JPY,Restaurant
TXN0000024669,2024-05-10T15:05:56,ACC00003197,ATM,1060.04,-785343.45,JPY,Amazon
TXN0000024670,2024-03-19T05:46:03,ACC00007283,Transfer,1181.46,-784161.99,JPY,Online Store
TXN0000024671,2024-03-03T19:43:21,ACC00003065,Transfer,743.13,-783418.86,EUR,Restaurant
TXN0000024672,2024-07-13T22:50:00,ACC00004284,Credit,327.86,-783091.0,EUR,Walmart
TXN0000024673,2024-02-09T19:13:07,ACC00002192,Payment,262.35,-783353.35,USD,Target
TXN0000024674,2024-03-30T00:04:06,ACC00009388,Transfer,95.67,-783257.68,EUR,Restaurant
TXN0000024675,2024-12-09T12:26:33,ACC00004354,Payment,514.8,-783772.48,USD,Restaurant
TXN0000024676,2024-09-03T07:33:46,ACC00001418,Payment,1467.18,-785239.66,USD,Target
TXN0000024677,2024-04-08T06:47:05,ACC00000501,Debit,267.3,-785506.96,EUR,Restaurant
TXN0000024678,2024-04-21T06:08:11,ACC00002851,Transfer,676.7,-784830.26,GBP,Shell
TXN0000024679,2024-04-18T01:47:28,ACC00006768,Debit,1708.39,-786538.65,USD,Starbucks
TXN0000024680,2024-05-10T13:39:12,ACC00008228,ATM,808.77,-787347.42,GBP,Restaurant
TXN0000024681,2024-09-15T12:24:59,ACC00000350,ATM,790.49,-788137.91,USD,Online Store
TXN0000024682,2024-12-14T00:50:12,ACC00000144,Debit,1325.12,-789463.03,EUR,Shell
TXN0000024683,2024-11-09T06:43:09,ACC00009566,Debit,1019.33,-790482.36,USD,Restaurant
TXN0000024684,2024-06-10T07:02:26,ACC00009005,Transfer,1187.24,-789295.12,GBP,Online Store
TXN0000024685,2024-02-17T14:08:37,ACC00003303,Payment,671.05,-789966.17,JPY,Walmart
TXN0000024686,2024-04-28T06:49:28,ACC00000229,Debit,602.07,-790568.24,EUR,Walmart
TXN0000024687,2024-09-10T18:46:01,ACC00003127,Payment,1149.44,-791717.68,JPY,Grocery
TXN0000024688,2024-02-05T23:17:17,ACC00004272,Debit,702.41,-792420.09,GBP,Online Store
TXN0000024689,2024-07-28T18:49:39,ACC00004232,Credit,766.56,-791653.53,USD,Online Store
TXN0000024690,2024-05-15T17:42:09,ACC00009307,Transfer,912.5,-790741.03,GBP,Starbucks
TXN0000024691,2024-09-05T17:54:06,ACC00000309,ATM,1476.05,-792217.08,USD,Online Store
TXN0000024692,2024-03-02T19:48:36,ACC00004655,Credit,1923.91,-790293.17,USD,Target
TXN0000024693,2024-02-06T17:28:48,ACC00008229,Payment,793.02,-791086.19,USD,Starbucks
TXN0000024694,2024-05-07T16:37:19,ACC00007238,Credit,991.27,-790094.92,EUR,Amazon
TXN0000024695,2024-06-05T02:17:54,ACC00005139,Credit,1154.86,-788940.06,GBP,Starbucks
TXN0000024696,2024-03-17T09:03:03,ACC00002164,Payment,317.1,-789257.16,GBP,Restaurant
TXN0000024697,2024-08-24T15:19:22,ACC00000394,Debit,1332.55,-790589.71,EUR,Target
TXN0000024698,2024-10-05T08:46:03,ACC00007377,Credit,1195.96,-789393.75,GBP,Amazon
TXN0000024699,2024-01-29T20:02:58,ACC00008780,Transfer,1286.75,-788107.0,USD,Shell
TXN0000024700,2024-12-06T08:38:11,ACC00000395,Credit,845.39,-787261.61,EUR,Walmart
TXN0000024701,2024-07-25T00:11:47,ACC00005328,ATM,1603.39,-788865.0,EUR,Grocery
TXN0000024702,2024-10-02T20:59:45,ACC00008605,Payment,811.59,-789676.59,GBP,Shell
TXN0000024703,2024-07-10T22:48:52,ACC00003892,Credit,1977.75,-787698.84,JPY,Walmart
TXN0000024704,2024-05-24T07:27:13,ACC00006479,ATM,473.36,-788172.2,USD,Walmart
TXN0000024705,2024-11-30T18:23:52,ACC00005844,Debit,322.14,-788494.34,GBP,Starbucks
TXN0000024706,2024-09-01T23:39:47,ACC00006202,ATM,383.96,-788878.3,EUR,Shell
TXN0000024707,2024-05-08T18:28:19,ACC00002778,Credit,1093.84,-787784.46,USD,Walmart
TXN0000024708,2024-02-26T02:34:39,ACC00006329,Debit,904.74,-788689.2,EUR,Grocery
TXN0000024709,2024-12-11T03:51:26,ACC00008194,Credit,899.36,-787789.84,USD,Restaurant
TXN0000024710,2024-02-04T05:02:25,ACC00005313,Credit,1085.0,-786704.84,EUR,Grocery
TXN0000024711,2024-03-27T19:44:27,ACC00005026,Transfer,1748.79,-784956.05,EUR,Amazon
TXN0000024712,2024-01-18T18:04:57,ACC00001715,ATM,1218.59,-786174.64,JPY,Grocery
TXN0000024713,2024-01-29T12:36:19,ACC00007828,ATM,636.22,-786810.86,EUR,Amazon
TXN0000024714,2024-08-04T02:18:07,ACC00009361,Payment,43.55,-786854.41,JPY,Target
TXN0000024715,2024-09-21T17:29:17,ACC00000095,Transfer,384.2,-786470.21,GBP,Restaurant
TXN0000024716,2024-10-01T23:43:53,ACC00003442,ATM,796.66,-787266.87,EUR,Shell
TXN0000024717,2024-09-22T19:11:37,ACC00004588,Debit,1828.03,-789094.9,EUR,Grocery
TXN0000024718,2024-09-15T03:59:02,ACC00007910,Transfer,1460.45,-787634.45,EUR,Online Store
TXN0000024719,2024-04-10T21:04:56,ACC00000769,Credit,1650.88,-785983.57,USD,Restaurant
TXN0000024720,2024-12-19T05:50:42,ACC00008777,Transfer,1482.26,-784501.31,EUR,Online Store
TXN0000024721,2024-07-21T18:47:33,ACC00006055,Debit,1307.13,-785808.44,GBP,Starbucks
TXN0000024722,2024-07-27T15:26:23,ACC00007533,ATM,628.95,-786437.39,GBP,Target
TXN0000024723,2024-01-05T20:44:40,ACC00010000,Debit,1444.13,-787881.52,EUR,Grocery
TXN0000024724,2024-09-24T23:51:24,ACC00001141,Debit,1701.04,-789582.56,GBP,Shell
TXN0000024725,2024-01-08T05:33:37,ACC00008025,Debit,592.49,-790175.05,EUR,Amazon
TXN0000024726,2024-10-28T14:52:36,ACC00006828,Transfer,1282.59,-788892.46,USD,Target
TXN0000024727,2024-04-13T08:08:20,ACC00007401,ATM,1860.34,-790752.8,EUR,Online Store
TXN0000024728,2024-09-13T21:34:24,ACC00005162,Debit,248.71,-791001.51,JPY,Target
TXN0000024729,2024-01-01T22:42:23,ACC00008841,Debit,996.46,-791997.97,GBP,Walmart
TXN0000024730,2024-01-30T15:02:23,ACC00008526,Credit,1980.04,-790017.93,JPY,Walmart
TXN0000024731,2024-12-01T03:54:54,ACC00005113,Transfer,1603.45,-788414.48,GBP,Online Store
TXN0000024732,2024-08-20T11:54:50,ACC00001279,Payment,1991.54,-790406.02,JPY,Restaurant
TXN0000024733,2024-12-05T05:07:40,ACC00007299,Transfer,65.92,-790340.1,EUR,Walmart
TXN0000024734,2024-07-31T17:51:30,ACC00001583,Credit,1290.04,-789050.06,EUR,Walmart
TXN0000024735,2024-02-29T23:46:43,ACC00007245,Payment,1027.24,-790077.3,JPY,Walmart
TXN0000024736,2024-08-16T18:07:04,ACC00006753,Payment,1875.35,-791952.65,JPY,Walmart
TXN0000024737,2024-09-22T21:45:36,ACC00007687,ATM,445.59,-792398.24,USD,Shell
TXN0000024738,2024-10-16T21:02:20,ACC00004409,ATM,52.83,-792451.07,JPY,Shell
TXN0000024739,2024-08-17T09:22:22,ACC00008164,ATM,368.04,-792819.11,EUR,Target
TXN0000024740,2024-12-17T04:28:06,ACC00009794,Debit,876.22,-793695.33,GBP,Grocery
TXN0000024741,2024-06-19T13:12:11,ACC00004957,ATM,408.07,-794103.4,EUR,Restaurant
TXN0000024742,2024-07-19T14:48:08,ACC00009275,ATM,1834.76,-795938.16,JPY,Walmart
TXN0000024743,2024-01-15T13:22:39,ACC00000344,Transfer,127.79,-795810.37,JPY,Amazon
TXN0000024744,2024-08-28T09:34:27,ACC00007515,ATM,476.44,-796286.81,GBP,Restaurant
TXN0000024745,2024-06-13T14:00:09,ACC00006895,Debit,1967.43,-798254.24,JPY,Grocery
TXN0000024746,2024-04-19T12:24:11,ACC00003446,Payment,92.64,-798346.88,JPY,Online Store
TXN0000024747,2024-09-06T00:32:13,ACC00005177,Credit,1846.94,-796499.94,EUR,Walmart
TXN0000024748,2024-10-23T11:18:45,ACC00001036,Payment,1989.92,-798489.86,EUR,Shell
TXN0000024749,2024-11-07T21:25:42,ACC00006265,Debit,208.85,-798698.71,USD,Grocery
TXN0000024750,2024-02-01T18:12:20,ACC00005918,Transfer,1666.18,-797032.53,JPY,Starbucks
TXN0000024751,2024-05-23T16:13:40,ACC00001611,Payment,897.98,-797930.51,EUR,Grocery
TXN0000024752,2024-08-09T19:37:21,ACC00003253,ATM,1828.79,-799759.3,JPY,Target
TXN0000024753,2024-04-10T06:52:11,ACC00004894,Debit,735.8,-800495.1,USD,Amazon
TXN0000024754,2024-07-23T21:31:58,ACC00008981,ATM,1499.81,-801994.91,EUR,Shell
TXN0000024755,2024-08-04T22:08:26,ACC00000014,Debit,1592.05,-803586.96,GBP,Restaurant
TXN0000024756,2024-06-18T04:26:09,ACC00002938,ATM,1562.08,-805149.04,EUR,Restaurant
TXN0000024757,2024-05-28T02:47:46,ACC00002524,Credit,1267.81,-803881.23,USD,Starbucks
TXN0000024758,2024-11-17T10:33:11,ACC00009172,Payment,832.57,-804713.8,GBP,Starbucks
TXN0000024759,2024-07-16T14:05:01,ACC00002150,Credit,752.86,-803960.94,USD,Amazon
TXN0000024760,2024-07-06T21:33:23,ACC00005288,Debit,24.9,-803985.84,EUR,Restaurant
TXN0000024761,2024-11-28T04:38:05,ACC00001009,Debit,1846.06,-805831.9,EUR,Grocery
TXN0000024762,2024-03-27T04:39:51,ACC00006274,ATM,1272.72,-807104.62,USD,Shell
TXN0000024763,2024-03-11T22:48:31,ACC00007049,ATM,1854.91,-808959.53,JPY,Restaurant
TXN0000024764,2024-05-20T12:55:04,ACC00003907,Credit,1644.36,-807315.17,EUR,Shell
TXN0000024765,2024-08-13T09:27:03,ACC00005104,Payment,813.31,-808128.48,EUR,Walmart
TXN0000024766,2024-04-03T04:40:36,ACC00008147,Debit,59.15,-808187.63,USD,Starbucks
TXN0000024767,2024-09-18T14:46:05,ACC00008444,ATM,1033.08,-809220.71,EUR,Grocery
TXN0000024768,2024-10-21T23:26:05,ACC00007818,ATM,1673.0,-810893.71,EUR,Restaurant
TXN0000024769,2024-08-10T16:52:22,ACC00009367,Payment,1167.26,-812060.97,USD,Online Store
TXN0000024770,2024-08-29T19:26:21,ACC00004280,ATM,710.31,-812771.28,GBP,Amazon
TXN0000024771,2024-01-04T23:15:08,ACC00001732,Credit,241.51,-812529.77,EUR,Online Store
TXN0000024772,2024-01-27T00:41:14,ACC00002945,Debit,914.53,-813444.3,USD,Target
TXN0000024773,2024-04-01T13:01:57,ACC00001306,Payment,672.86,-814117.16,GBP,Grocery
TXN0000024774,2024-01-31T01:43:52,ACC00007309,Debit,756.46,-814873.62,EUR,Amazon
TXN0000024775,2024-06-26T05:05:05,ACC00009163,Debit,1671.93,-816545.55,USD,Online Store
TXN0000024776,2024-06-09T19:26:43,ACC00005143,Credit,1740.57,-814804.98,GBP,Target
TXN0000024777,2024-04-17T23:23:41,ACC00008599,Debit,961.64,-815766.62,GBP,Shell
TXN0000024778,2024-10-07T15:11:48,ACC00002770,ATM,429.16,-816195.78,EUR,Starbucks
TXN0000024779,2024-08-22T21:12:04,ACC00008030,ATM,1251.18,-817446.96,USD,Online Store
TXN0000024780,2024-05-27T00:12:42,ACC00002000,Transfer,567.15,-816879.81,EUR,Online Store
TXN0000024781,2024-07-09T03:05:57,ACC00005169,Transfer,1394.63,-815485.18,EUR,Walmart
TXN0000024782,2024-06-03T20:48:43,ACC00002648,Payment,926.92,-816412.1,USD,Amazon
TXN0000024783,2024-03-12T17:05:20,ACC00004389,Payment,882.12,-817294.22,EUR,Online Store
TXN0000024784,2024-03-22T20:31:41,ACC00000401,Credit,372.93,-816921.29,JPY,Target
TXN0000024785,2024-04-22T04:54:12,ACC00000222,ATM,681.91,-817603.2,JPY,Starbucks
TXN0000024786,2024-12-09T23:55:03,ACC00003462,ATM,1851.08,-819454.28,JPY,Walmart
TXN0000024787,2024-01-08T07:17:03,ACC00004279,ATM,1978.83,-821433.11,USD,Amazon
TXN0000024788,2024-07-12T14:58:48,ACC00004949,Payment,288.87,-821721.98,JPY,Shell
TXN0000024789,2024-02-11T07:51:21,ACC00000631,Credit,599.46,-821122.52,GBP,Walmart
TXN0000024790,2024-11-26T15:33:47,ACC00004018,Debit,427.12,-821549.64,USD,Target
TXN0000024791,2024-01-25T08:18:15,ACC00003859,Transfer,612.17,-820937.47,JPY,Amazon
TXN0000024792,2024-09-17T06:45:33,ACC00002551,ATM,154.64,-821092.11,USD,Grocery
TXN0000024793,2024-03-08T23:00:58,ACC00005880,ATM,1650.86,-822742.97,GBP,Grocery
TXN0000024794,2024-03-10T00:17:06,ACC00008043,Payment,185.31,-822928.28,USD,Walmart
TXN0000024795,2024-03-16T03:32:56,ACC00005056,Credit,1184.42,-821743.86,EUR,Amazon
TXN0000024796,2024-07-07T13:05:55,ACC00009590,ATM,798.15,-822542.01,USD,Target
TXN0000024797,2024-01-05T11:13:31,ACC00000383,Debit,1059.96,-823601.97,EUR,Walmart
TXN0000024798,2024-09-06T08:31:21,ACC00000225,Payment,496.15,-824098.12,GBP,Restaurant
TXN0000024799,2024-11-17T23:14:00,ACC00004157,ATM,780.91,-824879.03,GBP,Amazon
TXN0000024800,2024-06-15T01:31:34,ACC00008885,ATM,1898.57,-826777.6,GBP,Restaurant
TXN0000024801,2024-10-05T16:50:22,ACC00003560,Credit,1658.1,-825119.5,JPY,Starbucks
TXN0000024802,2024-04-28T01:56:39,ACC00004501,Credit,545.36,-824574.14,GBP,Shell
TXN0000024803,2024-02-25T13:42:19,ACC00003405,ATM,1710.03,-826284.17,GBP,Walmart
TXN0000024804,2024-09-20T04:34:14,ACC00009465,Payment,239.08,-826523.25,USD,Starbucks
TXN0000024805,2024-06-24T13:29:15,ACC00006465,Payment,1903.01,-828426.26,GBP,Grocery
TXN0000024806,2024-02-25T16:39:57,ACC00004464,Debit,1785.59,-830211.85,JPY,Grocery
TXN0000024807,2024-12-19T15:17:45,ACC00000171,Debit,694.08,-830905.93,JPY,Shell
TXN0000024808,2024-11-25T14:07:55,ACC00001436,Credit,1274.51,-829631.42,USD,Shell
TXN0000024809,2024-11-28T17:42:57,ACC00009405,Debit,1412.85,-831044.27,GBP,Target
TXN0000024810,2024-12-24T11:07:08,ACC00003447,Credit,972.81,-830071.46,GBP,Starbucks
TXN0000024811,2024-03-19T18:06:12,ACC00000565,Credit,781.73,-829289.73,EUR,Grocery
TXN0000024812,2024-09-01T09:25:19,ACC00005848,ATM,1413.22,-830702.95,GBP,Amazon
TXN0000024813,2024-07-23T04:35:12,ACC00004093,Payment,953.76,-831656.71,GBP,Online Store
TXN0000024814,2024-01-06T00:36:08,ACC00001258,ATM,395.3,-832052.01,EUR,Amazon
TXN0000024815,2024-03-27T09:56:12,ACC00005574,Payment,586.71,-832638.72,GBP,Starbucks
TXN0000024816,2024-08-15T21:25:13,ACC00007670,ATM,645.73,-833284.45,GBP,Restaurant
TXN0000024817,2024-03-13T10:44:50,ACC00006720,Transfer,412.78,-832871.67,EUR,Grocery
TXN0000024818,2024-10-22T10:54:11,ACC00009771,Credit,1768.32,-831103.35,USD,Shell
TXN0000024819,2024-06-16T20:02:30,ACC00002625,Payment,883.23,-831986.58,EUR,Shell
TXN0000024820,2024-03-24T11:12:57,ACC00006500,Transfer,31.95,-831954.63,USD,Shell
TXN0000024821,2024-11-01T22:56:20,ACC00009139,ATM,897.84,-832852.47,USD,Grocery
TXN0000024822,2024-01-30T17:44:55,ACC00006027,Payment,1847.79,-834700.26,JPY,Grocery
TXN0000024823,2024-10-29T02:00:50,ACC00009918,Payment,189.37,-834889.63,USD,Shell
TXN0000024824,2024-10-13T13:00:03,ACC00005045,ATM,1652.06,-836541.69,JPY,Target
TXN0000024825,2024-09-04T08:45:25,ACC00000272,Credit,555.66,-835986.03,GBP,Amazon
TXN0000024826,2024-12-10T22:16:26,ACC00002887,Credit,719.66,-835266.37,USD,Walmart
TXN0000024827,2024-01-20T06:12:11,ACC00007141,Credit,282.26,-834984.11,EUR,Starbucks
TXN0000024828,2024-12-22T00:34:48,ACC00009244,Payment,1755.6,-836739.71,GBP,Grocery
TXN0000024829,2024-12-13T05:10:16,ACC00001521,Payment,1134.19,-837873.9,JPY,Grocery
TXN0000024830,2024-09-28T15:19:41,ACC00002282,Debit,952.67,-838826.57,JPY,Target
TXN0000024831,2024-10-10T02:53:04,ACC00002449,Credit,867.25,-837959.32,EUR,Restaurant
TXN0000024832,2024-10-27T02:49:29,ACC00002211,Credit,175.68,-837783.64,EUR,Amazon
TXN0000024833,2024-04-03T13:00:32,ACC00002283,Debit,1946.01,-839729.65,EUR,Starbucks
TXN0000024834,2024-07-29T15:55:43,ACC00009464,Transfer,819.51,-838910.14,EUR,Amazon
TXN0000024835,2024-06-07T09:32:09,ACC00002337,Debit,525.63,-839435.77,USD,Target
TXN0000024836,2024-07-01T23:09:45,ACC00006879,Payment,1686.51,-841122.28,EUR,Target
TXN0000024837,2024-02-27T08:36:08,ACC00000727,Debit,398.66,-841520.94,JPY,Target
TXN0000024838,2024-08-23T23:09:46,ACC00008114,Credit,1419.19,-840101.75,GBP,Grocery
TXN0000024839,2024-07-03T21:09:15,ACC00008413,Debit,1624.18,-841725.93,GBP,Amazon
TXN0000024840,2024-06-16T08:20:42,ACC00003538,ATM,1057.31,-842783.24,JPY,Walmart
TXN0000024841,2024-03-16T10:50:39,ACC00003783,Payment,315.96,-843099.2,JPY,Starbucks
TXN0000024842,2024-03-08T11:00:21,ACC00008516,Payment,464.84,-843564.04,GBP,Starbucks
TXN0000024843,2024-04-26T12:18:25,ACC00005182,ATM,1859.61,-845423.65,USD,Grocery
TXN0000024844,2024-03-19T14:18:56,ACC00001828,Transfer,1888.19,-843535.46,EUR,Restaurant
TXN0000024845,2024-08-06T16:53:58,ACC00001380,Payment,765.12,-844300.58,GBP,Grocery
TXN0000024846,2024-05-18T11:53:02,ACC00005593,ATM,555.24,-844855.82,EUR,Online Store
TXN0000024847,2024-09-26T14:01:08,ACC00001200,Debit,627.97,-845483.79,GBP,Amazon
TXN0000024848,2024-03-09T00:05:09,ACC00006058,Debit,1450.08,-846933.87,GBP,Grocery
TXN0000024849,2024-02-10T02:52:20,ACC00000967,Credit,745.96,-846187.91,USD,Shell
TXN0000024850,2024-06-22T14:45:39,ACC00009427,Credit,1671.98,-844515.93,EUR,Shell
TXN0000024851,2024-08-03T16:19:33,ACC00007535,Transfer,292.38,-844223.55,USD,Shell
TXN0000024852,2024-10-05T11:50:43,ACC00008241,Credit,792.34,-843431.21,JPY,Walmart
TXN0000024853,2024-02-08T21:31:15,ACC00008898,ATM,637.88,-844069.09,EUR,Walmart
TXN0000024854,2024-08-18T01:19:58,ACC00000168,ATM,739.46,-844808.55,USD,Target
TXN0000024855,2024-04-15T17:09:38,ACC00008364,Debit,1394.74,-846203.29,JPY,Online Store
TXN0000024856,2024-10-26T03:36:20,ACC00005703,ATM,518.34,-846721.63,EUR,Shell
TXN0000024857,2024-01-17T22:37:00,ACC00003248,Transfer,327.43,-846394.2,EUR,Walmart
TXN0000024858,2024-07-31T18:32:48,ACC00005577,Debit,757.37,-847151.57,JPY,Restaurant
TXN0000024859,2024-08-31T04:48:26,ACC00008263,Payment,460.14,-847611.71,GBP,Shell
TXN0000024860,2024-03-29T09:03:23,ACC00000177,Debit,614.62,-848226.33,USD,Restaurant
TXN0000024861,2024-08-15T09:00:11,ACC00003432,Credit,1762.5,-846463.83,GBP,Grocery
TXN0000024862,2024-12-19T00:51:19,ACC00001389,Payment,152.71,-846616.54,EUR,Grocery
TXN0000024863,2024-02-07T06:16:29,ACC00000523,Debit,1378.57,-847995.11,JPY,Amazon
TXN0000024864,2024-04-27T01:04:35,ACC00005430,Debit,239.25,-848234.36,USD,Starbucks
TXN0000024865,2024-09-20T22:56:32,ACC00006840,Payment,552.84,-848787.2,USD,Starbucks
TXN0000024866,2024-02-19T16:43:05,ACC00008152,Credit,868.55,-847918.65,GBP,Restaurant
TXN0000024867,2024-04-29T07:21:45,ACC00003479,Credit,776.91,-847141.74,USD,Restaurant
TXN0000024868,2024-09-21T12:33:54,ACC00006029,Credit,1523.86,-845617.88,GBP,Restaurant
TXN0000024869,2024-07-21T14:38:57,ACC00008127,Transfer,514.81,-845103.07,JPY,Shell
TXN0000024870,2024-09-14T02:38:32,ACC00005424,Transfer,1757.62,-843345.45,JPY,Walmart
TXN0000024871,2024-04-09T23:54:36,ACC00003104,ATM,427.89,-843773.34,JPY,Restaurant
TXN0000024872,2024-08-03T18:48:23,ACC00006289,Credit,1748.33,-842025.01,USD,Restaurant
TXN0000024873,2024-05-03T01:24:45,ACC00004077,Payment,1302.96,-843327.97,EUR,Walmart
TXN0000024874,2024-05-25T23:22:56,ACC00001301,Credit,1122.29,-842205.68,JPY,Starbucks
TXN0000024875,2024-05-13T17:15:09,ACC00003796,ATM,1943.81,-844149.49,EUR,Shell
TXN0000024876,2024-07-10T04:07:20,ACC00001492,Credit,1239.83,-842909.66,JPY,Online Store
TXN0000024877,2024-04-30T03:07:05,ACC00005075,Payment,1031.75,-843941.41,USD,Grocery
TXN0000024878,2024-11-19T03:48:59,ACC00003135,Credit,471.92,-843469.49,JPY,Grocery
TXN0000024879,2024-10-25T20:14:05,ACC00006360,Transfer,981.87,-842487.62,GBP,Grocery
TXN0000024880,2024-07-28T17:12:10,ACC00008513,Credit,801.02,-841686.6,JPY,Walmart
TXN0000024881,2024-04-16T04:11:42,ACC00005268,Debit,309.68,-841996.28,GBP,Shell
TXN0000024882,2024-05-18T15:28:01,ACC00003510,Payment,1078.14,-843074.42,JPY,Restaurant
TXN0000024883,2024-12-13T06:52:27,ACC00003710,Payment,1425.96,-844500.38,USD,Walmart
TXN0000024884,2024-05-13T05:21:11,ACC00004926,Debit,374.53,-844874.91,GBP,Amazon
TXN0000024885,2024-05-30T20:57:35,ACC00003111,Payment,146.57,-845021.48,EUR,Grocery
TXN0000024886,2024-05-17T23:04:11,ACC00002989,Transfer,1134.14,-843887.34,USD,Shell
TXN0000024887,2024-07-11T09:26:07,ACC00007589,ATM,1914.1,-845801.44,USD,Starbucks
TXN0000024888,2024-10-30T04:08:05,ACC00008429,ATM,500.93,-846302.37,EUR,Grocery
TXN0000024889,2024-02-07T12:05:25,ACC00003264,Transfer,1707.8,-844594.57,GBP,Online Store
TXN0000024890,2024-11-13T19:30:32,ACC00005424,ATM,1410.05,-846004.62,GBP,Starbucks
TXN0000024891,2024-09-01T11:30:44,ACC00000063,Payment,306.19,-846310.81,JPY,Grocery
TXN0000024892,2024-03-08T11:11:22,ACC00007195,ATM,1224.72,-847535.53,GBP,Walmart
TXN0000024893,2024-03-11T06:21:38,ACC00006402,Payment,1231.92,-848767.45,GBP,Walmart
TXN0000024894,2024-07-26T07:41:29,ACC00004224,Debit,1358.83,-850126.28,JPY,Starbucks
TXN0000024895,2024-08-12T04:16:28,ACC00008483,Credit,759.65,-849366.63,JPY,Grocery
TXN0000024896,2024-05-04T14:04:59,ACC00007409,Debit,1075.44,-850442.07,USD,Shell
TXN0000024897,2024-05-14T00:36:15,ACC00003897,Credit,1748.13,-848693.94,GBP,Amazon
TXN0000024898,2024-07-16T17:16:30,ACC00009642,Transfer,187.68,-848506.26,USD,Amazon
TXN0000024899,2024-09-17T01:31:13,ACC00001863,Transfer,341.18,-848165.08,EUR,Amazon
TXN0000024900,2024-06-28T17:53:49,ACC00008976,Credit,762.01,-847403.07,EUR,Shell
TXN0000024901,2024-09-14T00:39:40,ACC00009301,Debit,782.26,-848185.33,EUR,Starbucks
TXN0000024902,2024-03-17T20:14:19,ACC00001597,Debit,319.11,-848504.44,USD,Shell
TXN0000024903,2024-04-23T15:15:20,ACC00003858,Transfer,103.92,-848400.52,EUR,Amazon
TXN0000024904,2024-10-19T16:43:03,ACC00002215,Credit,1022.84,-847377.68,JPY,Grocery
TXN0000024905,2024-08-17T18:15:02,ACC00001026,Credit,1017.96,-846359.72,EUR,Shell
TXN0000024906,2024-07-19T01:58:50,ACC00000668,ATM,1436.89,-847796.61,EUR,Walmart
TXN0000024907,2024-10-31T03:21:26,ACC00008836,ATM,989.48,-848786.09,EUR,Starbucks
TXN0000024908,2024-01-23T13:59:41,ACC00002283,Debit,1688.49,-850474.58,EUR,Target
TXN0000024909,2024-10-12T16:52:18,ACC00005607,Transfer,1253.28,-849221.3,USD,Amazon
TXN0000024910,2024-02-06T19:15:45,ACC00005221,Debit,1731.6,-850952.9,EUR,Grocery
TXN0000024911,2024-11-05T10:04:47,ACC00007512,Debit,717.38,-851670.28,JPY,Online Store
TXN0000024912,2024-03-28T04:20:52,ACC00008987,Transfer,1555.27,-850115.01,JPY,Walmart
TXN0000024913,2024-03-11T02:47:13,ACC00003195,Debit,1824.49,-851939.5,EUR,Shell
TXN0000024914,2024-06-21T09:17:59,ACC00006528,Payment,524.38,-852463.88,USD,Online Store
TXN0000024915,2024-11-06T01:15:44,ACC00003035,Credit,290.7,-852173.18,EUR,Online Store
TXN0000024916,2024-10-26T16:01:25,ACC00005501,Payment,801.03,-852974.21,USD,Online Store
TXN0000024917,2024-04-19T03:59:40,ACC00005332,Transfer,1181.46,-851792.75,JPY,Restaurant
TXN0000024918,2024-03-14T21:47:27,ACC00009137,Payment,49.31,-851842.06,JPY,Grocery
TXN0000024919,2024-06-06T07:59:24,ACC00007133,Transfer,796.75,-851045.31,GBP,Grocery
TXN0000024920,2024-04-09T21:00:41,ACC00006396,Transfer,995.19,-850050.12,JPY,Walmart
TXN0000024921,2024-02-12T07:46:07,ACC00000174,Credit,844.65,-849205.47,GBP,Shell
TXN0000024922,2024-12-22T04:21:41,ACC00005670,Debit,1779.25,-850984.72,USD,Starbucks
TXN0000024923,2024-02-06T05:48:12,ACC00002685,Transfer,1892.35,-849092.37,JPY,Restaurant
TXN0000024924,2024-12-19T20:19:08,ACC00000802,Payment,1217.87,-850310.24,GBP,Walmart
TXN0000024925,2024-12-06T20:06:46,ACC00006111,Credit,439.51,-849870.73,USD,Grocery
TXN0000024926,2024-09-21T06:49:29,ACC00007657,Credit,1514.05,-848356.68,USD,Amazon
TXN0000024927,2024-12-18T18:54:30,ACC00008094,Payment,60.34,-848417.02,JPY,Target
TXN0000024928,2024-02-10T18:42:51,ACC00009332,Credit,153.42,-848263.6,GBP,Target
TXN0000024929,2024-06-09T19:36:53,ACC00007583,Transfer,1477.79,-846785.81,JPY,Target
TXN0000024930,2024-09-12T10:43:29,ACC00000388,Debit,1632.69,-848418.5,USD,Target
TXN0000024931,2024-05-01T19:23:13,ACC00003184,ATM,777.43,-849195.93,EUR,Grocery
TXN0000024932,2024-09-18T02:04:14,ACC00006667,Debit,1522.02,-850717.95,JPY,Walmart
TXN0000024933,2024-03-06T14:52:26,ACC00002482,Transfer,592.37,-850125.58,JPY,Amazon
TXN0000024934,2024-10-04T09:16:39,ACC00008269,Credit,230.59,-849894.99,JPY,Online Store
TXN0000024935,2024-11-18T05:33:44,ACC00005981,Debit,1790.64,-851685.63,JPY,Grocery
TXN0000024936,2024-09-15T04:02:50,ACC00009617,ATM,1231.96,-852917.59,GBP,Grocery
TXN0000024937,2024-02-16T01:11:29,ACC00001837,Payment,1116.82,-854034.41,GBP,Starbucks
TXN0000024938,2024-10-24T05:20:15,ACC00005593,Credit,1221.68,-852812.73,JPY,Amazon
TXN0000024939,2024-05-15T01:03:45,ACC00009154,Debit,1084.29,-853897.02,EUR,Restaurant
TXN0000024940,2024-08-27T01:42:52,ACC00005105,ATM,1538.76,-855435.78,USD,Online Store
TXN0000024941,2024-08-17T20:53:58,ACC00005576,Transfer,1238.5,-854197.28,EUR,Restaurant
TXN0000024942,2024-07-20T14:50:48,ACC00003794,Payment,1558.89,-855756.17,USD,Target
TXN0000024943,2024-07-18T03:10:43,ACC00009613,ATM,1099.96,-856856.13,EUR,Target
TXN0000024944,2024-02-13T09:07:55,ACC00006238,Payment,75.2,-856931.33,USD,Grocery
TXN0000024945,2024-10-10T19:19:52,ACC00005970,Credit,937.74,-855993.59,GBP,Grocery
TXN0000024946,2024-01-13T15:10:41,ACC00008808,Debit,584.4,-856577.99,JPY,Grocery
TXN0000024947,2024-02-11T01:10:52,ACC00007198,Debit,1954.03,-858532.02,JPY,Starbucks
TXN0000024948,2024-02-01T13:18:16,ACC00001893,Transfer,314.43,-858217.59,GBP,Online Store
TXN0000024949,2024-06-26T21:44:47,ACC00005274,Payment,1919.82,-860137.41,USD,Walmart
TXN0000024950,2024-12-19T07:27:11,ACC00007284,Debit,575.74,-860713.15,USD,Starbucks
TXN0000024951,2024-05-30T16:45:52,ACC00007802,Payment,819.05,-861532.2,EUR,Starbucks
TXN0000024952,2024-11-11T03:38:10,ACC00007900,Transfer,134.51,-861397.69,EUR,Starbucks
TXN0000024953,2024-05-21T08:38:03,ACC00006443,Transfer,1685.9,-859711.79,EUR,Online Store
TXN0000024954,2024-05-19T22:36:34,ACC00000112,Debit,1257.98,-860969.77,EUR,Online Store
TXN0000024955,2024-02-09T17:00:45,ACC00002599,Payment,103.3,-861073.07,EUR,Starbucks
TXN0000024956,2024-07-24T10:32:22,ACC00000716,Payment,136.34,-861209.41,JPY,Online Store
TXN0000024957,2024-05-28T19:17:59,ACC00005837,Debit,497.05,-861706.46,EUR,Grocery
TXN0000024958,2024-06-08T02:10:24,ACC00009817,Transfer,360.16,-861346.3,EUR,Grocery
TXN0000024959,2024-08-02T05:31:35,ACC00009386,Debit,1861.95,-863208.25,EUR,Walmart
TXN0000024960,2024-01-03T08:45:31,ACC00001872,Credit,280.51,-862927.74,EUR,Amazon
TXN0000024961,2024-01-09T14:49:47,ACC00005094,Debit,1811.9,-864739.64,EUR,Amazon
TXN0000024962,2024-03-30T04:39:49,ACC00000669,Transfer,1097.41,-863642.23,JPY,Online Store
TXN0000024963,2024-08-05T15:28:16,ACC00008200,ATM,805.68,-864447.91,JPY,Amazon
TXN0000024964,2024-11-17T05:02:05,ACC00008197,Debit,1022.41,-865470.32,USD,Starbucks
TXN0000024965,2024-05-26T12:03:10,ACC00007444,Transfer,683.49,-864786.83,GBP,Restaurant
TXN0000024966,2024-09-27T07:30:43,ACC00007971,Payment,1115.37,-865902.2,EUR,Starbucks
TXN0000024967,2024-11-06T09:28:03,ACC00008130,Credit,626.03,-865276.17,GBP,Starbucks
TXN0000024968,2024-10-13T09:04:18,ACC00001239,Debit,1831.37,-867107.54,GBP,Online Store
TXN0000024969,2024-06-19T18:43:37,ACC00002290,ATM,322.6,-867430.14,JPY,Grocery
TXN0000024970,2024-07-22T09:53:01,ACC00003496,Transfer,1206.11,-866224.03,GBP,Target
TXN0000024971,2024-12-15T21:14:36,ACC00004564,ATM,763.23,-866987.26,EUR,Online Store
TXN0000024972,2024-07-08T05:25:20,ACC00009155,Credit,823.93,-866163.33,JPY,Starbucks
TXN0000024973,2024-01-30T10:53:37,ACC00002541,ATM,1119.82,-867283.15,USD,Target
TXN0000024974,2024-10-10T12:42:45,ACC00005600,ATM,1666.69,-868949.84,JPY,Target
TXN0000024975,2024-11-27T01:28:14,ACC00007602,Debit,636.44,-869586.28,USD,Walmart
TXN0000024976,2024-12-23T23:41:35,ACC00002328,Credit,553.03,-869033.25,JPY,Online Store
TXN0000024977,2024-09-11T03:51:46,ACC00007856,Credit,523.49,-868509.76,JPY,Target
TXN0000024978,2024-02-13T08:49:05,ACC00005256,Payment,231.81,-868741.57,JPY,Online Store
TXN0000024979,2024-11-10T16:40:51,ACC00009784,ATM,1960.64,-870702.21,EUR,Starbucks
TXN0000024980,2024-12-08T02:14:56,ACC00007751,Payment,980.76,-871682.97,EUR,Restaurant
TXN0000024981,2024-12-16T20:51:59,ACC00001233,Debit,435.59,-872118.56,GBP,Amazon
TXN0000024982,2024-11-05T02:06:40,ACC00005259,Credit,531.52,-871587.04,JPY,Amazon
TXN0000024983,2024-12-10T13:50:02,ACC00008628,ATM,11.34,-871598.38,JPY,Target
TXN0000024984,2024-04-08T06:18:03,ACC00009777,Credit,460.47,-871137.91,GBP,Online Store
TXN0000024985,2024-10-20T22:51:18,ACC00008869,ATM,1513.97,-872651.88,USD,Starbucks
TXN0000024986,2024-03-23T00:13:06,ACC00009650,Debit,1685.18,-874337.06,USD,Amazon
TXN0000024987,2024-09-30T11:51:06,ACC00003457,ATM,1321.38,-875658.44,GBP,Walmart
TXN0000024988,2024-10-09T15:24:10,ACC00004943,ATM,1992.01,-877650.45,USD,Grocery
TXN0000024989,2024-01-04T10:50:17,ACC00007155,Transfer,1661.07,-875989.38,JPY,Grocery
TXN0000024990,2024-03-11T05:23:00,ACC00009332,Transfer,1296.76,-874692.62,GBP,Walmart
TXN0000024991,2024-01-29T12:43:01,ACC00002112,Transfer,827.68,-873864.94,JPY,Walmart
TXN0000024992,2024-10-03T19:41:13,ACC00007913,Credit,369.87,-873495.07,JPY,Restaurant
TXN0000024993,2024-02-28T17:25:23,ACC00006125,Transfer,1286.2,-872208.87,GBP,Restaurant
TXN0000024994,2024-05-03T15:24:00,ACC00008045,Debit,722.47,-872931.34,JPY,Grocery
TXN0000024995,2024-08-25T16:58:02,ACC00003447,ATM,1597.11,-874528.45,EUR,Online Store
TXN0000024996,2024-03-12T08:42:14,ACC00001999,ATM,433.12,-874961.57,EUR,Walmart
TXN0000024997,2024-11-02T12:40:04,ACC00001498,Transfer,595.39,-874366.18,EUR,Online Store
TXN0000024998,2024-01-11T23:19:10,ACC00009727,Credit,94.7,-874271.48,GBP,Grocery
TXN0000024999,2024-11-08T11:14:32,ACC00004523,Debit,950.68,-875222.16,EUR,Online Store
TXN0000025000,2024-01-01T13:13:06,ACC00002150,Transfer,1553.24,-873668.92,USD,Amazon
